MES,CODIGO_OBJETIVO,CONFIGURACION,VIAJES_ORIGINADOS,VIAJES_DESCARGADOS,DIFERENCIA,INDICE_CARGUE_DESCARGUE
202412,5001000,2,36466,38578,-2112,0.95
202412,5001000,2B1,0,4,-4,0
202412,5001000,2B2,0,18,-18,0
202412,5001000,2R2,11,63,-52,0.17
202412,5001000,2R3,0,1,-1,0
202412,5001000,2S1,2,32,-30,0.06
202412,5001000,2S2,1195,3092,-1897,0.39
202412,5001000,2S3,331,1342,-1011,0.25
202412,5001000,3,1347,920,427,1.46
202412,5001000,3S1,1,1,0,1
202412,5001000,3S2,2614,2842,-228,0.92
202412,5001000,3S3,4347,7280,-2933,0.6
202412,5001000,3S4,5,3,2,1.67
202412,5001000,4,4,67,-63,0.06
202412,5001000,CA,9481,16252,-6771,0.58
202412,5001000,V2,42,0,42,NA
202412,5001000,V3,50,510,-460,0.1
202412,5001001,2,0,35,-35,0
202412,5001001,2R2,0,2,-2,0
202412,5001001,3S3,0,1,-1,0
202412,5001001,CA,1,21,-20,0.05
202412,5001002,2,2,38,-36,0.05
202412,5001002,3,0,5,-5,0
202412,5001002,3S3,0,2,-2,0
202412,5001002,CA,2,6,-4,0.33
202412,5001003,2,3,12,-9,0.25
202412,5001003,3,2,3,-1,0.67
202412,5001003,3S3,9,4,5,2.25
202412,5001003,CA,0,9,-9,0
202412,5001004,2,4,19,-15,0.21
202412,5001004,3,0,1,-1,0
202412,5001004,CA,0,1,-1,0
202412,5001009,CA,0,1,-1,0
202412,5001010,2,0,1,-1,0
202412,5002000,2,139,57,82,2.44
202412,5002000,2S2,0,11,-11,0
202412,5002000,3,6,23,-17,0.26
202412,5002000,3S3,0,1,-1,0
202412,5002000,CA,0,15,-15,0
202412,5002000,V2,151,0,151,NA
202412,5002010,2,0,32,-32,0
202412,5002010,3,0,9,-9,0
202412,5004000,2,5,3,2,1.67
202412,5004000,3S3,22,0,22,NA
202412,5004000,CA,0,1,-1,0
202412,5021000,2,4,12,-8,0.33
202412,5021000,3,1,2,-1,0.5
202412,5021000,3S2,0,3,-3,0
202412,5021000,3S3,21,1,20,21
202412,5021000,CA,0,7,-7,0
202412,5030000,2,397,310,87,1.28
202412,5030000,2S2,0,8,-8,0
202412,5030000,2S3,0,5,-5,0
202412,5030000,3,16,58,-42,0.28
202412,5030000,3S2,15,8,7,1.88
202412,5030000,3S3,706,151,555,4.68
202412,5030000,CA,29,97,-68,0.3
202412,5030000,V2,0,2,-2,0
202412,5030000,V3,315,3,312,105
202412,5030011,3S3,12,0,12,NA
202412,5031000,2,6,83,-77,0.07
202412,5031000,2S2,0,12,-12,0
202412,5031000,3,0,10,-10,0
202412,5031000,3S2,3,6,-3,0.5
202412,5031000,3S3,10,1,9,10
202412,5031000,4,4,0,4,NA
202412,5031000,CA,0,58,-58,0
202412,5031000,V3,12,0,12,NA
202412,5031000,V4,6,0,6,NA
202412,5034000,2,29,213,-184,0.14
202412,5034000,2S2,1,0,1,NA
202412,5034000,3,1,28,-27,0.04
202412,5034000,3S2,0,4,-4,0
202412,5034000,3S3,51,116,-65,0.44
202412,5034000,4,1,0,1,NA
202412,5034000,CA,0,51,-51,0
202412,5034001,2,2,0,2,NA
202412,5034006,2,19,1,18,19
202412,5034007,2,3,0,3,NA
202412,5034009,2,8,2,6,4
202412,5036000,2,12,18,-6,0.67
202412,5036000,3,0,3,-3,0
202412,5036000,CA,4,4,0,1
202412,5036000,V2,4,2,2,2
202412,5036000,V3,81,0,81,NA
202412,5038000,2,11,41,-30,0.27
202412,5038000,3,1,23,-22,0.04
202412,5038000,3S2,1,1,0,1
202412,5038000,3S3,0,4,-4,0
202412,5038000,4,2,0,2,NA
202412,5038000,CA,0,24,-24,0
202412,5038008,2,4,13,-9,0.31
202412,5038008,3,2,0,2,NA
202412,5038008,3S3,6,14,-8,0.43
202412,5038008,CA,0,1,-1,0
202412,5040000,2,6,48,-42,0.12
202412,5040000,2S3,1,0,1,NA
202412,5040000,3,0,5,-5,0
202412,5040000,3S2,1,1,0,1
202412,5040000,3S3,1,2,-1,0.5
202412,5040000,CA,0,14,-14,0
202412,5040000,V3,0,4,-4,0
202412,5040004,2,0,8,-8,0
202412,5040004,3S3,0,1,-1,0
202412,5042000,2,21,8455,-8434,0
202412,5042000,2S2,1,1,0,1
202412,5042000,3,3,35,-32,0.09
202412,5042000,3S2,1,13,-12,0.08
202412,5042000,3S3,34,85,-51,0.4
202412,5042000,4,0,1,-1,0
202412,5042000,CA,9,85,-76,0.11
202412,5042000,V3,0,1,-1,0
202412,5042001,2,0,3,-3,0
202412,5042001,CA,0,5,-5,0
202412,5044000,2,3,8,-5,0.38
202412,5044000,3,10,1,9,10
202412,5044000,3S2,0,1,-1,0
202412,5044000,3S3,0,3,-3,0
202412,5044000,CA,0,4,-4,0
202412,5044000,V2,0,1,-1,0
202412,5044001,3,10,3,7,3.33
202412,5045000,2,523,1784,-1261,0.29
202412,5045000,2B2,0,15,-15,0
202412,5045000,2R2,0,1,-1,0
202412,5045000,2S2,5,26,-21,0.19
202412,5045000,2S3,4,19,-15,0.21
202412,5045000,3,32,181,-149,0.18
202412,5045000,3S2,51,98,-47,0.52
202412,5045000,3S3,138,688,-550,0.2
202412,5045000,4,0,5,-5,0
202412,5045000,CA,153,333,-180,0.46
202412,5045000,V3,0,1,-1,0
202412,5045001,2,0,1,-1,0
202412,5051000,2,24,151,-127,0.16
202412,5051000,2B2,0,2,-2,0
202412,5051000,2S2,2,0,2,NA
202412,5051000,2S3,2,0,2,NA
202412,5051000,3,0,5,-5,0
202412,5051000,3S2,1,0,1,NA
202412,5051000,3S3,4,33,-29,0.12
202412,5051000,CA,0,27,-27,0
202412,5055000,2,3,19,-16,0.16
202412,5055000,3,0,13,-13,0
202412,5055000,CA,0,3,-3,0
202412,5059000,2,8,116,-108,0.07
202412,5059000,2S2,0,23,-23,0
202412,5059000,2S3,1,4,-3,0.25
202412,5059000,3,0,2,-2,0
202412,5059000,3S3,1,4,-3,0.25
202412,5059000,CA,1,45,-44,0.02
202412,5059002,2,0,2,-2,0
202412,5079000,2,1890,1110,780,1.7
202412,5079000,2B1,1,0,1,NA
202412,5079000,2R2,4,2,2,2
202412,5079000,2S2,396,64,332,6.19
202412,5079000,2S3,25,38,-13,0.66
202412,5079000,3,252,150,102,1.68
202412,5079000,3S1,9,0,9,NA
202412,5079000,3S2,154,143,11,1.08
202412,5079000,3S3,1067,838,229,1.27
202412,5079000,4,5,2,3,2.5
202412,5079000,CA,84,611,-527,0.14
202412,5079000,V3,0,3,-3,0
202412,5079001,2,16,3,13,5.33
202412,5079001,2S2,4,0,4,NA
202412,5079001,2S3,4,0,4,NA
202412,5079001,3S3,3,3,0,1
202412,5079001,CA,12,7,5,1.71
202412,5086000,2,16,31,-15,0.52
202412,5086000,2S2,0,5,-5,0
202412,5086000,3,0,12,-12,0
202412,5086000,CA,0,15,-15,0
202412,5086000,V3,0,7,-7,0
202412,5086004,2,0,1,-1,0
202412,5088000,2,2575,3652,-1077,0.71
202412,5088000,2S2,111,265,-154,0.42
202412,5088000,2S3,32,76,-44,0.42
202412,5088000,3,215,246,-31,0.87
202412,5088000,3S2,66,163,-97,0.4
202412,5088000,3S3,1833,2526,-693,0.73
202412,5088000,4,54,11,43,4.91
202412,5088000,CA,2520,1352,1168,1.86
202412,5088000,V2,0,7,-7,0
202412,5088000,V3,372,66,306,5.64
202412,5088012,2S3,0,1,-1,0
202412,5088013,2,0,9,-9,0
202412,5088013,3S3,0,2,-2,0
202412,5091000,2,35,11,24,3.18
202412,5091000,3,0,11,-11,0
202412,5091000,3S3,2,14,-12,0.14
202412,5091000,CA,0,5,-5,0
202412,5093000,2,2,23,-21,0.09
202412,5093000,3,2,1,1,2
202412,5093000,3S3,29,44,-15,0.66
202412,5093000,CA,0,6,-6,0
202412,5093000,V2,0,1,-1,0
202412,5093000,V3,0,1,-1,0
202412,5093001,2,0,3,-3,0
202412,5093001,3,33,4,29,8.25
202412,5101000,2,109,176,-67,0.62
202412,5101000,2S2,1,0,1,NA
202412,5101000,3,0,3,-3,0
202412,5101000,3S3,37,56,-19,0.66
202412,5101000,4,11,0,11,NA
202412,5101000,CA,71,56,15,1.27
202412,5101007,3S2,0,1,-1,0
202412,5107000,2,5,15,-10,0.33
202412,5107000,3,1,1,0,1
202412,5107000,3S2,0,3,-3,0
202412,5107000,CA,1,2,-1,0.5
202412,5113000,2,20,100,-80,0.2
202412,5113000,2S2,0,1,-1,0
202412,5113000,2S3,0,1,-1,0
202412,5113000,3,4,39,-35,0.1
202412,5113000,3S2,3,56,-53,0.05
202412,5113000,3S3,53,26,27,2.04
202412,5113000,CA,1,22,-21,0.05
202412,5120000,2,3,3,0,1
202412,5120000,3S2,2,4,-2,0.5
202412,5120000,3S3,0,15,-15,0
202412,5120000,CA,0,7,-7,0
202412,5120002,2,0,2,-2,0
202412,5120002,3,0,1,-1,0
202412,5120003,3S2,0,1,-1,0
202412,5120004,2,1,15,-14,0.07
202412,5120004,3,0,1,-1,0
202412,5120004,3S3,0,2,-2,0
202412,5120004,CA,0,2,-2,0
202412,5120010,2,0,1,-1,0
202412,5120010,3S2,0,1,-1,0
202412,5125000,2,14,18,-4,0.78
202412,5125000,3,36,3,33,12
202412,5125000,3S3,0,2,-2,0
202412,5125000,CA,0,18,-18,0
202412,5129000,2,2862,2219,643,1.29
202412,5129000,2S2,113,288,-175,0.39
202412,5129000,2S3,91,140,-49,0.65
202412,5129000,3,127,150,-23,0.85
202412,5129000,3S1,4,3,1,1.33
202412,5129000,3S2,143,86,57,1.66
202412,5129000,3S3,794,355,439,2.24
202412,5129000,3S4,1,0,1,NA
202412,5129000,4,3,12,-9,0.25
202412,5129000,CA,1642,459,1183,3.58
202412,5129000,V2,16,0,16,NA
202412,5129000,V3,33,34,-1,0.97
202412,5129004,2,0,2,-2,0
202412,5129005,2,0,2,-2,0
202412,5129005,3S2,1,5,-4,0.2
202412,5129006,2,6,0,6,NA
202412,5134000,2,3,44,-41,0.07
202412,5134000,CA,0,3,-3,0
202412,5138000,2,22,158,-136,0.14
202412,5138000,2S2,1,0,1,NA
202412,5138000,3,4,27,-23,0.15
202412,5138000,3S2,1,1,0,1
202412,5138000,3S3,8,22,-14,0.36
202412,5138000,4,3,1,2,3
202412,5138000,CA,0,7,-7,0
202412,5138006,2,0,2,-2,0
202412,5142000,2,2,15,-13,0.13
202412,5142000,3,2,10,-8,0.2
202412,5142000,3S2,1,2,-1,0.5
202412,5142000,3S3,0,1,-1,0
202412,5142000,CA,0,7,-7,0
202412,5142003,2,0,3,-3,0
202412,5142006,2,0,60,-60,0
202412,5142006,3S3,0,7,-7,0
202412,5145000,2,9,17,-8,0.53
202412,5145000,3,2,5,-3,0.4
202412,5145000,CA,0,17,-17,0
202412,5147000,2,70,261,-191,0.27
202412,5147000,2B2,0,8,-8,0
202412,5147000,2R2,2,0,2,NA
202412,5147000,2R3,0,1,-1,0
202412,5147000,2S2,10,0,10,NA
202412,5147000,2S3,9,3,6,3
202412,5147000,3,10,32,-22,0.31
202412,5147000,3S2,12,6,6,2
202412,5147000,3S3,104,168,-64,0.62
202412,5147000,CA,78,56,22,1.39
202412,5147004,2S3,8,0,8,NA
202412,5147004,3S2,2,0,2,NA
202412,5147004,3S3,29,0,29,NA
202412,5148000,2,758,802,-44,0.95
202412,5148000,2R2,0,1,-1,0
202412,5148000,2S2,81,40,41,2.02
202412,5148000,2S3,27,2,25,13.5
202412,5148000,3,12,22,-10,0.55
202412,5148000,3S2,22,13,9,1.69
202412,5148000,3S3,35,130,-95,0.27
202412,5148000,CA,5,351,-346,0.01
202412,5148010,2,0,1,-1,0
202412,5150000,2,39,30,9,1.3
202412,5150000,3,0,6,-6,0
202412,5150000,CA,0,6,-6,0
202412,5150000,V2,0,1,-1,0
202412,5150000,V3,0,6,-6,0
202412,5154000,2,134,1005,-871,0.13
202412,5154000,2B2,0,14,-14,0
202412,5154000,2R2,0,4,-4,0
202412,5154000,2S2,6,14,-8,0.43
202412,5154000,2S3,10,16,-6,0.62
202412,5154000,3,7,77,-70,0.09
202412,5154000,3S2,15,41,-26,0.37
202412,5154000,3S3,131,608,-477,0.22
202412,5154000,3S4,1,2,-1,0.5
202412,5154000,4,0,1,-1,0
202412,5154000,CA,31,291,-260,0.11
202412,5154000,V3,0,1,-1,0
202412,5154003,2,0,1,-1,0
202412,5154003,CA,0,1,-1,0
202412,5154006,3S3,0,1,-1,0
202412,5154007,2,0,12,-12,0
202412,5154010,CA,0,1,-1,0
202412,5154013,3,0,1,-1,0
202412,5154015,3S3,8,18,-10,0.44
202412,5154015,CA,0,1,-1,0
202412,5154023,2,2,2,0,1
202412,5154023,3S2,0,2,-2,0
202412,5154023,3S3,2,7,-5,0.29
202412,5172000,2,119,303,-184,0.39
202412,5172000,2B2,1,13,-12,0.08
202412,5172000,2R2,0,11,-11,0
202412,5172000,2S2,0,2,-2,0
202412,5172000,2S3,2,3,-1,0.67
202412,5172000,3,4,62,-58,0.06
202412,5172000,3S2,4,8,-4,0.5
202412,5172000,3S3,69,175,-106,0.39
202412,5172000,CA,5,65,-60,0.08
202412,5172003,2S3,1,0,1,NA
202412,5172003,3,1,0,1,NA
202412,5172003,3S3,3,3,0,1
202412,5190000,2,14,49,-35,0.29
202412,5190000,2S1,0,1,-1,0
202412,5190000,3,1,3,-2,0.33
202412,5190000,3S1,1,1,0,1
202412,5190000,3S2,0,2,-2,0
202412,5190000,3S3,1,18,-17,0.06
202412,5190000,CA,2,33,-31,0.06
202412,5190000,V3,0,3,-3,0
202412,5197000,2,5,43,-38,0.12
202412,5197000,2S2,0,3,-3,0
202412,5197000,2S3,1,0,1,NA
202412,5197000,3,0,1,-1,0
202412,5197000,3S3,1,1,0,1
202412,5197000,CA,3,25,-22,0.12
202412,5197005,2,0,1,-1,0
202412,5206000,2,12,36,-24,0.33
202412,5206000,3,1,5,-4,0.2
202412,5206000,CA,1,2,-1,0.5
202412,5206000,V3,0,1,-1,0
202412,5209000,2,3,29,-26,0.1
202412,5209000,3,8,3,5,2.67
202412,5209000,3S2,0,2,-2,0
202412,5209000,3S3,50,49,1,1.02
202412,5209000,CA,0,20,-20,0
202412,5209004,3S3,27,12,15,2.25
202412,5212000,2,1709,1299,410,1.32
202412,5212000,2S1,1,0,1,NA
202412,5212000,2S2,752,252,500,2.98
202412,5212000,2S3,99,92,7,1.08
202412,5212000,3,16,81,-65,0.2
202412,5212000,3S1,4,1,3,4
202412,5212000,3S2,166,176,-10,0.94
202412,5212000,3S3,430,341,89,1.26
202412,5212000,4,1,24,-23,0.04
202412,5212000,CA,510,629,-119,0.81
202412,5234000,2,8,55,-47,0.15
202412,5234000,2S2,0,2,-2,0
202412,5234000,3,1,23,-22,0.04
202412,5234000,3S2,1,0,1,NA
202412,5234000,3S3,3,62,-59,0.05
202412,5234000,CA,2,20,-18,0.1
202412,5234000,V3,0,1,-1,0
202412,5234009,2,1,27,-26,0.04
202412,5234009,3,0,1,-1,0
202412,5234009,CA,0,32,-32,0
202412,5237000,2,153,314,-161,0.49
202412,5237000,2S2,0,7,-7,0
202412,5237000,2S3,0,2,-2,0
202412,5237000,3,0,87,-87,0
202412,5237000,3S2,1,6,-5,0.17
202412,5237000,3S3,1,136,-135,0.01
202412,5237000,CA,1,44,-43,0.02
202412,5237000,V3,0,88,-88,0
202412,5237001,2,2,1,1,2
202412,5240000,2,2,5,-3,0.4
202412,5240000,3,0,2,-2,0
202412,5240000,4,2,3,-1,0.67
202412,5240000,CA,0,10,-10,0
202412,5240003,2,1,8,-7,0.12
202412,5240007,2,0,3,-3,0
202412,5240007,CA,0,2,-2,0
202412,5250000,2,6,205,-199,0.03
202412,5250000,2S2,0,2,-2,0
202412,5250000,2S3,0,1,-1,0
202412,5250000,3,0,19,-19,0
202412,5250000,3S2,6,15,-9,0.4
202412,5250000,3S3,10,120,-110,0.08
202412,5250000,4,0,1,-1,0
202412,5250000,CA,0,33,-33,0
202412,5250000,V3,0,1,-1,0
202412,5250004,3S3,2,0,2,NA
202412,5264000,2,197,318,-121,0.62
202412,5264000,2S2,7,27,-20,0.26
202412,5264000,2S3,2,1,1,2
202412,5264000,3,2,20,-18,0.1
202412,5264000,3S2,45,17,28,2.65
202412,5264000,3S3,20,164,-144,0.12
202412,5264000,CA,6,45,-39,0.13
202412,5264000,V3,0,7,-7,0
202412,5266000,2,9784,3569,6215,2.74
202412,5266000,2R2,23,0,23,NA
202412,5266000,2S2,1863,338,1525,5.51
202412,5266000,2S3,555,150,405,3.7
202412,5266000,3,52,136,-84,0.38
202412,5266000,3S2,191,253,-62,0.75
202412,5266000,3S3,428,1201,-773,0.36
202412,5266000,4,0,2,-2,0
202412,5266000,CA,1576,1343,233,1.17
202412,5266001,2,19,85,-66,0.22
202412,5266001,3,4,2,2,2
202412,5266001,CA,0,3,-3,0
202412,5282000,2,55,163,-108,0.34
202412,5282000,2S2,0,12,-12,0
202412,5282000,3,4,3,1,1.33
202412,5282000,3S3,1,0,1,NA
202412,5282000,CA,0,26,-26,0
202412,5282000,V2,0,1,-1,0
202412,5282004,2,0,3,-3,0
202412,5282004,3,0,1,-1,0
202412,5282004,3S2,10,0,10,NA
202412,5284000,2,14,2582,-2568,0.01
202412,5284000,3,2,24,-22,0.08
202412,5284000,3S2,1,0,1,NA
202412,5284000,3S3,9,20,-11,0.45
202412,5284000,CA,2,45,-43,0.04
202412,5284000,V3,0,3,-3,0
202412,5284006,2,0,2,-2,0
202412,5306000,2,1,22,-21,0.05
202412,5306000,3,1,2,-1,0.5
202412,5306000,3S3,2,7,-5,0.29
202412,5306000,4,1,0,1,NA
202412,5306000,V3,0,1,-1,0
202412,5308000,2,8286,2838,5448,2.92
202412,5308000,2B1,4,0,4,NA
202412,5308000,2R2,17,12,5,1.42
202412,5308000,2S1,16,0,16,NA
202412,5308000,2S2,156,666,-510,0.23
202412,5308000,2S3,118,126,-8,0.94
202412,5308000,3,532,142,390,3.75
202412,5308000,3S1,2,0,2,NA
202412,5308000,3S2,301,423,-122,0.71
202412,5308000,3S3,2242,2816,-574,0.8
202412,5308000,3S4,2,2,0,1
202412,5308000,4,22,6,16,3.67
202412,5308000,CA,2671,528,2143,5.06
202412,5308000,V3,128,237,-109,0.54
202412,5308000,V4,2,62,-60,0.03
202412,5310000,2,84,22,62,3.82
202412,5310000,3,4,4,0,1
202412,5310000,3S3,0,9,-9,0
202412,5310000,4,2,0,2,NA
202412,5310000,CA,35,23,12,1.52
202412,5310002,2,1,2,-1,0.5
202412,5310003,2,1227,392,835,3.13
202412,5310003,2S2,19,52,-33,0.37
202412,5310003,2S3,35,58,-23,0.6
202412,5310003,3,16,3,13,5.33
202412,5310003,3S2,0,3,-3,0
202412,5310003,3S3,71,96,-25,0.74
202412,5310003,CA,227,19,208,11.95
202412,5313000,2,4,22,-18,0.18
202412,5313000,2S2,0,16,-16,0
202412,5313000,CA,0,38,-38,0
202412,5315000,2,7,16,-9,0.44
202412,5315000,3,4,2,2,2
202412,5315000,4,1,0,1,NA
202412,5315000,CA,0,13,-13,0
202412,5318000,2,6983,2291,4692,3.05
202412,5318000,2R2,0,12,-12,0
202412,5318000,2S1,8,0,8,NA
202412,5318000,2S2,181,294,-113,0.62
202412,5318000,2S3,64,89,-25,0.72
202412,5318000,3,253,136,117,1.86
202412,5318000,3S2,156,204,-48,0.76
202412,5318000,3S3,1225,938,287,1.31
202412,5318000,CA,785,554,231,1.42
202412,5318000,V2,0,171,-171,0
202412,5318000,V3,0,1,-1,0
202412,5318003,2,58,2,56,29
202412,5318003,2S1,2,0,2,NA
202412,5318003,2S2,49,0,49,NA
202412,5318003,2S3,2,0,2,NA
202412,5318003,3S2,23,0,23,NA
202412,5318003,3S3,165,0,165,NA
202412,5321000,2,12,113,-101,0.11
202412,5321000,2S2,0,23,-23,0
202412,5321000,3,0,9,-9,0
202412,5321000,3S3,0,1,-1,0
202412,5321000,CA,3,44,-41,0.07
202412,5347000,2,1,15,-14,0.07
202412,5347000,3,1,11,-10,0.09
202412,5347000,CA,0,8,-8,0
202412,5347008,CA,0,2,-2,0
202412,5353000,2,2,46,-44,0.04
202412,5353000,2S2,1,1,0,1
202412,5353000,3S2,0,2,-2,0
202412,5353000,3S3,0,3,-3,0
202412,5353000,CA,0,4,-4,0
202412,5353000,V3,0,1,-1,0
202412,5360000,2,36785,6555,30230,5.61
202412,5360000,2B1,0,2,-2,0
202412,5360000,2R2,8,3,5,2.67
202412,5360000,2S1,41,3,38,13.67
202412,5360000,2S2,588,498,90,1.18
202412,5360000,2S3,168,355,-187,0.47
202412,5360000,3,360,406,-46,0.89
202412,5360000,3S1,0,9,-9,0
202412,5360000,3S2,165,350,-185,0.47
202412,5360000,3S3,1990,5204,-3214,0.38
202412,5360000,3S4,0,4,-4,0
202412,5360000,4,5,25,-20,0.2
202412,5360000,CA,4505,1728,2777,2.61
202412,5360000,V3,2,0,2,NA
202412,5360001,2,1,1,0,1
202412,5360001,2S2,0,3,-3,0
202412,5360001,2S3,2,2,0,1
202412,5360001,3S3,2,3,-1,0.67
202412,5360001,CA,1,0,1,NA
202412,5360003,2,0,3,-3,0
202412,5360006,2,0,77,-77,0
202412,5361000,2,30,98,-68,0.31
202412,5361000,2S2,13,62,-49,0.21
202412,5361000,2S3,3,1,2,3
202412,5361000,3,6,8,-2,0.75
202412,5361000,3S2,0,1,-1,0
202412,5361000,3S3,10,30,-20,0.33
202412,5361000,4,1,0,1,NA
202412,5361000,CA,0,33,-33,0
202412,5361000,V3,0,1,-1,0
202412,5364000,2,21,200,-179,0.1
202412,5364000,2S3,1,1,0,1
202412,5364000,3,1,28,-27,0.04
202412,5364000,3S2,13,1,12,13
202412,5364000,3S3,123,36,87,3.42
202412,5364000,CA,0,85,-85,0
202412,5368000,2,125,28,97,4.46
202412,5368000,2S2,0,26,-26,0
202412,5368000,3,6,10,-4,0.6
202412,5368000,3S2,1,0,1,NA
202412,5368000,3S3,16,6,10,2.67
202412,5368000,CA,3,24,-21,0.12
202412,5368007,3S3,0,3,-3,0
202412,5376000,2,810,1235,-425,0.66
202412,5376000,2S2,13,10,3,1.3
202412,5376000,2S3,5,0,5,NA
202412,5376000,3,26,36,-10,0.72
202412,5376000,3S2,5,8,-3,0.62
202412,5376000,3S3,46,176,-130,0.26
202412,5376000,CA,39,421,-382,0.09
202412,5380000,2,10651,2831,7820,3.76
202412,5380000,2R2,48,2,46,24
202412,5380000,2S2,569,486,83,1.17
202412,5380000,2S3,35,88,-53,0.4
202412,5380000,3,36,90,-54,0.4
202412,5380000,3S2,258,296,-38,0.87
202412,5380000,3S3,517,933,-416,0.55
202412,5380000,4,1,6,-5,0.17
202412,5380000,CA,5159,964,4195,5.35
202412,5380000,V3,1,1,0,1
202412,5380001,2,24,44,-20,0.55
202412,5380001,2S2,0,3,-3,0
202412,5380001,2S3,0,1,-1,0
202412,5380001,3S3,0,1,-1,0
202412,5380001,CA,2,4,-2,0.5
202412,5380005,2,102,32,70,3.19
202412,5380005,2S2,10,6,4,1.67
202412,5380005,2S3,9,2,7,4.5
202412,5380005,3,9,1,8,9
202412,5380005,3S2,9,0,9,NA
202412,5380005,3S3,19,12,7,1.58
202412,5380005,CA,1,0,1,NA
202412,5380010,2,0,1,-1,0
202412,5390000,2,41,65,-24,0.63
202412,5390000,3,5,6,-1,0.83
202412,5390000,3S2,4,1,3,4
202412,5390000,3S3,1,20,-19,0.05
202412,5390000,CA,8,31,-23,0.26
202412,5400000,2,116,267,-151,0.43
202412,5400000,2S2,1,1,0,1
202412,5400000,2S3,1,0,1,NA
202412,5400000,3,26,24,2,1.08
202412,5400000,3S2,2,11,-9,0.18
202412,5400000,3S3,172,86,86,2
202412,5400000,4,2,0,2,NA
202412,5400000,CA,7,232,-225,0.03
202412,5400000,V3,218,2,216,109
202412,5400000,V4,28,0,28,NA
202412,5400001,2,0,6,-6,0
202412,5411000,2,1,28,-27,0.04
202412,5411000,3,4,2,2,2
202412,5411000,CA,0,8,-8,0
202412,5411000,V2,0,8,-8,0
202412,5411001,2,0,10,-10,0
202412,5411007,2S2,1,0,1,NA
202412,5411007,3S2,0,1,-1,0
202412,5425000,2,49,101,-52,0.49
202412,5425000,3,2,35,-33,0.06
202412,5425000,3S2,2,47,-45,0.04
202412,5425000,3S3,6,11,-5,0.55
202412,5425000,4,0,10,-10,0
202412,5425000,CA,2,13,-11,0.15
202412,5425000,V3,0,16,-16,0
202412,5425001,2,0,1,-1,0
202412,5425003,2,1,0,1,NA
202412,5425005,2,1,2,-1,0.5
202412,5425005,3S3,14,1,13,14
202412,5425005,CA,0,1,-1,0
202412,5440000,2,1872,1166,706,1.61
202412,5440000,2R2,0,6,-6,0
202412,5440000,2S2,4,9,-5,0.44
202412,5440000,2S3,3,3,0,1
202412,5440000,3,63,42,21,1.5
202412,5440000,3S2,31,24,7,1.29
202412,5440000,3S3,86,556,-470,0.15
202412,5440000,4,0,1,-1,0
202412,5440000,CA,106,452,-346,0.23
202412,5440000,V3,0,36,-36,0
202412,5440001,2,0,1,-1,0
202412,5440001,3S3,0,8,-8,0
202412,5467000,2,21,7,14,3
202412,5467000,2S2,0,7,-7,0
202412,5467000,3,0,2,-2,0
202412,5467000,CA,2,12,-10,0.17
202412,5480000,2,4,152,-148,0.03
202412,5480000,3,2,7,-5,0.29
202412,5480000,3S2,1,1,0,1
202412,5480000,3S3,1,42,-41,0.02
202412,5480000,CA,1,22,-21,0.05
202412,5480004,2,0,2,-2,0
202412,5480004,3,1,0,1,NA
202412,5480004,3S3,2,0,2,NA
202412,5480006,2,0,20,-20,0
202412,5480006,3,0,6,-6,0
202412,5480006,3S3,0,6,-6,0
202412,5483000,2,3,29,-26,0.1
202412,5483000,3,1,10,-9,0.1
202412,5483000,3S2,0,1,-1,0
202412,5483000,3S3,0,1,-1,0
202412,5483000,CA,0,9,-9,0
202412,5490000,2,49,281,-232,0.17
202412,5490000,2B2,0,1,-1,0
202412,5490000,2R2,2,0,2,NA
202412,5490000,2S2,1,0,1,NA
202412,5490000,2S3,1,0,1,NA
202412,5490000,3,4,13,-9,0.31
202412,5490000,3S2,3,4,-1,0.75
202412,5490000,3S3,8,18,-10,0.44
202412,5490000,CA,1,50,-49,0.02
202412,5490004,2,0,2,-2,0
202412,5495000,2,2,67,-65,0.03
202412,5495000,2B2,0,1,-1,0
202412,5495000,3,0,5,-5,0
202412,5495000,3S2,0,2,-2,0
202412,5495000,3S3,7,9,-2,0.78
202412,5495000,CA,0,4,-4,0
202412,5495005,3S3,0,4,-4,0
202412,5501000,2,1,0,1,NA
202412,5501000,3,0,1,-1,0
202412,5541000,2,5,56,-51,0.09
202412,5541000,2S2,0,25,-25,0
202412,5541000,2S3,0,1,-1,0
202412,5541000,3,0,1,-1,0
202412,5541000,3S2,0,1,-1,0
202412,5541000,CA,1,48,-47,0.02
202412,5541001,2,6,16,-10,0.38
202412,5541001,3,0,4,-4,0
202412,5541001,3S2,1,0,1,NA
202412,5541001,CA,1,20,-19,0.05
202412,5543000,2,5,12,-7,0.42
202412,5543000,3,1,2,-1,0.5
202412,5543000,CA,0,1,-1,0
202412,5576000,2,19,10,9,1.9
202412,5576000,3,3,1,2,3
202412,5576000,3S3,4,5,-1,0.8
202412,5576000,CA,0,7,-7,0
202412,5579000,2,96,294,-198,0.33
202412,5579000,2S2,1,0,1,NA
202412,5579000,3,9,111,-102,0.08
202412,5579000,3S2,2,6,-4,0.33
202412,5579000,3S3,263,111,152,2.37
202412,5579000,CA,132,110,22,1.2
202412,5579000,V3,0,7,-7,0
202412,5579005,2,0,5,-5,0
202412,5585000,2,3,63,-60,0.05
202412,5585000,3,2,9,-7,0.22
202412,5585000,3S2,4,3,1,1.33
202412,5585000,3S3,220,165,55,1.33
202412,5585000,CA,3,30,-27,0.1
202412,5585000,V3,0,1,-1,0
202412,5585003,2,2,12,-10,0.17
202412,5585003,CA,2,19,-17,0.11
202412,5585003,V3,0,2,-2,0
202412,5585004,2,43,23,20,1.87
202412,5585004,2S2,2,0,2,NA
202412,5585004,3,1,0,1,NA
202412,5585004,3S3,0,1,-1,0
202412,5585004,CA,1,3,-2,0.33
202412,5591000,2,18,134,-116,0.13
202412,5591000,2S2,0,3,-3,0
202412,5591000,2S3,2,1,1,2
202412,5591000,3,29,45,-16,0.64
202412,5591000,3S2,6,1,5,6
202412,5591000,3S3,641,303,338,2.12
202412,5591000,3S4,1,0,1,NA
202412,5591000,CA,6,54,-48,0.11
202412,5591000,V3,1,17,-16,0.06
202412,5591000,V4R2,0,2,-2,0
202412,5591002,2,0,4,-4,0
202412,5591002,3S3,5,1,4,5
202412,5591002,CA,1,0,1,NA
202412,5591003,2,0,1,-1,0
202412,5591003,3,0,1,-1,0
202412,5591004,2,39,65,-26,0.6
202412,5591004,3,7,4,3,1.75
202412,5591004,3S2,4,2,2,2
202412,5591004,3S3,345,42,303,8.21
202412,5591004,CA,9,61,-52,0.15
202412,5591004,V3,3,2,1,1.5
202412,5604000,2,12,86,-74,0.14
202412,5604000,2S2,0,4,-4,0
202412,5604000,2S3,0,1,-1,0
202412,5604000,3,0,52,-52,0
202412,5604000,3S2,4,3,1,1.33
202412,5604000,3S3,1,34,-33,0.03
202412,5604000,CA,2,29,-27,0.07
202412,5604000,V3,0,8,-8,0
202412,5604001,3S2,0,1,-1,0
202412,5604003,2,0,2,-2,0
202412,5604003,2S2,1,0,1,NA
202412,5604003,3S2,0,4,-4,0
202412,5604005,3S2,0,6,-6,0
202412,5607000,2,51,414,-363,0.12
202412,5607000,2R2,0,17,-17,0
202412,5607000,2S2,0,1,-1,0
202412,5607000,2S3,1,2,-1,0.5
202412,5607000,3,10,11,-1,0.91
202412,5607000,3S2,12,2,10,6
202412,5607000,3S3,38,56,-18,0.68
202412,5607000,CA,10,216,-206,0.05
202412,5607004,CA,1,0,1,NA
202412,5607008,2,0,2,-2,0
202412,5607008,CA,0,5,-5,0
202412,5615000,2,6269,6665,-396,0.94
202412,5615000,2R2,7,8,-1,0.88
202412,5615000,2R3,0,2,-2,0
202412,5615000,2S2,576,452,124,1.27
202412,5615000,2S3,179,190,-11,0.94
202412,5615000,3,205,197,8,1.04
202412,5615000,3S2,485,557,-72,0.87
202412,5615000,3S3,1002,2746,-1744,0.36
202412,5615000,3S4,0,1,-1,0
202412,5615000,4,1,2,-1,0.5
202412,5615000,CA,2207,2610,-403,0.85
202412,5615000,V3,0,4,-4,0
202412,5615010,2,15,1,14,15
202412,5615010,3S3,0,1,-1,0
202412,5615010,CA,1,2,-1,0.5
202412,5628000,2,1,22,-21,0.05
202412,5628000,3,0,3,-3,0
202412,5628000,CA,0,9,-9,0
202412,5628000,V3,2,0,2,NA
202412,5628001,3,1,1,0,1
202412,5631000,2,4545,2376,2169,1.91
202412,5631000,2R3,0,2,-2,0
202412,5631000,2S2,66,116,-50,0.57
202412,5631000,2S3,28,95,-67,0.29
202412,5631000,3,362,206,156,1.76
202412,5631000,3S2,195,395,-200,0.49
202412,5631000,3S3,532,858,-326,0.62
202412,5631000,4,2,8,-6,0.25
202412,5631000,CA,2908,975,1933,2.98
202412,5631000,V3,6,150,-144,0.04
202412,5631000,V4,0,4,-4,0
202412,5631002,3S2,0,1,-1,0
202412,5631002,3S3,0,2,-2,0
202412,5642000,2,13,52,-39,0.25
202412,5642000,3,1,31,-30,0.03
202412,5642000,3S2,3,13,-10,0.23
202412,5642000,3S3,39,23,16,1.7
202412,5642000,CA,0,9,-9,0
202412,5642010,3,1,0,1,NA
202412,5647000,2,5,19,-14,0.26
202412,5647000,2S2,0,4,-4,0
202412,5647000,3,0,10,-10,0
202412,5647000,3S2,1,1,0,1
202412,5647000,3S3,2,6,-4,0.33
202412,5647000,4,2,0,2,NA
202412,5647000,CA,0,1,-1,0
202412,5647000,V3,0,1,-1,0
202412,5649000,2,7,97,-90,0.07
202412,5649000,2S2,0,11,-11,0
202412,5649000,3,1,18,-17,0.06
202412,5649000,3S3,0,1,-1,0
202412,5649000,CA,1,77,-76,0.01
202412,5649000,V3,0,6,-6,0
202412,5649001,CA,0,15,-15,0
202412,5649005,CA,0,2,-2,0
202412,5649012,2,0,1,-1,0
202412,5649012,3S3,0,4,-4,0
202412,5649012,CA,0,2,-2,0
202412,5652000,2,1,4,-3,0.25
202412,5652000,3,3,9,-6,0.33
202412,5652000,3S3,108,41,67,2.63
202412,5652000,CA,0,3,-3,0
202412,5652000,V3,4,0,4,NA
202412,5652010,2,2,3,-1,0.67
202412,5652010,2S2,0,1,-1,0
202412,5652010,3,10,0,10,NA
202412,5652010,3S2,3,1,2,3
202412,5652010,3S3,227,33,194,6.88
202412,5652010,V3,1,0,1,NA
202412,5656000,2,12,106,-94,0.11
202412,5656000,2S3,0,1,-1,0
202412,5656000,3,8,8,0,1
202412,5656000,3S2,5,0,5,NA
202412,5656000,3S3,1,7,-6,0.14
202412,5656000,CA,0,54,-54,0
202412,5656000,V2,0,3,-3,0
202412,5656000,V3,0,1,-1,0
202412,5658000,2,2,19,-17,0.11
202412,5658000,3,0,3,-3,0
202412,5658000,3S3,0,18,-18,0
202412,5658000,CA,0,3,-3,0
202412,5659000,2,24,52,-28,0.46
202412,5659000,2S3,0,1,-1,0
202412,5659000,3,2,12,-10,0.17
202412,5659000,3S2,98,2,96,49
202412,5659000,3S3,16,9,7,1.78
202412,5659000,CA,0,5,-5,0
202412,5660000,2,8,33,-25,0.24
202412,5660000,2S2,0,13,-13,0
202412,5660000,3,0,6,-6,0
202412,5660000,3S3,8,3,5,2.67
202412,5660000,CA,1,72,-71,0.01
202412,5660000,V3,0,4,-4,0
202412,5660006,CA,0,2,-2,0
202412,5660008,2,0,1,-1,0
202412,5660012,2,0,2,-2,0
202412,5660012,2S2,1,0,1,NA
202412,5660012,3S3,18,0,18,NA
202412,5660012,CA,0,1,-1,0
202412,5660013,2,0,3,-3,0
202412,5660013,CA,0,5,-5,0
202412,5664000,2,196,737,-541,0.27
202412,5664000,2S3,0,1,-1,0
202412,5664000,3,53,55,-2,0.96
202412,5664000,3S2,158,56,102,2.82
202412,5664000,3S3,472,474,-2,1
202412,5664000,4,35,0,35,NA
202412,5664000,CA,2,130,-128,0.02
202412,5664000,V3,0,1,-1,0
202412,5664005,2,0,11,-11,0
202412,5664005,3S3,0,18,-18,0
202412,5665000,2,21,138,-117,0.15
202412,5665000,3,0,23,-23,0
202412,5665000,3S2,1,2,-1,0.5
202412,5665000,3S3,0,3,-3,0
202412,5665000,CA,2,25,-23,0.08
202412,5665003,2S2,0,3,-3,0
202412,5665003,2S3,0,1,-1,0
202412,5665003,3S3,2,2,0,1
202412,5667000,2,6,86,-80,0.07
202412,5667000,2S2,0,13,-13,0
202412,5667000,3,2,2,0,1
202412,5667000,3S3,0,1,-1,0
202412,5667000,CA,1,22,-21,0.05
202412,5670000,2,15,31,-16,0.48
202412,5670000,2S3,0,1,-1,0
202412,5670000,3,1,4,-3,0.25
202412,5670000,3S3,2,0,2,NA
202412,5670000,CA,0,13,-13,0
202412,5670003,2,67,5,62,13.4
202412,5670003,3S3,1,0,1,NA
202412,5674000,2,16,100,-84,0.16
202412,5674000,3,4,4,0,1
202412,5674000,3S3,0,1,-1,0
202412,5674000,CA,1,39,-38,0.03
202412,5679000,2,7,36,-29,0.19
202412,5679000,3,1,3,-2,0.33
202412,5679000,3S2,8,0,8,NA
202412,5679000,3S3,3,0,3,NA
202412,5679000,CA,1,33,-32,0.03
202412,5679000,V2,0,6,-6,0
202412,5679009,2,0,1,-1,0
202412,5686000,2,520,747,-227,0.7
202412,5686000,2S2,0,2,-2,0
202412,5686000,2S3,0,4,-4,0
202412,5686000,3,22,86,-64,0.26
202412,5686000,3S2,55,10,45,5.5
202412,5686000,3S3,386,435,-49,0.89
202412,5686000,CA,16,109,-93,0.15
202412,5686000,V3,0,88,-88,0
202412,5686001,2,0,14,-14,0
202412,5686001,3,0,5,-5,0
202412,5686004,2,0,2,-2,0
202412,5686006,3,0,2,-2,0
202412,5686011,2,1,4,-3,0.25
202412,5686011,3,0,2,-2,0
202412,5686011,3S3,12,2,10,6
202412,5686011,CA,1,0,1,NA
202412,5690000,2,193,86,107,2.24
202412,5690000,3,6,12,-6,0.5
202412,5690000,3S2,0,1,-1,0
202412,5690000,3S3,35,9,26,3.89
202412,5690000,CA,3,6,-3,0.5
202412,5690000,V3,0,1,-1,0
202412,5690001,2,82,11,71,7.45
202412,5690003,2,1,1,0,1
202412,5690004,2,0,24,-24,0
202412,5690004,2S3,0,1,-1,0
202412,5690004,3S3,0,2,-2,0
202412,5690004,CA,0,1,-1,0
202412,5690010,2,2,3,-1,0.67
202412,5690010,3,1,1,0,1
202412,5690010,3S2,0,2,-2,0
202412,5690010,3S3,1,0,1,NA
202412,5697000,2,103,803,-700,0.13
202412,5697000,2S2,0,2,-2,0
202412,5697000,2S3,0,4,-4,0
202412,5697000,3,4,19,-15,0.21
202412,5697000,3S2,2,2,0,1
202412,5697000,3S3,41,114,-73,0.36
202412,5697000,CA,3,292,-289,0.01
202412,5697000,V3,0,1,-1,0
202412,5736000,2,23,459,-436,0.05
202412,5736000,2S2,0,8,-8,0
202412,5736000,3,3,103,-100,0.03
202412,5736000,3S2,8,8,0,1
202412,5736000,3S3,14,19,-5,0.74
202412,5736000,3S4,0,2,-2,0
202412,5736000,4,0,5,-5,0
202412,5736000,CA,2,94,-92,0.02
202412,5736000,V3,0,12,-12,0
202412,5736002,3S2,0,4,-4,0
202412,5756000,2,222,269,-47,0.83
202412,5756000,3,328,19,309,17.26
202412,5756000,3S2,547,5,542,109.4
202412,5756000,3S3,3110,696,2414,4.47
202412,5756000,CA,4,90,-86,0.04
202412,5756000,V3,105,12,93,8.75
202412,5756005,CA,0,10,-10,0
202412,5756030,2,1,2,-1,0.5
202412,5756030,3,0,1,-1,0
202412,5756030,3S3,14,0,14,NA
202412,5756030,CA,0,3,-3,0
202412,5756033,3,40,0,40,NA
202412,5756033,3S3,119,11,108,10.82
202412,5756033,V3,34,0,34,NA
202412,5761000,2,10,54,-44,0.19
202412,5761000,3,2,3,-1,0.67
202412,5761000,3S3,2,8,-6,0.25
202412,5761000,CA,0,47,-47,0
202412,5761002,2,3,0,3,NA
202412,5761002,2S2,1,0,1,NA
202412,5761004,2,0,1,-1,0
202412,5789000,2,183,123,60,1.49
202412,5789000,2S2,0,23,-23,0
202412,5789000,3,2,8,-6,0.25
202412,5789000,3S3,1,1,0,1
202412,5789000,CA,7,35,-28,0.2
202412,5789000,V2,0,1,-1,0
202412,5789000,V3,0,3,-3,0
202412,5789001,2,0,1,-1,0
202412,5789001,3,0,1,-1,0
202412,5789001,3S3,0,1,-1,0
202412,5789002,2,1,1,0,1
202412,5789005,CA,0,3,-3,0
202412,5790000,2,4,68,-64,0.06
202412,5790000,2B2,0,6,-6,0
202412,5790000,2R2,0,1,-1,0
202412,5790000,3,2,6,-4,0.33
202412,5790000,3S2,3,3,0,1
202412,5790000,3S3,3,6,-3,0.5
202412,5790000,CA,3,17,-14,0.18
202412,5790002,2,0,1,-1,0
202412,5790003,2S3,0,1,-1,0
202412,5790003,3S3,1,0,1,NA
202412,5792000,2,2,10,-8,0.2
202412,5792000,2S2,0,2,-2,0
202412,5792000,3S2,0,2,-2,0
202412,5792000,3S3,0,5,-5,0
202412,5792000,CA,0,24,-24,0
202412,5809000,2,86,40,46,2.15
202412,5809000,2S2,0,10,-10,0
202412,5809000,3,0,31,-31,0
202412,5809000,3S3,131,3,128,43.67
202412,5809000,CA,0,25,-25,0
202412,5809000,V2,0,3,-3,0
202412,5809001,3S3,3,0,3,NA
202412,5819000,2,9,12,-3,0.75
202412,5819000,3,3,24,-21,0.12
202412,5819000,3S2,0,92,-92,0
202412,5819000,3S3,0,94,-94,0
202412,5819000,4,0,2,-2,0
202412,5819000,CA,0,3,-3,0
202412,5819000,V3,0,6,-6,0
202412,5819002,3S3,1,0,1,NA
202412,5837000,2,37,848,-811,0.04
202412,5837000,2B2,0,1,-1,0
202412,5837000,2R3,0,1,-1,0
202412,5837000,2S2,0,14,-14,0
202412,5837000,2S3,5,6,-1,0.83
202412,5837000,3,3,90,-87,0.03
202412,5837000,3S2,28,32,-4,0.88
202412,5837000,3S3,38,282,-244,0.13
202412,5837000,4,0,5,-5,0
202412,5837000,CA,5,149,-144,0.03
202412,5837000,V3,1,0,1,NA
202412,5837001,2,0,12,-12,0
202412,5837001,3,0,2,-2,0
202412,5837001,3S3,0,1,-1,0
202412,5837001,CA,0,1,-1,0
202412,5837002,2,2,9,-7,0.22
202412,5837002,2S3,1,5,-4,0.2
202412,5837002,3,1,0,1,NA
202412,5837002,3S2,0,77,-77,0
202412,5837002,3S3,6,47,-41,0.13
202412,5837002,3S4,0,3,-3,0
202412,5837002,CA,0,1,-1,0
202412,5837003,2,0,1,-1,0
202412,5842000,2,1,26,-25,0.04
202412,5842000,3S2,0,1,-1,0
202412,5842000,3S3,2,6,-4,0.33
202412,5842000,CA,0,20,-20,0
202412,5842000,V2,0,2,-2,0
202412,5847000,2,115,153,-38,0.75
202412,5847000,3,18,18,0,1
202412,5847000,3S3,8,39,-31,0.21
202412,5847000,CA,2,74,-72,0.03
202412,5854000,2,1,37,-36,0.03
202412,5854000,3,1,1,0,1
202412,5854000,3S3,0,8,-8,0
202412,5854000,CA,1,8,-7,0.12
202412,5854002,2,1,2,-1,0.5
202412,5854002,3,0,2,-2,0
202412,5854002,3S3,0,3,-3,0
202412,5856000,2,9,21,-12,0.43
202412,5856000,2S2,0,4,-4,0
202412,5856000,3,15,14,1,1.07
202412,5856000,3S3,0,2,-2,0
202412,5856000,CA,0,8,-8,0
202412,5856000,V2,0,2,-2,0
202412,5856000,V3,71,1,70,71
202412,5856000,V4,22,0,22,NA
202412,5858000,2,19,90,-71,0.21
202412,5858000,2S2,0,1,-1,0
202412,5858000,2S3,0,2,-2,0
202412,5858000,3,6,16,-10,0.38
202412,5858000,3S2,16,19,-3,0.84
202412,5858000,3S3,11,34,-23,0.32
202412,5858000,CA,1,32,-31,0.03
202412,5861000,2,5,54,-49,0.09
202412,5861000,2S2,0,7,-7,0
202412,5861000,3,1,6,-5,0.17
202412,5861000,3S2,2,0,2,NA
202412,5861000,3S3,0,2,-2,0
202412,5861000,CA,0,48,-48,0
202412,5861000,V2,0,2,-2,0
202412,5861000,V3,0,1,-1,0
202412,5861002,2,4,15,-11,0.27
202412,5861002,3S2,1,2,-1,0.5
202412,5861002,3S3,22,29,-7,0.76
202412,5861002,3S4,1,0,1,NA
202412,5861002,4,8,1,7,8
202412,5861002,CA,0,3,-3,0
202412,5873006,3S3,0,3,-3,0
202412,5885000,2,50,11,39,4.55
202412,5885000,3,0,3,-3,0
202412,5885000,3S2,0,1,-1,0
202412,5885000,3S3,8,0,8,NA
202412,5885000,V3,0,3,-3,0
202412,5887000,2,109,480,-371,0.23
202412,5887000,2S2,0,4,-4,0
202412,5887000,2S3,0,2,-2,0
202412,5887000,3,120,12,108,10
202412,5887000,3S2,60,22,38,2.73
202412,5887000,3S3,281,431,-150,0.65
202412,5887000,CA,0,88,-88,0
202412,5887003,3,0,1,-1,0
202412,5887004,2,0,2,-2,0
202412,5887007,2,19,22,-3,0.86
202412,5887007,2S2,0,2,-2,0
202412,5887007,3,2,3,-1,0.67
202412,5887007,3S2,1,0,1,NA
202412,5887007,3S3,24,25,-1,0.96
202412,5887007,4,2,0,2,NA
202412,5887007,CA,0,17,-17,0
202412,5890000,2,196,116,80,1.69
202412,5890000,3,5,42,-37,0.12
202412,5890000,3S3,0,66,-66,0
202412,5890000,CA,8,46,-38,0.17
202412,5890000,V3,0,8,-8,0
202412,5893000,2,19,97,-78,0.2
202412,5893000,2S2,1,5,-4,0.2
202412,5893000,2S3,1,7,-6,0.14
202412,5893000,3,0,7,-7,0
202412,5893000,3S1,0,2,-2,0
202412,5893000,3S2,4,3,1,1.33
202412,5893000,3S3,63,67,-4,0.94
202412,5893000,3S4,1,0,1,NA
202412,5893000,4,2,0,2,NA
202412,5893000,CA,28,57,-29,0.49
202412,5893000,V2,0,1,-1,0
202412,5893000,V3,0,2,-2,0
202412,5893001,3S3,0,2,-2,0
202412,5893001,V3,0,5,-5,0
202412,5893002,CA,0,1,-1,0
202412,5893003,2,6,1,5,6
202412,5893003,CA,0,4,-4,0
202412,5893005,3S3,37,30,7,1.23
202412,5895000,2,4,119,-115,0.03
202412,5895000,2B2,0,8,-8,0
202412,5895000,2R2,0,1,-1,0
202412,5895000,3,0,22,-22,0
202412,5895000,3S2,2,6,-4,0.33
202412,5895000,3S3,4,68,-64,0.06
202412,5895000,CA,1,23,-22,0.04
202412,8001000,2,24923,22121,2802,1.13
202412,8001000,2B1,12,24,-12,0.5
202412,8001000,2B2,5,3,2,1.67
202412,8001000,2R2,85,51,34,1.67
202412,8001000,2S1,9,15,-6,0.6
202412,8001000,2S2,857,2329,-1472,0.37
202412,8001000,2S3,629,1623,-994,0.39
202412,8001000,3,643,759,-116,0.85
202412,8001000,3S1,1,4,-3,0.25
202412,8001000,3S2,2111,2647,-536,0.8
202412,8001000,3S3,16667,16306,361,1.02
202412,8001000,3S3S2,0,1,-1,0
202412,8001000,3S4,8,11,-3,0.73
202412,8001000,4,34,9,25,3.78
202412,8001000,CA,5821,4941,880,1.18
202412,8001000,V2,42,64,-22,0.66
202412,8001000,V3,119,250,-131,0.48
202412,8001000,V4,21,37,-16,0.57
202412,8001001,2,320,25,295,12.8
202412,8001001,2S2,13,10,3,1.3
202412,8001001,2S3,62,17,45,3.65
202412,8001001,3,5,1,4,5
202412,8001001,3S2,21,50,-29,0.42
202412,8001001,3S3,128,125,3,1.02
202412,8001001,CA,0,2,-2,0
202412,8001002,2,0,3,-3,0
202412,8001002,CA,0,1,-1,0
202412,8001004,2,0,6,-6,0
202412,8001004,3S3,6,8,-2,0.75
202412,8078000,2,1125,413,712,2.72
202412,8078000,2R2,0,1,-1,0
202412,8078000,2S2,452,5,447,90.4
202412,8078000,2S3,121,7,114,17.29
202412,8078000,3,477,8,469,59.62
202412,8078000,3S2,8,26,-18,0.31
202412,8078000,3S3,765,449,316,1.7
202412,8078000,CA,3,162,-159,0.02
202412,8078000,V2,12,16,-4,0.75
202412,8078000,V3,0,4,-4,0
202412,8078001,2,39,87,-48,0.45
202412,8078001,3,0,7,-7,0
202412,8078001,CA,0,10,-10,0
202412,8078002,CA,0,1,-1,0
202412,8078003,2,0,10,-10,0
202412,8137000,2,1,49,-48,0.02
202412,8137000,3S2,1,0,1,NA
202412,8137000,CA,0,24,-24,0
202412,8137000,V3,0,1,-1,0
202412,8137001,2,1,0,1,NA
202412,8141000,2,15,48,-33,0.31
202412,8141000,2S2,0,86,-86,0
202412,8141000,2S3,0,3,-3,0
202412,8141000,3,9,1,8,9
202412,8141000,3S2,0,2,-2,0
202412,8141000,3S3,3,11,-8,0.27
202412,8141000,CA,1,20,-19,0.05
202412,8141001,CA,0,8,-8,0
202412,8296000,2,9433,2208,7225,4.27
202412,8296000,2B1,0,1,-1,0
202412,8296000,2R2,220,9,211,24.44
202412,8296000,2S1,1,2,-1,0.5
202412,8296000,2S2,222,541,-319,0.41
202412,8296000,2S3,113,252,-139,0.45
202412,8296000,3,333,110,223,3.03
202412,8296000,3S1,5,0,5,NA
202412,8296000,3S2,306,395,-89,0.77
202412,8296000,3S3,2058,2170,-112,0.95
202412,8296000,3S4,4,20,-16,0.2
202412,8296000,4,5,0,5,NA
202412,8296000,CA,2344,443,1901,5.29
202412,8296000,V3,1,119,-118,0.01
202412,8296000,V4,0,23,-23,0
202412,8296001,2,10,41,-31,0.24
202412,8296001,3S3,1,0,1,NA
202412,8372000,2,8,163,-155,0.05
202412,8372000,3,1,2,-1,0.5
202412,8372000,3S2,0,2,-2,0
202412,8372000,3S3,1,16,-15,0.06
202412,8372000,CA,1,55,-54,0.02
202412,8372003,CA,0,2,-2,0
202412,8372004,2,9,7,2,1.29
202412,8372004,3S3,2,1,1,2
202412,8372004,CA,0,22,-22,0
202412,8421000,2,72,199,-127,0.36
202412,8421000,2S2,2,1,1,2
202412,8421000,2S3,28,2,26,14
202412,8421000,3,0,2,-2,0
202412,8421000,3S2,22,13,9,1.69
202412,8421000,3S3,387,17,370,22.76
202412,8421000,3S4,1,0,1,NA
202412,8421000,CA,0,55,-55,0
202412,8421000,V2,2,0,2,NA
202412,8421000,V3,22,0,22,NA
202412,8421000,V3R3,1,0,1,NA
202412,8421000,V4,23,0,23,NA
202412,8421001,2,20,6,14,3.33
202412,8421001,2S2,1,0,1,NA
202412,8421001,3S2,1,0,1,NA
202412,8421001,3S3,1,4,-3,0.25
202412,8421001,3S4,1,0,1,NA
202412,8421003,3S4,1,0,1,NA
202412,8421005,2,0,1,-1,0
202412,8433000,2,14546,2249,12297,6.47
202412,8433000,2B1,2,1,1,2
202412,8433000,2R2,5,5,0,1
202412,8433000,2S2,134,272,-138,0.49
202412,8433000,2S3,142,174,-32,0.82
202412,8433000,3,153,105,48,1.46
202412,8433000,3S1,1,2,-1,0.5
202412,8433000,3S2,316,358,-42,0.88
202412,8433000,3S3,3050,1905,1145,1.6
202412,8433000,3S4,2,0,2,NA
202412,8433000,CA,2023,562,1461,3.6
202412,8433000,V2,1,0,1,NA
202412,8433000,V3,17,3,14,5.67
202412,8433000,V4,0,1,-1,0
202412,8433001,2,63,170,-107,0.37
202412,8433001,3,0,24,-24,0
202412,8433001,3S3,7,7,0,1
202412,8433004,3S3,0,4,-4,0
202412,8436000,2,1,62,-61,0.02
202412,8436000,2S1,0,1,-1,0
202412,8436000,CA,0,55,-55,0
202412,8520000,2,22,265,-243,0.08
202412,8520000,2S2,13,125,-112,0.1
202412,8520000,2S3,47,64,-17,0.73
202412,8520000,3,8,5,3,1.6
202412,8520000,3S2,24,19,5,1.26
202412,8520000,3S3,1238,870,368,1.42
202412,8520000,3S4,0,1,-1,0
202412,8520000,CA,1,87,-86,0.01
202412,8520000,V2,15,0,15,NA
202412,8520000,V3,70,0,70,NA
202412,8549000,2,0,23,-23,0
202412,8549000,2S2,0,2,-2,0
202412,8549000,3,0,18,-18,0
202412,8549000,CA,0,19,-19,0
202412,8549002,2,0,8,-8,0
202412,8549002,2S2,1,0,1,NA
202412,8549002,3S2,1,0,1,NA
202412,8549002,3S3,0,1,-1,0
202412,8549002,CA,0,3,-3,0
202412,8549003,2S3,2,0,2,NA
202412,8549003,3S3,1,0,1,NA
202412,8558000,2,52,201,-149,0.26
202412,8558000,2S2,0,2,-2,0
202412,8558000,3,0,60,-60,0
202412,8558000,CA,0,37,-37,0
202412,8558001,2,1,12,-11,0.08
202412,8558001,3,0,4,-4,0
202412,8558001,3S3,0,1,-1,0
202412,8558001,CA,0,1,-1,0
202412,8560000,2,200,232,-32,0.86
202412,8560000,2S2,2,3,-1,0.67
202412,8560000,2S3,7,1,6,7
202412,8560000,3,4,18,-14,0.22
202412,8560000,3S2,5,1,4,5
202412,8560000,3S3,9,11,-2,0.82
202412,8560000,3S4,2,0,2,NA
202412,8560000,CA,2,54,-52,0.04
202412,8560000,V2,0,2,-2,0
202412,8560000,V3,0,19,-19,0
202412,8560000,V4,0,3,-3,0
202412,8560002,2,0,1,-1,0
202412,8560003,2,1,7,-6,0.14
202412,8560003,3S2,1,1,0,1
202412,8560003,3S3,2,0,2,NA
202412,8560003,CA,0,1,-1,0
202412,8573000,2,99,1119,-1020,0.09
202412,8573000,2S2,1,104,-103,0.01
202412,8573000,2S3,0,33,-33,0
202412,8573000,3,2,82,-80,0.02
202412,8573000,3S2,0,104,-104,0
202412,8573000,3S3,15,479,-464,0.03
202412,8573000,CA,93,763,-670,0.12
202412,8573000,V2,2,0,2,NA
202412,8573002,2,1,0,1,NA
202412,8573002,CA,0,1,-1,0
202412,8606000,2,7,62,-55,0.11
202412,8606000,2S2,1,0,1,NA
202412,8606000,3,1,1,0,1
202412,8606000,3S2,5,1,4,5
202412,8606000,3S3,6,13,-7,0.46
202412,8606000,CA,1,31,-30,0.03
202412,8606004,3S2,0,1,-1,0
202412,8606005,2,0,1,-1,0
202412,8634000,2,422,443,-21,0.95
202412,8634000,2S2,1,3,-2,0.33
202412,8634000,2S3,7,9,-2,0.78
202412,8634000,3,156,12,144,13
202412,8634000,3S2,13,43,-30,0.3
202412,8634000,3S3,174,467,-293,0.37
202412,8634000,CA,7,107,-100,0.07
202412,8634000,V2,0,17,-17,0
202412,8634000,V3,0,56,-56,0
202412,8634000,V3R2,0,15,-15,0
202412,8634000,V3R3,0,1,-1,0
202412,8634000,V4,0,9,-9,0
202412,8638000,2,106,742,-636,0.14
202412,8638000,2S2,0,10,-10,0
202412,8638000,2S3,2,4,-2,0.5
202412,8638000,3,0,26,-26,0
202412,8638000,3S2,6,52,-46,0.12
202412,8638000,3S3,14,88,-74,0.16
202412,8638000,CA,7,184,-177,0.04
202412,8638000,V2,12,5,7,2.4
202412,8638000,V3,0,6,-6,0
202412,8638001,2,0,7,-7,0
202412,8638001,3,1,0,1,NA
202412,8638002,2,2,21,-19,0.1
202412,8638002,3,0,1,-1,0
202412,8638002,3S2,1,0,1,NA
202412,8638002,3S3,1,1,0,1
202412,8638002,CA,0,3,-3,0
202412,8638004,2,12,2,10,6
202412,8638004,CA,0,6,-6,0
202412,8638005,2,1,0,1,NA
202412,8638005,3S2,1,0,1,NA
202412,8638005,V3,0,1,-1,0
202412,8638006,2,0,1,-1,0
202412,8638006,2S3,1,0,1,NA
202412,8638006,CA,0,1,-1,0
202412,8675000,2,2,37,-35,0.05
202412,8675000,3,0,2,-2,0
202412,8675000,CA,0,17,-17,0
202412,8685000,2,24,148,-124,0.16
202412,8685000,3,4,27,-23,0.15
202412,8685000,3S2,0,12,-12,0
202412,8685000,3S3,91,30,61,3.03
202412,8685000,CA,0,76,-76,0
202412,8685000,V2,20,0,20,NA
202412,8685000,V3,19,0,19,NA
202412,8758000,2,4501,3682,819,1.22
202412,8758000,2R2,9,12,-3,0.75
202412,8758000,2R3,1,0,1,NA
202412,8758000,2S1,0,13,-13,0
202412,8758000,2S2,53,123,-70,0.43
202412,8758000,2S3,88,127,-39,0.69
202412,8758000,3,94,67,27,1.4
202412,8758000,3S1,2,4,-2,0.5
202412,8758000,3S2,133,310,-177,0.43
202412,8758000,3S3,546,1231,-685,0.44
202412,8758000,3S4,2,2,0,1
202412,8758000,CA,2529,862,1667,2.93
202412,8758000,V2,0,61,-61,0
202412,8758000,V3,0,184,-184,0
202412,8758000,V4,0,42,-42,0
202412,8770000,2,0,52,-52,0
202412,8770000,3S3,0,2,-2,0
202412,8770000,CA,0,23,-23,0
202412,8832000,2,13,158,-145,0.08
202412,8832000,2S2,3,2,1,1.5
202412,8832000,2S3,41,36,5,1.14
202412,8832000,3,0,1,-1,0
202412,8832000,3S2,9,24,-15,0.38
202412,8832000,3S3,58,97,-39,0.6
202412,8832000,3S4,2,0,2,NA
202412,8832000,CA,0,70,-70,0
202412,8832000,V3,0,20,-20,0
202412,8832010,2,0,2,-2,0
202412,8832010,3S2,1,0,1,NA
202412,8832010,CA,0,1,-1,0
202412,8849000,2,1,31,-30,0.03
202412,8849000,2S2,3,0,3,NA
202412,8849000,3S3,0,2,-2,0
202412,8849000,CA,0,37,-37,0
202412,11001000,2,69401,77418,-8017,0.9
202412,11001000,2B1,11,2,9,5.5
202412,11001000,2B2,5,5,0,1
202412,11001000,2R2,120,103,17,1.17
202412,11001000,2R3,43,8,35,5.38
202412,11001000,2S1,124,62,62,2
202412,11001000,2S2,6334,7872,-1538,0.8
202412,11001000,2S3,3015,2399,616,1.26
202412,11001000,3,1166,2756,-1590,0.42
202412,11001000,3S1,18,17,1,1.06
202412,11001000,3S2,4806,7006,-2200,0.69
202412,11001000,3S2S3,1,1,0,1
202412,11001000,3S3,11277,20961,-9684,0.54
202412,11001000,3S4,21,58,-37,0.36
202412,11001000,4,31,92,-61,0.34
202412,11001000,CA,23077,40748,-17671,0.57
202412,11001000,M2,1,0,1,NA
202412,11001000,V2,76,111,-35,0.68
202412,11001000,V3,62,730,-668,0.08
202412,11001000,V3R2,0,1,-1,0
202412,11001000,V4,0,61,-61,0
202412,11001001,2,167,46,121,3.63
202412,11001001,2S2,0,6,-6,0
202412,11001001,2S3,0,1,-1,0
202412,11001001,3S3,6,10,-4,0.6
202412,11001001,CA,0,2,-2,0
202412,11001005,2,0,1,-1,0
202412,11001005,3S3,0,1,-1,0
202412,11001006,2,9,16,-7,0.56
202412,11001006,2S2,6,1,5,6
202412,11001006,2S3,2,1,1,2
202412,11001006,3S3,1,7,-6,0.14
202412,11001006,CA,5,1,4,5
202412,13001000,2,13583,15031,-1448,0.9
202412,13001000,2B1,15,8,7,1.88
202412,13001000,2B2,43,6,37,7.17
202412,13001000,2R2,114,50,64,2.28
202412,13001000,2R3,0,1,-1,0
202412,13001000,2S1,19,6,13,3.17
202412,13001000,2S2,7585,3380,4205,2.24
202412,13001000,2S3,3009,2007,1002,1.5
202412,13001000,3,1184,268,916,4.42
202412,13001000,3S1,19,5,14,3.8
202412,13001000,3S2,4900,2657,2243,1.84
202412,13001000,3S2S3,1,0,1,NA
202412,13001000,3S3,19346,12750,6596,1.52
202412,13001000,3S4,93,19,74,4.89
202412,13001000,4,31,13,18,2.38
202412,13001000,CA,2473,3389,-916,0.73
202412,13001000,M2,0,1,-1,0
202412,13001000,V2,1,57,-56,0.02
202412,13001000,V3,97,0,97,NA
202412,13001001,2,1,2,-1,0.5
202412,13001001,CA,0,1,-1,0
202412,13001002,2,0,1,-1,0
202412,13001002,3S3,0,1,-1,0
202412,13001003,2,11,57,-46,0.19
202412,13001003,2S2,1,0,1,NA
202412,13001003,2S3,1,5,-4,0.2
202412,13001003,3,0,4,-4,0
202412,13001003,3S3,4,1,3,4
202412,13001003,3S4,2,3,-1,0.67
202412,13001003,CA,5,14,-9,0.36
202412,13001004,2,30,56,-26,0.54
202412,13001004,2S3,0,4,-4,0
202412,13001004,3,1,2,-1,0.5
202412,13001004,3S2,5,3,2,1.67
202412,13001004,3S3,26,33,-7,0.79
202412,13001004,CA,2,12,-10,0.17
202412,13001004,V2,7,0,7,NA
202412,13001005,2,0,2,-2,0
202412,13001008,2,2,2,0,1
202412,13001008,3,1,0,1,NA
202412,13001008,3S2,0,1,-1,0
202412,13001008,CA,0,1,-1,0
202412,13001009,2,161,10,151,16.1
202412,13001009,2B1,2,0,2,NA
202412,13001009,2R2,1,0,1,NA
202412,13001009,2S1,2,0,2,NA
202412,13001009,2S2,85,16,69,5.31
202412,13001009,2S3,10,2,8,5
202412,13001009,3,2,0,2,NA
202412,13001009,3S2,17,2,15,8.5
202412,13001009,3S3,104,30,74,3.47
202412,13001009,CA,16,28,-12,0.57
202412,13001010,2,11,21,-10,0.52
202412,13001010,3,0,1,-1,0
202412,13001010,CA,1,10,-9,0.1
202412,13001012,2,1,1,0,1
202412,13001012,3S3,0,1,-1,0
202412,13001012,CA,0,1,-1,0
202412,13001013,2,0,1,-1,0
202412,13001015,2,0,5,-5,0
202412,13001015,2S2,0,4,-4,0
202412,13001015,3S3,2,1,1,2
202412,13001015,CA,0,5,-5,0
202412,13001019,2,6,8,-2,0.75
202412,13001019,3,0,1,-1,0
202412,13001019,3S2,1,0,1,NA
202412,13001020,2,1,5,-4,0.2
202412,13001020,3S3,1,1,0,1
202412,13001020,CA,1,1,0,1
202412,13001022,2S3,1,0,1,NA
202412,13001025,2,1,1,0,1
202412,13001025,3S2,1,0,1,NA
202412,13001025,3S3,2,2,0,1
202412,13001029,2,12,49,-37,0.24
202412,13001029,3,0,13,-13,0
202412,13001029,3S2,1,11,-10,0.09
202412,13001029,3S3,0,1,-1,0
202412,13001029,CA,0,2,-2,0
202412,13006000,2,1,7,-6,0.14
202412,13006000,3,0,7,-7,0
202412,13006000,3S3,0,3,-3,0
202412,13006000,CA,0,3,-3,0
202412,13006002,3S3,1,0,1,NA
202412,13006003,2,1,0,1,NA
202412,13006008,2,0,2,-2,0
202412,13006008,CA,0,1,-1,0
202412,13030000,2,1,0,1,NA
202412,13030000,3,0,1,-1,0
202412,13042000,2,2,9,-7,0.22
202412,13042000,3,0,4,-4,0
202412,13042000,3S2,3,1,2,3
202412,13042000,3S3,0,7,-7,0
202412,13052000,2,445,600,-155,0.74
202412,13052000,2R2,0,3,-3,0
202412,13052000,2S2,5,18,-13,0.28
202412,13052000,2S3,7,67,-60,0.1
202412,13052000,3,312,105,207,2.97
202412,13052000,3S2,161,28,133,5.75
202412,13052000,3S3,127,443,-316,0.29
202412,13052000,3S4,0,3,-3,0
202412,13052000,CA,579,183,396,3.16
202412,13052000,V2,13,0,13,NA
202412,13052002,2,36,28,8,1.29
202412,13052002,2S3,1,0,1,NA
202412,13052002,3,4,7,-3,0.57
202412,13052002,3S2,2,0,2,NA
202412,13052002,3S3,3,0,3,NA
202412,13052002,CA,1,1,0,1
202412,13052003,2,1,0,1,NA
202412,13052003,2S3,0,1,-1,0
202412,13052004,2,38,2,36,19
202412,13052004,2S2,7,0,7,NA
202412,13052004,2S3,11,0,11,NA
202412,13052004,3,0,142,-142,0
202412,13062000,2,110,3,107,36.67
202412,13062000,3,0,1,-1,0
202412,13062000,3S2,2,1,1,2
202412,13062000,CA,0,4,-4,0
202412,13074000,2,1,8,-7,0.12
202412,13074000,3,0,46,-46,0
202412,13074000,CA,0,6,-6,0
202412,13140000,2,3,150,-147,0.02
202412,13140000,2S3,1,0,1,NA
202412,13140000,3,0,10,-10,0
202412,13140000,3S3,0,6,-6,0
202412,13140000,CA,1,91,-90,0.01
202412,13140002,2,0,1,-1,0
202412,13140002,3S3,1,0,1,NA
202412,13140003,3S3,1,0,1,NA
202412,13140004,2,0,2,-2,0
202412,13140004,3S3,0,1,-1,0
202412,13140004,CA,0,2,-2,0
202412,13160000,2,7,50,-43,0.14
202412,13160000,2S2,1,3,-2,0.33
202412,13160000,2S3,1,2,-1,0.5
202412,13160000,3,2,8,-6,0.25
202412,13160000,3S2,1,0,1,NA
202412,13160000,3S3,9,15,-6,0.6
202412,13160000,3S3S2,0,1,-1,0
202412,13160000,CA,1,11,-10,0.09
202412,13160000,V3,0,12,-12,0
202412,13188000,2,2,3,-1,0.67
202412,13188000,2S1,0,1,-1,0
202412,13188000,3,0,6,-6,0
202412,13188000,3S1,0,4,-4,0
202412,13188000,3S2,0,1,-1,0
202412,13188000,3S3,2,9,-7,0.22
202412,13188000,CA,0,2,-2,0
202412,13212000,2,3,16,-13,0.19
202412,13212000,3,0,1,-1,0
202412,13212000,3S2,1,2,-1,0.5
202412,13212000,3S3,0,1,-1,0
202412,13212005,2,1,1,0,1
202412,13212006,2,0,1,-1,0
202412,13222000,2,16,21,-5,0.76
202412,13222000,2S2,8,9,-1,0.89
202412,13222000,2S3,0,18,-18,0
202412,13222000,3,1,5,-4,0.2
202412,13222000,3S2,5,9,-4,0.56
202412,13222000,3S3,78,125,-47,0.62
202412,13222000,CA,0,23,-23,0
202412,13222000,V2,1,0,1,NA
202412,13244000,2,56,312,-256,0.18
202412,13244000,3,1,16,-15,0.06
202412,13244000,3S2,0,1,-1,0
202412,13244000,3S3,12,23,-11,0.52
202412,13244000,4,0,2,-2,0
202412,13244000,CA,10,94,-84,0.11
202412,13244001,2,0,4,-4,0
202412,13244001,CA,0,1,-1,0
202412,13244008,2,0,1,-1,0
202412,13244014,2,0,1,-1,0
202412,13244014,2S3,0,1,-1,0
202412,13248000,2,38,6,32,6.33
202412,13248000,2S2,1,0,1,NA
202412,13248000,3S3,1,1,0,1
202412,13248000,CA,0,8,-8,0
202412,13268000,2,0,1,-1,0
202412,13300000,2,3,14,-11,0.21
202412,13300000,3,0,30,-30,0
202412,13300000,3S3,0,20,-20,0
202412,13300000,CA,0,2,-2,0
202412,13300004,2,0,2,-2,0
202412,13300006,2,0,1,-1,0
202412,13430000,2,225,893,-668,0.25
202412,13430000,2B2,0,19,-19,0
202412,13430000,2R2,0,3,-3,0
202412,13430000,2S2,1,10,-9,0.1
202412,13430000,2S3,5,1,4,5
202412,13430000,3,65,92,-27,0.71
202412,13430000,3S2,3,13,-10,0.23
202412,13430000,3S3,114,315,-201,0.36
202412,13430000,CA,6,153,-147,0.04
202412,13430006,3S2,1,2,-1,0.5
202412,13430009,3S2,0,1,-1,0
202412,13430017,2,0,11,-11,0
202412,13430017,3,2,0,2,NA
202412,13430017,3S3,0,15,-15,0
202412,13430017,CA,0,24,-24,0
202412,13430032,2,3,3,0,1
202412,13430032,CA,0,2,-2,0
202412,13430048,2,0,4,-4,0
202412,13433000,2,75,49,26,1.53
202412,13433000,2S1,0,3,-3,0
202412,13433000,3,0,9,-9,0
202412,13433000,3S3,0,15,-15,0
202412,13433000,CA,3,12,-9,0.25
202412,13433000,V2,4,0,4,NA
202412,13433003,2,10,12,-2,0.83
202412,13433003,2S3,1,0,1,NA
202412,13433003,CA,4,1,3,4
202412,13440000,2S2,1,0,1,NA
202412,13440000,3,0,15,-15,0
202412,13440021,2,0,1,-1,0
202412,13440021,3,1,0,1,NA
202412,13442000,2,12,176,-164,0.07
202412,13442000,2B2,0,1,-1,0
202412,13442000,3,0,1,-1,0
202412,13442000,3S3,61,40,21,1.52
202412,13442000,3S4,1,0,1,NA
202412,13442000,4,0,1,-1,0
202412,13442000,CA,2,88,-86,0.02
202412,13442008,2,0,2,-2,0
202412,13442008,3S3,1,0,1,NA
202412,13458000,2,0,2,-2,0
202412,13458000,3,0,36,-36,0
202412,13458000,3S2,1,1,0,1
202412,13468000,2,35,290,-255,0.12
202412,13468000,2B2,0,15,-15,0
202412,13468000,2S2,7,0,7,NA
202412,13468000,3,4,18,-14,0.22
202412,13468000,3S2,1,1,0,1
202412,13468000,3S3,1,31,-30,0.03
202412,13468000,3S4,0,1,-1,0
202412,13468000,CA,1,48,-47,0.02
202412,13468010,2,0,1,-1,0
202412,13468023,3S3,0,2,-2,0
202412,13468023,CA,0,2,-2,0
202412,13468024,2,0,1,-1,0
202412,13468024,2S3,0,2,-2,0
202412,13468028,2,1,29,-28,0.03
202412,13468028,CA,0,1,-1,0
202412,13468040,2,1,1,0,1
202412,13468040,CA,0,1,-1,0
202412,13473000,2,10,7,3,1.43
202412,13473000,3,0,1,-1,0
202412,13473000,3S3,1,2,-1,0.5
202412,13490000,2,0,11,-11,0
202412,13490000,3,1,1,0,1
202412,13490000,3S3,0,8,-8,0
202412,13490000,V3,4,0,4,NA
202412,13549000,2,0,3,-3,0
202412,13549015,2,0,2,-2,0
202412,13549015,2S3,1,3,-2,0.33
202412,13549015,3S3,1,0,1,NA
202412,13580000,2,1,27,-26,0.04
202412,13580000,3,0,1,-1,0
202412,13580000,3S2,1,0,1,NA
202412,13580000,3S3,31,8,23,3.88
202412,13580000,V3R3,4,0,4,NA
202412,13580005,2,0,2,-2,0
202412,13580005,CA,0,2,-2,0
202412,13600000,2,0,7,-7,0
202412,13600000,3,1,1,0,1
202412,13600000,3S3,1,3,-2,0.33
202412,13600000,CA,1,5,-4,0.2
202412,13600001,2,0,6,-6,0
202412,13600001,3,0,2,-2,0
202412,13600001,3S2,1,1,0,1
202412,13600001,3S3,5,0,5,NA
202412,13600001,V3,0,1,-1,0
202412,13620000,2,3,2,1,1.5
202412,13620000,CA,0,2,-2,0
202412,13647000,2,4,17,-13,0.24
202412,13647000,3S3,0,1,-1,0
202412,13647000,CA,0,5,-5,0
202412,13647002,2,0,1,-1,0
202412,13650000,2S2,7,0,7,NA
202412,13650000,3,0,2,-2,0
202412,13650005,2S3,0,2,-2,0
202412,13650005,3S3,1,1,0,1
202412,13654000,2,21,46,-25,0.46
202412,13654000,2S2,1,0,1,NA
202412,13654000,2S3,0,1,-1,0
202412,13654000,3,0,1,-1,0
202412,13654000,3S3,1,7,-6,0.14
202412,13654000,4,0,1,-1,0
202412,13654000,CA,0,3,-3,0
202412,13655000,3,0,19,-19,0
202412,13657000,2,125,125,0,1
202412,13657000,2B2,0,1,-1,0
202412,13657000,2R2,0,1,-1,0
202412,13657000,2S2,4,0,4,NA
202412,13657000,2S3,5,0,5,NA
202412,13657000,3,1,9,-8,0.11
202412,13657000,3S2,1,0,1,NA
202412,13657000,3S3,2,60,-58,0.03
202412,13657000,CA,0,17,-17,0
202412,13657004,3,1,2,-1,0.5
202412,13657005,2,10,0,10,NA
202412,13667000,2,2,39,-37,0.05
202412,13667000,3,0,17,-17,0
202412,13667000,3S2,1,0,1,NA
202412,13667000,3S3,0,3,-3,0
202412,13667000,4,0,1,-1,0
202412,13670000,2,13,123,-110,0.11
202412,13670000,3,3,35,-32,0.09
202412,13670000,3S2,0,3,-3,0
202412,13670000,3S3,28,48,-20,0.58
202412,13670000,CA,2,16,-14,0.12
202412,13670000,V3,0,10,-10,0
202412,13670004,2,0,6,-6,0
202412,13673000,2,28,37,-9,0.76
202412,13673000,2S2,3,0,3,NA
202412,13673000,2S3,2,0,2,NA
202412,13673000,3S3,1,0,1,NA
202412,13673000,CA,0,24,-24,0
202412,13673003,2,1,1,0,1
202412,13673003,CA,20,21,-1,0.95
202412,13673005,2,3,1,2,3
202412,13673005,2S2,1,1,0,1
202412,13673005,2S3,1,1,0,1
202412,13673005,3,2,0,2,NA
202412,13673005,3S3,1,1,0,1
202412,13673005,CA,2,2,0,1
202412,13683000,2,227,219,8,1.04
202412,13683000,2S2,2,0,2,NA
202412,13683000,2S3,9,2,7,4.5
202412,13683000,3,3,2,1,1.5
202412,13683000,3S2,0,3,-3,0
202412,13683000,3S3,10,8,2,1.25
202412,13683000,CA,1,17,-16,0.06
202412,13683000,V2,5,1,4,5
202412,13688000,2,11,230,-219,0.05
202412,13688000,2R3,0,1,-1,0
202412,13688000,3,0,59,-59,0
202412,13688000,3S2,0,2,-2,0
202412,13688000,3S3,0,75,-75,0
202412,13688000,CA,27,55,-28,0.49
202412,13688000,V2,0,1,-1,0
202412,13688000,V3,0,17,-17,0
202412,13744000,2,2,11,-9,0.18
202412,13744000,3,0,6,-6,0
202412,13744000,3S3,0,17,-17,0
202412,13744000,CA,0,2,-2,0
202412,13744000,V3,0,2,-2,0
202412,13760000,2,0,4,-4,0
202412,13760000,3,2,1,1,2
202412,13760000,CA,19,28,-9,0.68
202412,13760000,V2,1,0,1,NA
202412,13780000,2,1,6,-5,0.17
202412,13780000,3S3,1,7,-6,0.14
202412,13780000,CA,0,1,-1,0
202412,13780017,2,0,1,-1,0
202412,13810000,2,0,3,-3,0
202412,13810000,3,0,10,-10,0
202412,13810011,3,0,1,-1,0
202412,13836000,2,435,1103,-668,0.39
202412,13836000,2B1,0,1,-1,0
202412,13836000,2S2,92,21,71,4.38
202412,13836000,2S3,50,148,-98,0.34
202412,13836000,3,13,64,-51,0.2
202412,13836000,3S2,290,219,71,1.32
202412,13836000,3S3,726,722,4,1.01
202412,13836000,3S4,1,5,-4,0.2
202412,13836000,4,0,4,-4,0
202412,13836000,CA,49,573,-524,0.09
202412,13836000,V2,23,0,23,NA
202412,13836003,3,0,1,-1,0
202412,13836003,3S3,1,4,-3,0.25
202412,13836003,3S4,1,0,1,NA
202412,13838000,2,145,91,54,1.59
202412,13838000,2R2,10,1,9,10
202412,13838000,2S2,84,9,75,9.33
202412,13838000,2S3,42,36,6,1.17
202412,13838000,3,0,2,-2,0
202412,13838000,3S2,350,313,37,1.12
202412,13838000,3S3,133,93,40,1.43
202412,13838000,3S4,5,7,-2,0.71
202412,13838000,CA,3,11,-8,0.27
202412,13838001,2,12,14,-2,0.86
202412,13873000,2,3,48,-45,0.06
202412,13873000,3S2,0,1,-1,0
202412,13873000,3S3,0,11,-11,0
202412,13873000,CA,0,25,-25,0
202412,13873000,V2,4,0,4,NA
202412,13894000,2,69,49,20,1.41
202412,13894000,2S3,1,1,0,1
202412,13894000,3,1,0,1,NA
202412,13894000,3S3,31,12,19,2.58
202412,13894000,CA,1,9,-8,0.11
202412,15001000,2,1745,3454,-1709,0.51
202412,15001000,2B1,2,0,2,NA
202412,15001000,2R2,1,23,-22,0.04
202412,15001000,2S1,0,1,-1,0
202412,15001000,2S2,10,156,-146,0.06
202412,15001000,2S3,16,39,-23,0.41
202412,15001000,3,24,154,-130,0.16
202412,15001000,3S2,108,229,-121,0.47
202412,15001000,3S3,350,804,-454,0.44
202412,15001000,3S4,0,2,-2,0
202412,15001000,4,0,1,-1,0
202412,15001000,CA,1314,1238,76,1.06
202412,15001000,V2,3,0,3,NA
202412,15001000,V3,0,239,-239,0
202412,15001007,2,0,5,-5,0
202412,15001007,2S2,0,25,-25,0
202412,15001007,CA,0,1,-1,0
202412,15022000,2,0,3,-3,0
202412,15047000,2,4,40,-36,0.1
202412,15047000,3,1,0,1,NA
202412,15047000,3S3,0,2,-2,0
202412,15047000,CA,22,43,-21,0.51
202412,15047004,2,0,2,-2,0
202412,15047007,3,0,2,-2,0
202412,15047010,2,0,27,-27,0
202412,15051000,2,0,24,-24,0
202412,15051000,3,0,1,-1,0
202412,15051000,3S3,3,7,-4,0.43
202412,15051000,4,18,0,18,NA
202412,15051000,CA,0,5,-5,0
202412,15051000,V3,93,0,93,NA
202412,15051000,V4,163,0,163,NA
202412,15087000,2,2,74,-72,0.03
202412,15087000,3,1,0,1,NA
202412,15087000,3S2,26,0,26,NA
202412,15087000,3S3,1,13,-12,0.08
202412,15087000,CA,1,11,-10,0.09
202412,15090000,2,0,1,-1,0
202412,15092000,2,0,2,-2,0
202412,15097000,2,0,12,-12,0
202412,15097000,CA,1,2,-1,0.5
202412,15104000,2,4,39,-35,0.1
202412,15104000,3,0,1,-1,0
202412,15104000,3S2,1,1,0,1
202412,15104000,3S3,28,4,24,7
202412,15104000,CA,1,21,-20,0.05
202412,15106000,2,0,4,-4,0
202412,15106000,3S3,12,2,10,6
202412,15106000,CA,0,6,-6,0
202412,15109000,2,1,9,-8,0.11
202412,15109000,CA,0,4,-4,0
202412,15109001,2,0,1,-1,0
202412,15109001,CA,0,1,-1,0
202412,15131000,2,1,2,-1,0.5
202412,15131000,2S3,0,1,-1,0
202412,15131000,3S2,0,2,-2,0
202412,15131000,3S3,0,5,-5,0
202412,15135000,2,0,5,-5,0
202412,15135000,CA,0,5,-5,0
202412,15162000,2,0,13,-13,0
202412,15172000,2,0,18,-18,0
202412,15172000,3,0,1,-1,0
202412,15176000,2,72,767,-695,0.09
202412,15176000,3,0,13,-13,0
202412,15176000,3S2,0,10,-10,0
202412,15176000,3S3,156,308,-152,0.51
202412,15176000,CA,12,290,-278,0.04
202412,15176000,V2,0,1,-1,0
202412,15180000,2,2,8,-6,0.25
202412,15180000,CA,5,2,3,2.5
202412,15183000,2,0,17,-17,0
202412,15183000,CA,0,28,-28,0
202412,15185000,2,0,13,-13,0
202412,15185000,3S3,0,2,-2,0
202412,15185000,CA,0,3,-3,0
202412,15187000,2,0,4,-4,0
202412,15187000,3S3,0,1,-1,0
202412,15187000,CA,0,2,-2,0
202412,15189000,2,18,3,15,6
202412,15189000,CA,0,1,-1,0
202412,15204000,2,0,44,-44,0
202412,15204000,2S2,0,2,-2,0
202412,15204000,3S2,0,2,-2,0
202412,15204000,3S3,1,12,-11,0.08
202412,15204000,CA,0,20,-20,0
202412,15212000,2,0,1,-1,0
202412,15215000,2,1,5,-4,0.2
202412,15215000,3S2,7,0,7,NA
202412,15215000,3S3,406,0,406,NA
202412,15215000,CA,1,1,0,1
202412,15218000,2,0,2,-2,0
202412,15218000,3S3,67,0,67,NA
202412,15223000,2,1,29,-28,0.03
202412,15223000,3S3,0,2,-2,0
202412,15224000,2,0,4,-4,0
202412,15232001,2,1,1,0,1
202412,15236000,2,0,6,-6,0
202412,15236000,3,0,2,-2,0
202412,15236000,CA,0,1,-1,0
202412,15238000,2,1528,1732,-204,0.88
202412,15238000,2R2,0,7,-7,0
202412,15238000,2S2,9,56,-47,0.16
202412,15238000,2S3,6,34,-28,0.18
202412,15238000,3,93,59,34,1.58
202412,15238000,3S1,0,1,-1,0
202412,15238000,3S2,19,109,-90,0.17
202412,15238000,3S3,541,774,-233,0.7
202412,15238000,3S4,1,0,1,NA
202412,15238000,CA,658,614,44,1.07
202412,15238000,V2,16,0,16,NA
202412,15238002,2,0,4,-4,0
202412,15238011,2,0,33,-33,0
202412,15238011,CA,0,17,-17,0
202412,15244000,2,0,18,-18,0
202412,15244000,CA,0,2,-2,0
202412,15248000,2,0,5,-5,0
202412,15248000,CA,12,10,2,1.2
202412,15272000,2,0,7,-7,0
202412,15272000,3S3,0,2,-2,0
202412,15272000,CA,0,5,-5,0
202412,15276000,2,0,9,-9,0
202412,15276000,CA,0,2,-2,0
202412,15293000,2,0,9,-9,0
202412,15293000,CA,0,3,-3,0
202412,15296000,2,0,5,-5,0
202412,15296000,CA,0,5,-5,0
202412,15299000,2,38,230,-192,0.17
202412,15299000,3,0,11,-11,0
202412,15299000,CA,27,62,-35,0.44
202412,15317000,2,0,2,-2,0
202412,15322000,2,7,158,-151,0.04
202412,15322000,3,4,18,-14,0.22
202412,15322000,3S3,1,0,1,NA
202412,15322000,CA,3,30,-27,0.1
202412,15322008,2,0,8,-8,0
202412,15322008,3,0,4,-4,0
202412,15322008,CA,0,12,-12,0
202412,15325000,2,0,12,-12,0
202412,15325000,CA,0,2,-2,0
202412,15332000,2,1,8,-7,0.12
202412,15332005,2,0,15,-15,0
202412,15362000,2,0,4,-4,0
202412,15362000,CA,0,5,-5,0
202412,15367000,2,0,8,-8,0
202412,15367000,CA,1,4,-3,0.25
202412,15368000,2,0,5,-5,0
202412,15377000,2,0,5,-5,0
202412,15377000,3S3,2,1,1,2
202412,15380000,2,0,53,-53,0
202412,15380000,CA,0,1,-1,0
202412,15401000,2,0,4,-4,0
202412,15401000,CA,0,1,-1,0
202412,15403000,2,0,10,-10,0
202412,15407000,2,12,242,-230,0.05
202412,15407000,3,4,32,-28,0.12
202412,15407000,3S2,0,1,-1,0
202412,15407000,3S2S3,0,1,-1,0
202412,15407000,3S3,0,5,-5,0
202412,15407000,CA,6,157,-151,0.04
202412,15425000,2,0,6,-6,0
202412,15425000,CA,1,0,1,NA
202412,15442001,2,0,1,-1,0
202412,15455000,2,4,30,-26,0.13
202412,15455000,3,0,2,-2,0
202412,15455000,3S3,0,7,-7,0
202412,15455000,3S4,0,1,-1,0
202412,15455000,CA,19,44,-25,0.43
202412,15464000,2,1,4,-3,0.25
202412,15464000,3S3,22,0,22,NA
202412,15464000,CA,0,2,-2,0
202412,15466000,2,0,18,-18,0
202412,15466000,CA,0,12,-12,0
202412,15469000,2,8,195,-187,0.04
202412,15469000,2S3,0,2,-2,0
202412,15469000,3,0,1,-1,0
202412,15469000,3S2,1,0,1,NA
202412,15469000,3S3,3,11,-8,0.27
202412,15469000,CA,3,68,-65,0.04
202412,15476000,2,1,11,-10,0.09
202412,15476000,2S2,0,1,-1,0
202412,15476000,CA,0,2,-2,0
202412,15480000,2,1,30,-29,0.03
202412,15480000,CA,0,2,-2,0
202412,15491000,2,578,265,313,2.18
202412,15491000,2S3,1,1,0,1
202412,15491000,3,97,1,96,97
202412,15491000,3S2,82,47,35,1.74
202412,15491000,3S3,3626,1038,2588,3.49
202412,15491000,CA,3,26,-23,0.12
202412,15491000,V2,0,8,-8,0
202412,15491000,V3,1,33,-32,0.03
202412,15491000,V3R2,0,1,-1,0
202412,15491000,V4,5,0,5,NA
202412,15491001,2,157,80,77,1.96
202412,15491001,2S3,0,1,-1,0
202412,15491001,3,0,1,-1,0
202412,15491001,3S3,255,292,-37,0.87
202412,15491001,4,2,0,2,NA
202412,15491001,CA,0,3,-3,0
202412,15491001,V3,2,0,2,NA
202412,15491004,2,1,3,-2,0.33
202412,15491006,2,0,21,-21,0
202412,15491006,2B2,0,1,-1,0
202412,15491006,2R3,0,2,-2,0
202412,15491007,3S3,1,11,-10,0.09
202412,15494000,2,0,7,-7,0
202412,15494000,CA,0,7,-7,0
202412,15500000,2,33,6,27,5.5
202412,15500000,3,14,2,12,7
202412,15500000,3S2,0,5,-5,0
202412,15500000,3S3,7,125,-118,0.06
202412,15500000,CA,0,4,-4,0
202412,15507000,2,4,19,-15,0.21
202412,15507000,3,1,4,-3,0.25
202412,15507000,3S2,0,1,-1,0
202412,15507000,CA,0,13,-13,0
202412,15507000,V3,2,0,2,NA
202412,15511000,2,0,3,-3,0
202412,15511000,CA,0,1,-1,0
202412,15514000,2,1,18,-17,0.06
202412,15514000,3,0,3,-3,0
202412,15514000,3S2,0,1,-1,0
202412,15514000,3S3,0,1,-1,0
202412,15514000,CA,8,10,-2,0.8
202412,15516000,2,42,302,-260,0.14
202412,15516000,3,2,6,-4,0.33
202412,15516000,3S2,25,2,23,12.5
202412,15516000,3S3,153,30,123,5.1
202412,15516000,CA,26,175,-149,0.15
202412,15516000,V3,2,3,-1,0.67
202412,15516000,V4,4,0,4,NA
202412,15516001,2,0,1,-1,0
202412,15516002,2,0,1,-1,0
202412,15516006,2,1,0,1,NA
202412,15518000,2,4,6,-2,0.67
202412,15518000,2S2,1,1,0,1
202412,15518000,3,2,1,1,2
202412,15518000,3S2,2,2,0,1
202412,15518000,3S3,0,2,-2,0
202412,15518000,CA,1,3,-2,0.33
202412,15518000,V3,0,6,-6,0
202412,15518001,2,0,3,-3,0
202412,15531000,2,0,16,-16,0
202412,15531000,CA,0,1,-1,0
202412,15533000,2,0,4,-4,0
202412,15537000,2,4,43,-39,0.09
202412,15537000,3,1,2,-1,0.5
202412,15537000,3S2,0,1,-1,0
202412,15537000,3S3,414,12,402,34.5
202412,15537000,CA,4,5,-1,0.8
202412,15537000,V2,10,0,10,NA
202412,15537000,V3,12,0,12,NA
202412,15537000,V4,29,0,29,NA
202412,15537001,2,0,1,-1,0
202412,15542000,2,4,18,-14,0.22
202412,15542000,3S2,0,1,-1,0
202412,15542000,3S3,6,7,-1,0.86
202412,15542000,CA,1,7,-6,0.14
202412,15572000,2,36,711,-675,0.05
202412,15572000,2R2,0,8,-8,0
202412,15572000,2S2,1,7,-6,0.14
202412,15572000,2S3,2,4,-2,0.5
202412,15572000,3,8,39,-31,0.21
202412,15572000,3S2,16,275,-259,0.06
202412,15572000,3S3,61,967,-906,0.06
202412,15572000,3S4,3,0,3,NA
202412,15572000,CA,44,211,-167,0.21
202412,15572000,V2,22,2,20,11
202412,15572000,V3,120,35,85,3.43
202412,15572006,3S3,0,1,-1,0
202412,15572006,CA,0,1,-1,0
202412,15572007,2,1,6,-5,0.17
202412,15572007,3S3,0,5,-5,0
202412,15572014,2,1,4,-3,0.25
202412,15572014,3S2,0,74,-74,0
202412,15572014,3S3,0,148,-148,0
202412,15580000,2,0,6,-6,0
202412,15580000,CA,0,4,-4,0
202412,15599000,2,0,47,-47,0
202412,15599000,3S3,0,6,-6,0
202412,15599000,CA,0,16,-16,0
202412,15600000,2,3,6,-3,0.5
202412,15600000,3S3,43,5,38,8.6
202412,15600000,CA,25,47,-22,0.53
202412,15600000,V3,19,0,19,NA
202412,15600000,V4,106,0,106,NA
202412,15621000,2,0,6,-6,0
202412,15621000,CA,0,1,-1,0
202412,15632000,2,0,14,-14,0
202412,15632000,3S3,1,0,1,NA
202412,15632000,CA,0,5,-5,0
202412,15632001,2,0,1,-1,0
202412,15638000,2,1,10,-9,0.1
202412,15638000,3S3,0,1,-1,0
202412,15638000,CA,0,19,-19,0
202412,15646000,2,5,125,-120,0.04
202412,15646000,2S2,0,1,-1,0
202412,15646000,2S3,4,1,3,4
202412,15646000,3,21,26,-5,0.81
202412,15646000,3S2,5,7,-2,0.71
202412,15646000,3S3,2550,442,2108,5.77
202412,15646000,3S4,0,4,-4,0
202412,15646000,4,1,15,-14,0.07
202412,15646000,CA,4,26,-22,0.15
202412,15646000,V2,6,54,-48,0.11
202412,15646000,V3,304,510,-206,0.6
202412,15646000,V4,62,196,-134,0.32
202412,15646001,2,0,2,-2,0
202412,15660000,2,0,1,-1,0
202412,15660000,CA,0,21,-21,0
202412,15664000,2,0,8,-8,0
202412,15664000,3,2,0,2,NA
202412,15664000,3S3,0,1,-1,0
202412,15664000,CA,0,2,-2,0
202412,15667000,2,1,12,-11,0.08
202412,15667000,3,0,1,-1,0
202412,15667000,CA,26,27,-1,0.96
202412,15673000,2,0,7,-7,0
202412,15673000,CA,1,0,1,NA
202412,15676000,2,0,22,-22,0
202412,15676000,3S3,0,1,-1,0
202412,15681000,2,0,1,-1,0
202412,15681000,CA,0,2,-2,0
202412,15681007,2,0,1,-1,0
202412,15686000,2,26,83,-57,0.31
202412,15686000,3,0,8,-8,0
202412,15686000,3S3,0,15,-15,0
202412,15686000,CA,1,10,-9,0.1
202412,15686000,V2,0,1,-1,0
202412,15690000,2,3,23,-20,0.13
202412,15690000,2S2,1,0,1,NA
202412,15690000,3,4,14,-10,0.29
202412,15690000,CA,1,2,-1,0.5
202412,15693000,2,0,61,-61,0
202412,15693000,2S2,0,2,-2,0
202412,15693000,3,0,4,-4,0
202412,15693000,3S2,0,2,-2,0
202412,15693000,3S3,0,2,-2,0
202412,15693000,CA,0,9,-9,0
202412,15696000,2,0,20,-20,0
202412,15696000,CA,0,9,-9,0
202412,15720000,2,0,8,-8,0
202412,15720000,CA,0,2,-2,0
202412,15723000,2,0,3,-3,0
202412,15723000,CA,0,1,-1,0
202412,15740000,2,0,9,-9,0
202412,15740000,3S3,0,2,-2,0
202412,15740000,CA,0,5,-5,0
202412,15753000,2,5,76,-71,0.07
202412,15753000,3,0,1,-1,0
202412,15753000,3S2,0,2,-2,0
202412,15753000,3S3,0,20,-20,0
202412,15753000,CA,44,78,-34,0.56
202412,15753006,3S3,1,0,1,NA
202412,15755000,2,2,10,-8,0.2
202412,15755000,3,0,3,-3,0
202412,15755000,3S3,41,0,41,NA
202412,15755000,CA,0,3,-3,0
202412,15757000,2,26,57,-31,0.46
202412,15757000,3,1,3,-2,0.33
202412,15757000,3S2,14,1,13,14
202412,15757000,3S3,1225,12,1213,102.08
202412,15757000,4,9,0,9,NA
202412,15757000,CA,0,18,-18,0
202412,15757000,V2,1,3,-2,0.33
202412,15757000,V3,43,13,30,3.31
202412,15757000,V4,53,4,49,13.25
202412,15757000,V4R2,11,0,11,NA
202412,15757003,3S3,11,0,11,NA
202412,15759000,2,476,2496,-2020,0.19
202412,15759000,2R2,0,20,-20,0
202412,15759000,2S2,21,29,-8,0.72
202412,15759000,2S3,9,9,0,1
202412,15759000,3,135,84,51,1.61
202412,15759000,3S2,236,64,172,3.69
202412,15759000,3S3,2020,798,1222,2.53
202412,15759000,4,0,1,-1,0
202412,15759000,CA,31,1074,-1043,0.03
202412,15759000,V2,13,0,13,NA
202412,15759000,V3,22,39,-17,0.56
202412,15759000,V4,7,0,7,NA
202412,15759001,2,0,1,-1,0
202412,15761000,2,0,24,-24,0
202412,15761000,CA,0,2,-2,0
202412,15762000,2,1,3,-2,0.33
202412,15762000,3S2,1,0,1,NA
202412,15762000,3S3,0,2,-2,0
202412,15762000,CA,0,1,-1,0
202412,15763000,2,13,32,-19,0.41
202412,15763000,2S3,3,10,-7,0.3
202412,15763000,3,0,8,-8,0
202412,15763000,3S2,1,25,-24,0.04
202412,15763000,3S3,2,7,-5,0.29
202412,15763000,CA,5,15,-10,0.33
202412,15764000,2,3,67,-64,0.04
202412,15764000,2S2,1,2,-1,0.5
202412,15764000,2S3,0,1,-1,0
202412,15764000,3,1,2,-1,0.5
202412,15764000,3S2,2,3,-1,0.67
202412,15764000,3S3,4,23,-19,0.17
202412,15764000,CA,0,39,-39,0
202412,15774000,2,0,5,-5,0
202412,15774000,CA,0,1,-1,0
202412,15776000,2,3,27,-24,0.11
202412,15776000,2S3,0,1,-1,0
202412,15776000,3,0,1,-1,0
202412,15776000,3S2,1,1,0,1
202412,15776000,3S3,2,4,-2,0.5
202412,15776000,CA,0,21,-21,0
202412,15778000,2,0,8,-8,0
202412,15778000,CA,0,2,-2,0
202412,15790000,2,0,10,-10,0
202412,15790000,3,1,1,0,1
202412,15790000,3S2,1,1,0,1
202412,15790000,3S3,223,0,223,NA
202412,15790000,CA,0,9,-9,0
202412,15790000,V2,3,1,2,3
202412,15790000,V3,26,0,26,NA
202412,15790000,V4,4,0,4,NA
202412,15798000,2,0,12,-12,0
202412,15798000,CA,0,1,-1,0
202412,15804000,2,0,29,-29,0
202412,15804000,3,0,1,-1,0
202412,15804000,3S3,0,2,-2,0
202412,15804000,CA,0,7,-7,0
202412,15806000,2,12,421,-409,0.03
202412,15806000,2S2,33,404,-371,0.08
202412,15806000,2S3,46,152,-106,0.3
202412,15806000,3,1,3,-2,0.33
202412,15806000,3S1,0,1,-1,0
202412,15806000,3S2,2,3,-1,0.67
202412,15806000,3S3,2236,1392,844,1.61
202412,15806000,CA,9,46,-37,0.2
202412,15806000,V3,0,1,-1,0
202412,15808000,2,0,7,-7,0
202412,15808000,3S3,0,1,-1,0
202412,15808000,CA,0,26,-26,0
202412,15810000,2,0,5,-5,0
202412,15814000,2,10,71,-61,0.14
202412,15814000,3S2,0,1,-1,0
202412,15814000,3S3,0,7,-7,0
202412,15814000,CA,14,32,-18,0.44
202412,15816000,2,0,5,-5,0
202412,15816000,3,1,0,1,NA
202412,15816000,3S3,0,1,-1,0
202412,15820000,2,2,6,-4,0.33
202412,15820000,3S2,17,0,17,NA
202412,15820000,3S3,284,0,284,NA
202412,15820000,CA,0,2,-2,0
202412,15820000,V3,26,0,26,NA
202412,15822000,2,0,4,-4,0
202412,15822000,CA,0,1,-1,0
202412,15835000,2,0,13,-13,0
202412,15835000,3S3,0,3,-3,0
202412,15835000,CA,0,3,-3,0
202412,15837000,2,334,330,4,1.01
202412,15837000,2S2,0,5,-5,0
202412,15837000,2S3,0,5,-5,0
202412,15837000,3,52,44,8,1.18
202412,15837000,3S2,9,35,-26,0.26
202412,15837000,3S3,740,1448,-708,0.51
202412,15837000,CA,2,17,-15,0.12
202412,15837000,V2,0,23,-23,0
202412,15837000,V3,238,0,238,NA
202412,15837006,3S3,12,0,12,NA
202412,15842000,2,0,8,-8,0
202412,15842000,3S3,0,1,-1,0
202412,15842000,CA,0,8,-8,0
202412,15861000,2,14,63,-49,0.22
202412,15861000,3,0,2,-2,0
202412,15861000,3S3,2,7,-5,0.29
202412,15861000,CA,5,19,-14,0.26
202412,15861005,2,0,1,-1,0
202412,15861007,3S3,0,1,-1,0
202412,15861008,3S3,0,1,-1,0
202412,15879000,2,0,8,-8,0
202412,15879000,CA,0,2,-2,0
202412,15897000,2,0,17,-17,0
202412,15897000,3,0,3,-3,0
202412,15897000,3S2,1,0,1,NA
202412,15897000,CA,0,5,-5,0
202412,17001000,2,5982,6888,-906,0.87
202412,17001000,2R2,3,0,3,NA
202412,17001000,2S2,464,607,-143,0.76
202412,17001000,2S3,98,184,-86,0.53
202412,17001000,3,129,139,-10,0.93
202412,17001000,3S1,0,2,-2,0
202412,17001000,3S2,507,368,139,1.38
202412,17001000,3S3,1864,2100,-236,0.89
202412,17001000,3S4,1,6,-5,0.17
202412,17001000,4,6,7,-1,0.86
202412,17001000,CA,1185,2260,-1075,0.52
202412,17001027,3S2,0,1,-1,0
202412,17001027,3S3,0,36,-36,0
202412,17001029,2,0,1,-1,0
202412,17013000,2,56,254,-198,0.22
202412,17013000,3,0,22,-22,0
202412,17013000,3S3,0,3,-3,0
202412,17013000,CA,1,54,-53,0.02
202412,17013000,V3,0,6,-6,0
202412,17042000,2,42,201,-159,0.21
202412,17042000,3,1,4,-3,0.25
202412,17042000,3S2,4,7,-3,0.57
202412,17042000,3S3,51,45,6,1.13
202412,17042000,3S4,0,1,-1,0
202412,17042000,CA,0,80,-80,0
202412,17050000,2,159,71,88,2.24
202412,17050000,3S3,0,18,-18,0
202412,17050000,CA,0,28,-28,0
202412,17050006,2,0,2,-2,0
202412,17088000,2,6,67,-61,0.09
202412,17088000,2S2,2,0,2,NA
202412,17088000,3S3,0,1,-1,0
202412,17088000,CA,0,10,-10,0
202412,17174000,2,315,784,-469,0.4
202412,17174000,2R2,0,31,-31,0
202412,17174000,2S2,16,44,-28,0.36
202412,17174000,2S3,33,35,-2,0.94
202412,17174000,3,36,12,24,3
202412,17174000,3S2,70,36,34,1.94
202412,17174000,3S3,411,416,-5,0.99
202412,17174000,4,26,0,26,NA
202412,17174000,CA,12,238,-226,0.05
202412,17272000,2,1,27,-26,0.04
202412,17272000,2S3,0,1,-1,0
202412,17272000,CA,0,23,-23,0
202412,17272005,2,0,3,-3,0
202412,17380000,2,701,980,-279,0.72
202412,17380000,2R2,0,3,-3,0
202412,17380000,2S2,4,9,-5,0.44
202412,17380000,2S3,2,0,2,NA
202412,17380000,3,34,26,8,1.31
202412,17380000,3S2,17,6,11,2.83
202412,17380000,3S3,112,214,-102,0.52
202412,17380000,3S4,1,1,0,1
202412,17380000,4,0,1,-1,0
202412,17380000,CA,337,251,86,1.34
202412,17380000,V2,0,1,-1,0
202412,17380000,V3,0,1,-1,0
202412,17380001,2,0,1,-1,0
202412,17380002,2,1,6,-5,0.17
202412,17380002,3S2,0,1,-1,0
202412,17380002,3S3,0,2,-2,0
202412,17380003,2,0,1,-1,0
202412,17380009,2,0,1,-1,0
202412,17388000,2,0,13,-13,0
202412,17388000,CA,0,15,-15,0
202412,17388002,2,0,2,-2,0
202412,17388002,3S3,1,3,-2,0.33
202412,17388008,2,0,6,-6,0
202412,17433000,2,45,96,-51,0.47
202412,17433000,3,6,4,2,1.5
202412,17433000,3S3,4,8,-4,0.5
202412,17433000,CA,0,51,-51,0
202412,17433000,V3,0,1,-1,0
202412,17442000,2,31,117,-86,0.26
202412,17442000,3,1,22,-21,0.05
202412,17442000,3S2,0,2,-2,0
202412,17442000,3S3,2,6,-4,0.33
202412,17442000,CA,3,34,-31,0.09
202412,17444000,2,35,89,-54,0.39
202412,17444000,3,0,5,-5,0
202412,17444000,3S3,0,6,-6,0
202412,17444000,CA,0,10,-10,0
202412,17444000,V3,0,1,-1,0
202412,17446000,2,0,5,-5,0
202412,17446000,CA,0,5,-5,0
202412,17486000,2,30,131,-101,0.23
202412,17486000,2S2,0,1,-1,0
202412,17486000,3,1,6,-5,0.17
202412,17486000,3S3,1,19,-18,0.05
202412,17486000,CA,0,80,-80,0
202412,17486008,3S3,0,2,-2,0
202412,17486009,4,0,1,-1,0
202412,17486012,CA,0,3,-3,0
202412,17495000,2,1,28,-27,0.04
202412,17495000,3,0,10,-10,0
202412,17495000,3S3,26,1,25,26
202412,17495000,CA,2,20,-18,0.1
202412,17495000,V3,0,2,-2,0
202412,17513000,2,6,72,-66,0.08
202412,17513000,3,0,16,-16,0
202412,17513000,CA,2,11,-9,0.18
202412,17524000,2,0,103,-103,0
202412,17524000,3S2,0,3,-3,0
202412,17524000,3S3,0,6,-6,0
202412,17524000,CA,0,53,-53,0
202412,17524001,2,13,49,-36,0.27
202412,17524001,2S2,0,1,-1,0
202412,17524001,3,1,2,-1,0.5
202412,17524001,3S3,0,146,-146,0
202412,17524001,CA,0,22,-22,0
202412,17524003,2,0,19,-19,0
202412,17524005,2,0,2,-2,0
202412,17524005,3S3,2,0,2,NA
202412,17524005,CA,0,1,-1,0
202412,17524008,3,0,1,-1,0
202412,17541000,2,28,134,-106,0.21
202412,17541000,3,0,1,-1,0
202412,17541000,3S3,8,17,-9,0.47
202412,17541000,CA,4,97,-93,0.04
202412,17541000,V3,0,4,-4,0
202412,17541002,2,6,10,-4,0.6
202412,17614000,2,2,280,-278,0.01
202412,17614000,2R2,0,14,-14,0
202412,17614000,2S2,0,2,-2,0
202412,17614000,3,1,5,-4,0.2
202412,17614000,3S2,2,0,2,NA
202412,17614000,3S3,28,49,-21,0.57
202412,17614000,CA,2,161,-159,0.01
202412,17614004,2,0,9,-9,0
202412,17614004,3,0,4,-4,0
202412,17614004,3S3,0,2,-2,0
202412,17616000,2,3,54,-51,0.06
202412,17616000,2S2,0,1,-1,0
202412,17616000,3,0,3,-3,0
202412,17616000,3S3,0,1,-1,0
202412,17616000,4,0,2,-2,0
202412,17616000,CA,0,33,-33,0
202412,17653000,2,9,132,-123,0.07
202412,17653000,3,0,6,-6,0
202412,17653000,3S3,0,1,-1,0
202412,17653000,CA,0,29,-29,0
202412,17653007,2,0,1,-1,0
202412,17662000,2,24,67,-43,0.36
202412,17662000,3,0,15,-15,0
202412,17662000,3S3,0,1,-1,0
202412,17662000,CA,0,15,-15,0
202412,17662000,V3,0,5,-5,0
202412,17662003,2,3,9,-6,0.33
202412,17662003,3,0,1,-1,0
202412,17662003,CA,0,2,-2,0
202412,17662007,2,0,4,-4,0
202412,17665000,2,0,3,-3,0
202412,17665000,CA,0,2,-2,0
202412,17777000,2,4,396,-392,0.01
202412,17777000,2R2,0,12,-12,0
202412,17777000,3,2,0,2,NA
202412,17777000,3S3,1,15,-14,0.07
202412,17777000,3S4,0,1,-1,0
202412,17777000,CA,1,241,-240,0
202412,17867000,2,1,30,-29,0.03
202412,17867000,3S3,0,3,-3,0
202412,17867000,CA,0,10,-10,0
202412,17867003,2,0,3,-3,0
202412,17867004,2,0,3,-3,0
202412,17873000,2,23,383,-360,0.06
202412,17873000,2S2,6,1,5,6
202412,17873000,3,0,8,-8,0
202412,17873000,3S2,0,1,-1,0
202412,17873000,3S3,1,32,-31,0.03
202412,17873000,CA,4,172,-168,0.02
202412,17873004,2,3,0,3,NA
202412,17873004,3,2,0,2,NA
202412,17873004,3S3,7,0,7,NA
202412,17873004,CA,0,3,-3,0
202412,17873016,CA,0,1,-1,0
202412,17877000,2,61,150,-89,0.41
202412,17877000,3,3,25,-22,0.12
202412,17877000,3S2,4,1,3,4
202412,17877000,3S3,1,71,-70,0.01
202412,17877000,CA,1,58,-57,0.02
202412,18001000,2,435,1922,-1487,0.23
202412,18001000,2R2,0,5,-5,0
202412,18001000,2S2,0,42,-42,0
202412,18001000,2S3,0,3,-3,0
202412,18001000,3,28,115,-87,0.24
202412,18001000,3S2,1,46,-45,0.02
202412,18001000,3S3,99,540,-441,0.18
202412,18001000,4,0,1,-1,0
202412,18001000,CA,77,274,-197,0.28
202412,18001000,V2,0,1,-1,0
202412,18001002,2,0,1,-1,0
202412,18001013,2,0,3,-3,0
202412,18029000,2,0,9,-9,0
202412,18029000,2S3,0,1,-1,0
202412,18029000,3,1,0,1,NA
202412,18029000,3S2,1,0,1,NA
202412,18029000,3S3,0,1,-1,0
202412,18029000,CA,0,1,-1,0
202412,18094000,2,1,7,-6,0.14
202412,18094000,3S3,0,3,-3,0
202412,18094000,CA,0,1,-1,0
202412,18094007,2,1,0,1,NA
202412,18150000,2,3,79,-76,0.04
202412,18150000,3,0,13,-13,0
202412,18150000,3S3,14,36,-22,0.39
202412,18150000,4,0,1,-1,0
202412,18150000,CA,1,17,-16,0.06
202412,18205000,2,1,14,-13,0.07
202412,18205000,3,0,3,-3,0
202412,18205000,3S3,8,1,7,8
202412,18205000,CA,0,17,-17,0
202412,18247000,2,1,63,-62,0.02
202412,18247000,3,0,3,-3,0
202412,18247000,3S3,0,12,-12,0
202412,18247000,CA,0,8,-8,0
202412,18247005,2,0,1,-1,0
202412,18256000,2,1,45,-44,0.02
202412,18256000,3S2,0,1,-1,0
202412,18256000,3S3,0,1,-1,0
202412,18256000,CA,0,2,-2,0
202412,18410000,2,0,3,-3,0
202412,18410000,3S2,1,0,1,NA
202412,18410000,3S3,0,1,-1,0
202412,18460000,2,2,1,1,2
202412,18460000,V2,1,0,1,NA
202412,18460001,3S3,0,1,-1,0
202412,18479000,2,1,5,-4,0.2
202412,18479000,3S2,0,1,-1,0
202412,18479000,3S3,0,12,-12,0
202412,18592000,2,0,37,-37,0
202412,18592000,2S3,0,1,-1,0
202412,18592000,3,0,2,-2,0
202412,18592000,3S2,0,1,-1,0
202412,18592000,3S3,0,4,-4,0
202412,18592000,CA,3,18,-15,0.17
202412,18610000,2,0,15,-15,0
202412,18610000,3S3,0,2,-2,0
202412,18610000,CA,0,2,-2,0
202412,18610001,2,0,5,-5,0
202412,18610001,CA,0,1,-1,0
202412,18610002,3S2,7,0,7,NA
202412,18610002,3S3,34,0,34,NA
202412,18753000,2,11,425,-414,0.03
202412,18753000,2S2,3,1,2,3
202412,18753000,3,0,15,-15,0
202412,18753000,3S2,1,4,-3,0.25
202412,18753000,3S3,31,49,-18,0.63
202412,18753000,CA,1,40,-39,0.03
202412,18753003,2,0,24,-24,0
202412,18753003,CA,0,3,-3,0
202412,18753004,2,0,1,-1,0
202412,18753006,2,0,4,-4,0
202412,18756008,2,0,8,-8,0
202412,18756008,2S3,0,2,-2,0
202412,18756008,3,1,0,1,NA
202412,18756008,3S3,0,1,-1,0
202412,18756008,CA,0,1,-1,0
202412,18785000,2,1,7,-6,0.14
202412,18785000,3,0,24,-24,0
202412,18785000,3S2,1,0,1,NA
202412,18785000,3S3,1,1,0,1
202412,18785000,CA,0,2,-2,0
202412,18860000,2,1,3,-2,0.33
202412,18860000,CA,1,0,1,NA
202412,19001000,2,909,4059,-3150,0.22
202412,19001000,2R2,0,2,-2,0
202412,19001000,2S2,5,101,-96,0.05
202412,19001000,2S3,4,27,-23,0.15
202412,19001000,3,14,134,-120,0.1
202412,19001000,3S2,40,103,-63,0.39
202412,19001000,3S3,283,911,-628,0.31
202412,19001000,3S4,0,1,-1,0
202412,19001000,CA,355,923,-568,0.38
202412,19001008,2,7,0,7,NA
202412,19001010,2S3,0,1,-1,0
202412,19001019,CA,0,1,-1,0
202412,19022000,2,1,29,-28,0.03
202412,19050000,2,4,100,-96,0.04
202412,19050000,3,0,3,-3,0
202412,19050000,CA,0,12,-12,0
202412,19050000,V3,0,1,-1,0
202412,19050001,2,0,11,-11,0
202412,19050001,3,0,1,-1,0
202412,19050006,2,0,36,-36,0
202412,19050006,4,0,1,-1,0
202412,19050006,CA,0,2,-2,0
202412,19050007,2,0,6,-6,0
202412,19050008,2,0,3,-3,0
202412,19075000,2,0,94,-94,0
202412,19075000,3S2,0,2,-2,0
202412,19075000,CA,0,13,-13,0
202412,19075002,2,0,1,-1,0
202412,19100000,2,2,50,-48,0.04
202412,19100000,3,0,5,-5,0
202412,19100000,3S2,1,2,-1,0.5
202412,19100000,3S3,0,3,-3,0
202412,19100000,CA,0,3,-3,0
202412,19100004,2,0,3,-3,0
202412,19100021,2,0,3,-3,0
202412,19110000,2,1,13,-12,0.08
202412,19110000,3,0,4,-4,0
202412,19110000,CA,0,1,-1,0
202412,19110003,2,0,1,-1,0
202412,19110008,2,0,1,-1,0
202412,19110012,2,1,4,-3,0.25
202412,19130000,2,0,31,-31,0
202412,19130000,2S2,0,1,-1,0
202412,19130000,3,0,14,-14,0
202412,19130000,CA,0,25,-25,0
202412,19130012,3S3,1,0,1,NA
202412,19137000,2,0,17,-17,0
202412,19137000,3,0,3,-3,0
202412,19137000,CA,0,38,-38,0
202412,19137004,2,2,6,-4,0.33
202412,19137008,2,0,1,-1,0
202412,19137008,CA,1,0,1,NA
202412,19142000,2,1615,736,879,2.19
202412,19142000,2B1,10,1,9,10
202412,19142000,2B2,3,1,2,3
202412,19142000,2R2,2,0,2,NA
202412,19142000,2S1,0,5,-5,0
202412,19142000,2S2,150,140,10,1.07
202412,19142000,2S3,21,40,-19,0.52
202412,19142000,3,55,24,31,2.29
202412,19142000,3S1,0,4,-4,0
202412,19142000,3S2,199,91,108,2.19
202412,19142000,3S3,948,708,240,1.34
202412,19142000,CA,218,212,6,1.03
202412,19142001,3S3,0,2,-2,0
202412,19142006,2,208,72,136,2.89
202412,19142006,2S2,23,6,17,3.83
202412,19142006,2S3,8,3,5,2.67
202412,19142006,3,5,0,5,NA
202412,19142006,3S2,88,54,34,1.63
202412,19142006,3S3,286,212,74,1.35
202412,19142006,CA,0,7,-7,0
202412,19142020,CA,0,1,-1,0
202412,19142028,3S3,0,1,-1,0
202412,19212000,2,1,130,-129,0.01
202412,19212000,3,0,5,-5,0
202412,19212000,3S2,0,2,-2,0
202412,19212000,CA,2,74,-72,0.03
202412,19256000,2,0,76,-76,0
202412,19256000,3,0,4,-4,0
202412,19256000,3S3,4,7,-3,0.57
202412,19256000,CA,1,9,-8,0.11
202412,19256006,2,0,1,-1,0
202412,19256014,2,0,5,-5,0
202412,19256018,2,1,18,-17,0.06
202412,19256018,2S3,2,0,2,NA
202412,19256018,3S2,1,0,1,NA
202412,19256018,3S3,3,3,0,1
202412,19256018,CA,0,14,-14,0
202412,19256025,2,1,0,1,NA
202412,19256028,2,0,1,-1,0
202412,19256033,2,1,0,1,NA
202412,19290000,2,1,71,-70,0.01
202412,19290000,3S3,0,10,-10,0
202412,19290000,CA,1,2,-1,0.5
202412,19300000,2,310,90,220,3.44
202412,19300000,2S2,114,35,79,3.26
202412,19300000,2S3,24,9,15,2.67
202412,19300000,3,0,1,-1,0
202412,19300000,3S1,5,0,5,NA
202412,19300000,3S2,41,19,22,2.16
202412,19300000,3S3,210,159,51,1.32
202412,19300000,CA,44,5,39,8.8
202412,19300000,V2,0,1,-1,0
202412,19318000,2,0,4,-4,0
202412,19318010,2,0,1,-1,0
202412,19355000,2,3,16,-13,0.19
202412,19355000,3,0,8,-8,0
202412,19355000,3S3,0,1,-1,0
202412,19355000,CA,0,2,-2,0
202412,19355012,2,2,13,-11,0.15
202412,19355012,CA,0,2,-2,0
202412,19364000,2,0,1,-1,0
202412,19392000,2,1,20,-19,0.05
202412,19392000,3S3,0,1,-1,0
202412,19392000,CA,0,6,-6,0
202412,19397000,2,0,23,-23,0
202412,19397000,3S2,1,0,1,NA
202412,19397000,CA,0,3,-3,0
202412,19418020,3S3,0,4,-4,0
202412,19418020,CA,0,1,-1,0
202412,19418033,2,0,1,-1,0
202412,19450000,2,2,81,-79,0.02
202412,19450000,3,2,4,-2,0.5
202412,19450000,3S3,2,5,-3,0.4
202412,19450000,CA,0,6,-6,0
202412,19450019,2,2,3,-1,0.67
202412,19450019,3S3,0,1,-1,0
202412,19455000,2,80,181,-101,0.44
202412,19455000,2S2,15,12,3,1.25
202412,19455000,2S3,4,12,-8,0.33
202412,19455000,3,9,9,0,1
202412,19455000,3S2,26,10,16,2.6
202412,19455000,3S3,665,74,591,8.99
202412,19455000,CA,10,88,-78,0.11
202412,19455005,2,31,1,30,31
202412,19455005,3,0,1,-1,0
202412,19455005,3S3,173,3,170,57.67
202412,19455005,CA,18,3,15,6
202412,19473000,2,3,51,-48,0.06
202412,19473000,3,0,1,-1,0
202412,19473000,3S3,0,7,-7,0
202412,19473000,CA,0,62,-62,0
202412,19473012,CA,0,1,-1,0
202412,19513000,2,0,22,-22,0
202412,19513000,3,0,1,-1,0
202412,19513000,3S2,0,2,-2,0
202412,19513000,CA,0,2,-2,0
202412,19517000,2,0,9,-9,0
202412,19517000,CA,0,2,-2,0
202412,19517006,CA,0,1,-1,0
202412,19532000,2,11,226,-215,0.05
202412,19532000,3,1,10,-9,0.1
202412,19532000,3S2,1,3,-2,0.33
202412,19532000,3S3,0,20,-20,0
202412,19532000,CA,19,44,-25,0.43
202412,19532004,2,0,1,-1,0
202412,19532005,2,0,2,-2,0
202412,19532008,2,0,30,-30,0
202412,19532008,3S2,0,2,-2,0
202412,19532008,CA,0,6,-6,0
202412,19532009,2,0,1,-1,0
202412,19532009,3,0,8,-8,0
202412,19532013,2,0,6,-6,0
202412,19532013,3,0,3,-3,0
202412,19532013,3S2,0,1,-1,0
202412,19532013,3S3,0,18,-18,0
202412,19533000,2,2,5,-3,0.4
202412,19533000,2S2,0,1,-1,0
202412,19533000,3,28,1,27,28
202412,19533000,3S3,0,1,-1,0
202412,19533000,CA,0,2,-2,0
202412,19548000,2,12,154,-142,0.08
202412,19548000,2S2,0,4,-4,0
202412,19548000,3,0,1,-1,0
202412,19548000,3S2,1,4,-3,0.25
202412,19548000,3S3,0,14,-14,0
202412,19548000,CA,1,38,-37,0.03
202412,19548001,2,0,1,-1,0
202412,19573000,2,1217,515,702,2.36
202412,19573000,2B1,15,0,15,NA
202412,19573000,2R2,10,4,6,2.5
202412,19573000,2S1,0,1,-1,0
202412,19573000,2S2,192,33,159,5.82
202412,19573000,2S3,20,14,6,1.43
202412,19573000,3,34,19,15,1.79
202412,19573000,3S1,0,1,-1,0
202412,19573000,3S2,50,85,-35,0.59
202412,19573000,3S3,359,424,-65,0.85
202412,19573000,CA,149,155,-6,0.96
202412,19585000,2,2,6,-4,0.33
202412,19585000,CA,1,10,-9,0.1
202412,19585001,2,0,2,-2,0
202412,19585001,CA,0,2,-2,0
202412,19585004,2,0,2,-2,0
202412,19622000,2,1,39,-38,0.03
202412,19622000,CA,0,23,-23,0
202412,19693000,2,0,13,-13,0
202412,19693000,CA,0,1,-1,0
202412,19693001,2,0,1,-1,0
202412,19693001,CA,0,2,-2,0
202412,19693005,2,0,3,-3,0
202412,19698000,2,805,1352,-547,0.6
202412,19698000,2B1,5,0,5,NA
202412,19698000,2R3,3,0,3,NA
202412,19698000,2S1,0,11,-11,0
202412,19698000,2S2,153,63,90,2.43
202412,19698000,2S3,53,19,34,2.79
202412,19698000,3,34,79,-45,0.43
202412,19698000,3S1,0,13,-13,0
202412,19698000,3S2,95,124,-29,0.77
202412,19698000,3S3,163,558,-395,0.29
202412,19698000,CA,40,604,-564,0.07
202412,19698000,V2,2,0,2,NA
202412,19698007,2,12,35,-23,0.34
202412,19698007,3,0,1,-1,0
202412,19698007,CA,0,23,-23,0
202412,19698028,2,1,0,1,NA
202412,19698036,2,1,0,1,NA
202412,19701000,2,0,3,-3,0
202412,19701000,3S2,0,1,-1,0
202412,19701000,3S3,0,3,-3,0
202412,19701000,3S4,0,1,-1,0
202412,19701006,2,0,1,-1,0
202412,19701006,3S2,1,0,1,NA
202412,19701006,V2,4,2,2,2
202412,19743000,2,0,38,-38,0
202412,19743000,CA,1,29,-28,0.03
202412,19760000,2,1,6,-5,0.17
202412,19760000,3,0,5,-5,0
202412,19760007,2,0,1,-1,0
202412,19780000,2,3,69,-66,0.04
202412,19780000,2S3,0,1,-1,0
202412,19780000,3,0,14,-14,0
202412,19780000,3S3,0,1,-1,0
202412,19780000,CA,0,18,-18,0
202412,19780001,2,0,2,-2,0
202412,19785000,2,0,10,-10,0
202412,19807000,2,8,172,-164,0.05
202412,19807000,2S3,0,1,-1,0
202412,19807000,3,0,1,-1,0
202412,19807000,3S3,4,4,0,1
202412,19807000,CA,2,58,-56,0.03
202412,19809000,2,0,3,-3,0
202412,19821000,2,0,25,-25,0
202412,19821007,2,0,2,-2,0
202412,19821007,3,1,1,0,1
202412,19824000,2,0,10,-10,0
202412,19824000,CA,0,1,-1,0
202412,19845000,2,1552,350,1202,4.43
202412,19845000,2S1,0,1,-1,0
202412,19845000,2S2,645,131,514,4.92
202412,19845000,2S3,34,27,7,1.26
202412,19845000,3,13,20,-7,0.65
202412,19845000,3S1,0,1,-1,0
202412,19845000,3S2,125,162,-37,0.77
202412,19845000,3S3,149,561,-412,0.27
202412,19845000,4,1,2,-1,0.5
202412,19845000,CA,162,121,41,1.34
202412,20001000,2,3160,6091,-2931,0.52
202412,20001000,2B1,0,3,-3,0
202412,20001000,2R2,61,26,35,2.35
202412,20001000,2S1,0,2,-2,0
202412,20001000,2S2,37,244,-207,0.15
202412,20001000,2S3,7,77,-70,0.09
202412,20001000,3,67,142,-75,0.47
202412,20001000,3S1,0,1,-1,0
202412,20001000,3S2,190,406,-216,0.47
202412,20001000,3S3,487,1664,-1177,0.29
202412,20001000,4,0,5,-5,0
202412,20001000,CA,473,716,-243,0.66
202412,20001000,V2,0,2,-2,0
202412,20001001,2,0,11,-11,0
202412,20001002,2,0,6,-6,0
202412,20001005,2,0,1,-1,0
202412,20001005,3S3,5,1,4,5
202412,20001010,2,2,0,2,NA
202412,20001013,2,7,6,1,1.17
202412,20001013,2S2,1,0,1,NA
202412,20001013,3S2,0,1,-1,0
202412,20001013,3S3,5,6,-1,0.83
202412,20001014,2,0,3,-3,0
202412,20001014,CA,1,2,-1,0.5
202412,20001018,2,3,1,2,3
202412,20001018,2S2,1,1,0,1
202412,20001018,3S2,1,0,1,NA
202412,20001018,3S3,5,4,1,1.25
202412,20001018,CA,0,1,-1,0
202412,20001024,2,1,0,1,NA
202412,20001025,3S3,0,1,-1,0
202412,20001028,3S3,0,1,-1,0
202412,20001031,2,1,9,-8,0.11
202412,20011000,2,414,1514,-1100,0.27
202412,20011000,2R2,0,1,-1,0
202412,20011000,2S2,3,8,-5,0.38
202412,20011000,2S3,4,23,-19,0.17
202412,20011000,3,34,137,-103,0.25
202412,20011000,3S2,359,279,80,1.29
202412,20011000,3S3,339,1783,-1444,0.19
202412,20011000,3S4,3,4,-1,0.75
202412,20011000,4,0,1,-1,0
202412,20011000,CA,55,167,-112,0.33
202412,20011001,2S3,0,1,-1,0
202412,20011001,3S1,1,0,1,NA
202412,20011001,3S2,4,0,4,NA
202412,20011001,3S3,7,2,5,3.5
202412,20011001,3S4,1,1,0,1
202412,20011014,2,10,0,10,NA
202412,20011021,2,0,14,-14,0
202412,20011021,CA,0,1,-1,0
202412,20013000,2,54,314,-260,0.17
202412,20013000,2S2,6,0,6,NA
202412,20013000,3,1,2,-1,0.5
202412,20013000,3S2,19,1,18,19
202412,20013000,3S3,289,621,-332,0.47
202412,20013000,3S4,0,1,-1,0
202412,20013000,4,0,1,-1,0
202412,20013000,CA,25,93,-68,0.27
202412,20013002,2,6,4,2,1.5
202412,20013002,2S2,7,0,7,NA
202412,20013002,2S3,3,0,3,NA
202412,20013002,3S2,1,0,1,NA
202412,20013002,3S3,0,1,-1,0
202412,20013002,CA,0,1,-1,0
202412,20032000,2,4,63,-59,0.06
202412,20032000,2S2,1,0,1,NA
202412,20032000,3,0,1,-1,0
202412,20032000,3S2,2,0,2,NA
202412,20032000,3S3,3,12,-9,0.25
202412,20032000,CA,0,2,-2,0
202412,20032001,2,0,3,-3,0
202412,20032001,2S2,2,0,2,NA
202412,20032001,3,1,0,1,NA
202412,20032001,3S1,0,2,-2,0
202412,20032001,3S2,2,1,1,2
202412,20032001,3S3,22,1,21,22
202412,20032001,3S4,1,1,0,1
202412,20045000,2,39,156,-117,0.25
202412,20045000,2S3,4,0,4,NA
202412,20045000,3S3,2,41,-39,0.05
202412,20045000,CA,0,23,-23,0
202412,20060000,2,271,434,-163,0.62
202412,20060000,2S2,2,26,-24,0.08
202412,20060000,2S3,1,7,-6,0.14
202412,20060000,3,52,18,34,2.89
202412,20060000,3S2,36,198,-162,0.18
202412,20060000,3S3,111,239,-128,0.46
202412,20060000,3S4,1,1,0,1
202412,20060000,CA,16,50,-34,0.32
202412,20060000,V3,9,0,9,NA
202412,20175000,2,7,33,-26,0.21
202412,20175000,2S3,0,1,-1,0
202412,20175000,3S3,0,8,-8,0
202412,20175000,CA,1,18,-17,0.06
202412,20175010,2,0,2,-2,0
202412,20175011,2,2,7,-5,0.29
202412,20175011,CA,0,2,-2,0
202412,20175014,2S3,0,1,-1,0
202412,20175014,3S3,0,2,-2,0
202412,20175016,2,0,1,-1,0
202412,20175016,3S2,0,1,-1,0
202412,20175016,3S3,0,3,-3,0
202412,20178000,2,12,93,-81,0.13
202412,20178000,3,0,3,-3,0
202412,20178000,3S2,0,11,-11,0
202412,20178000,3S3,5,40,-35,0.12
202412,20178000,CA,0,7,-7,0
202412,20178008,2,0,3,-3,0
202412,20178018,2,0,4,-4,0
202412,20228000,2,104,289,-185,0.36
202412,20228000,2S2,2,1,1,2
202412,20228000,2S3,4,3,1,1.33
202412,20228000,3,3,5,-2,0.6
202412,20228000,3S2,0,1,-1,0
202412,20228000,3S3,61,106,-45,0.58
202412,20228000,4,0,1,-1,0
202412,20228000,CA,4,25,-21,0.16
202412,20228002,2,0,1,-1,0
202412,20228002,3S3,9,10,-1,0.9
202412,20228006,CA,0,1,-1,0
202412,20228010,2,0,2,-2,0
202412,20238000,2,15,154,-139,0.1
202412,20238000,2R2,0,1,-1,0
202412,20238000,2S2,0,2,-2,0
202412,20238000,2S3,1,1,0,1
202412,20238000,3,2,5,-3,0.4
202412,20238000,3S2,1,1,0,1
202412,20238000,3S3,84,40,44,2.1
202412,20238000,3S4,2,0,2,NA
202412,20238000,CA,0,4,-4,0
202412,20238003,2,0,1,-1,0
202412,20238003,3S3,1,0,1,NA
202412,20250000,2,16,158,-142,0.1
202412,20250000,2S2,5,4,1,1.25
202412,20250000,3,2,11,-9,0.18
202412,20250000,3S2,14,13,1,1.08
202412,20250000,3S3,131,197,-66,0.66
202412,20250000,3S4,9,4,5,2.25
202412,20250000,4,0,1,-1,0
202412,20250000,CA,1,20,-19,0.05
202412,20250002,2,67,132,-65,0.51
202412,20250002,2S2,10,1,9,10
202412,20250002,2S3,2,16,-14,0.12
202412,20250002,3,0,1,-1,0
202412,20250002,3S1,1,0,1,NA
202412,20250002,3S2,0,4,-4,0
202412,20250002,3S3,14,1031,-1017,0.01
202412,20250002,CA,6,15,-9,0.4
202412,20250002,V3R3,1,0,1,NA
202412,20250004,2,5,5,0,1
202412,20250004,3S2,3,1,2,3
202412,20250004,3S3,10,54,-44,0.19
202412,20295000,2,11,88,-77,0.12
202412,20295000,2S3,0,3,-3,0
202412,20295000,3,0,2,-2,0
202412,20295000,3S2,3,0,3,NA
202412,20295000,3S3,106,32,74,3.31
202412,20295000,CA,0,15,-15,0
202412,20295000,V2,0,6,-6,0
202412,20295000,V3,0,13,-13,0
202412,20295000,V4,0,25,-25,0
202412,20295000,V4R2,2,0,2,NA
202412,20383000,2,8,35,-27,0.23
202412,20383000,2S2,1,2,-1,0.5
202412,20383000,2S3,0,13,-13,0
202412,20383000,3,19,1,18,19
202412,20383000,3S2,21,97,-76,0.22
202412,20383000,3S3,459,2525,-2066,0.18
202412,20383000,CA,0,4,-4,0
202412,20383001,2,8,0,8,NA
202412,20383001,3S2,11,32,-21,0.34
202412,20383001,3S3,123,701,-578,0.18
202412,20383001,CA,0,1,-1,0
202412,20383006,2,16,3,13,5.33
202412,20383006,2S3,2,0,2,NA
202412,20383006,3S3,1,11,-10,0.09
202412,20383010,2,4,10,-6,0.4
202412,20383010,3,1,1,0,1
202412,20383010,3S2,2,0,2,NA
202412,20383010,3S3,61,90,-29,0.68
202412,20383010,CA,0,1,-1,0
202412,20400000,2,76,339,-263,0.22
202412,20400000,2S2,20,24,-4,0.83
202412,20400000,2S3,1,1,0,1
202412,20400000,3R3,1,0,1,NA
202412,20400000,3S2,15,125,-110,0.12
202412,20400000,3S3,293,401,-108,0.73
202412,20400000,3S4,2,1,1,2
202412,20400000,CA,13,54,-41,0.24
202412,20400000,V2,2,0,2,NA
202412,20400000,V3,0,9,-9,0
202412,20400001,2,1,2,-1,0.5
202412,20400002,2,2,3,-1,0.67
202412,20400003,2,0,3,-3,0
202412,20443000,2,2,46,-44,0.04
202412,20443000,3,0,7,-7,0
202412,20443000,3S2,1,0,1,NA
202412,20443000,3S3,0,4,-4,0
202412,20517000,2,5,89,-84,0.06
202412,20517000,3S3,9,15,-6,0.6
202412,20517000,CA,3,6,-3,0.5
202412,20517001,CA,1,0,1,NA
202412,20517002,CA,0,1,-1,0
202412,20517006,2S3,0,2,-2,0
202412,20517006,3S2,1,0,1,NA
202412,20517006,3S3,0,12,-12,0
202412,20517006,3S4,0,1,-1,0
202412,20550000,2,19,98,-79,0.19
202412,20550000,2R2,0,5,-5,0
202412,20550000,2S2,1,1,0,1
202412,20550000,3,2,4,-2,0.5
202412,20550000,3S2,7,1,6,7
202412,20550000,3S3,6,77,-71,0.08
202412,20550000,3S4,0,2,-2,0
202412,20550000,CA,1,3,-2,0.33
202412,20550010,CA,0,1,-1,0
202412,20570000,2,19,91,-72,0.21
202412,20570000,3,3,0,3,NA
202412,20570000,3S3,3,0,3,NA
202412,20570000,4,0,1,-1,0
202412,20570000,CA,1,4,-3,0.25
202412,20614000,2,60,29,31,2.07
202412,20614000,3,0,16,-16,0
202412,20614000,3S3,31,17,14,1.82
202412,20614000,3S4,0,1,-1,0
202412,20614000,CA,1,2,-1,0.5
202412,20614001,3S3,0,4,-4,0
202412,20614006,3S3,25,0,25,NA
202412,20614012,3S2,11,0,11,NA
202412,20614012,3S3,13,18,-5,0.72
202412,20621000,2,125,192,-67,0.65
202412,20621000,2S2,3,0,3,NA
202412,20621000,2S3,14,1,13,14
202412,20621000,3,5,10,-5,0.5
202412,20621000,3S2,11,3,8,3.67
202412,20621000,3S3,153,299,-146,0.51
202412,20621000,CA,0,32,-32,0
202412,20621011,2,0,1,-1,0
202412,20710000,2,38,170,-132,0.22
202412,20710000,2S2,33,0,33,NA
202412,20710000,2S3,2,1,1,2
202412,20710000,3,3,41,-38,0.07
202412,20710000,3S2,7,9,-2,0.78
202412,20710000,3S3,94,72,22,1.31
202412,20710000,3S4,1,0,1,NA
202412,20710000,4,0,6,-6,0
202412,20710000,CA,1,54,-53,0.02
202412,20710000,V2,0,3,-3,0
202412,20710000,V3,0,7,-7,0
202412,20710000,V3R3,2,0,2,NA
202412,20710001,2S3,5,0,5,NA
202412,20710001,3S3,4,2,2,2
202412,20750000,2,9,75,-66,0.12
202412,20750000,2S3,1,0,1,NA
202412,20750000,3,0,2,-2,0
202412,20750000,3S3,8,28,-20,0.29
202412,20750000,CA,0,16,-16,0
202412,20750002,2,0,2,-2,0
202412,20770000,2,29,117,-88,0.25
202412,20770000,2R2,0,24,-24,0
202412,20770000,2S1,0,2,-2,0
202412,20770000,2S2,0,7,-7,0
202412,20770000,2S3,0,8,-8,0
202412,20770000,3,6,8,-2,0.75
202412,20770000,3S2,11,7,4,1.57
202412,20770000,3S3,1675,99,1576,16.92
202412,20770000,3S4,0,1,-1,0
202412,20770000,CA,5,39,-34,0.13
202412,20770001,2,0,1,-1,0
202412,20770001,2S2,1,0,1,NA
202412,20770003,2S3,0,1,-1,0
202412,20770003,3S3,1,0,1,NA
202412,20770007,2,0,1,-1,0
202412,20770010,3,0,1,-1,0
202412,20770014,2,9,1,8,9
202412,20770014,2S2,1,0,1,NA
202412,20770014,2S3,1,0,1,NA
202412,20770014,3,2,3,-1,0.67
202412,20770014,3S2,2,10,-8,0.2
202412,20770014,3S3,905,4,901,226.25
202412,20770014,CA,1,0,1,NA
202412,20787000,2,3,14,-11,0.21
202412,20787000,3S3,1,3,-2,0.33
202412,20787005,2,1,1,0,1
202412,20787011,2,1,0,1,NA
202412,23001000,2,2150,5389,-3239,0.4
202412,23001000,2B1,0,1,-1,0
202412,23001000,2B2,1,66,-65,0.02
202412,23001000,2R2,6,24,-18,0.25
202412,23001000,2R3,0,10,-10,0
202412,23001000,2S2,39,258,-219,0.15
202412,23001000,2S3,25,139,-114,0.18
202412,23001000,3,22,186,-164,0.12
202412,23001000,3S2,166,589,-423,0.28
202412,23001000,3S3,665,1771,-1106,0.38
202412,23001000,3S4,0,1,-1,0
202412,23001000,4,0,4,-4,0
202412,23001000,CA,955,638,317,1.5
202412,23001000,V3,8,0,8,NA
202412,23001001,2,2,0,2,NA
202412,23001001,2R2,0,1,-1,0
202412,23001001,3S2,1,1,0,1
202412,23001001,3S3,0,6,-6,0
202412,23001001,V3,0,4,-4,0
202412,23001004,2,0,1,-1,0
202412,23001008,2,3,1,2,3
202412,23001008,2S2,12,0,12,NA
202412,23001008,3S2,1,0,1,NA
202412,23001009,2,1,0,1,NA
202412,23001010,3S2,0,1,-1,0
202412,23001014,2,2,2,0,1
202412,23001019,3,1,0,1,NA
202412,23001020,2,3,3,0,1
202412,23001020,3,1,0,1,NA
202412,23001020,3S2,1,7,-6,0.14
202412,23001020,CA,1,0,1,NA
202412,23001032,2,0,1,-1,0
202412,23001032,3S2,0,1,-1,0
202412,23001068,3S2,1,0,1,NA
202412,23068000,2,10,112,-102,0.09
202412,23068000,2B2,0,1,-1,0
202412,23068000,2S2,0,1,-1,0
202412,23068000,3,1,19,-18,0.05
202412,23068000,3S2,1,3,-2,0.33
202412,23068000,3S3,0,37,-37,0
202412,23068000,CA,0,13,-13,0
202412,23068014,2,0,3,-3,0
202412,23068014,2R3,0,1,-1,0
202412,23068014,3,0,1,-1,0
202412,23068014,3S3,0,1,-1,0
202412,23079000,2,12,37,-25,0.32
202412,23079000,2B2,0,1,-1,0
202412,23079000,2R2,0,1,-1,0
202412,23079000,3,1,1,0,1
202412,23079000,3S2,1,3,-2,0.33
202412,23079000,3S3,0,58,-58,0
202412,23079000,CA,0,3,-3,0
202412,23079007,2,0,3,-3,0
202412,23079012,2,0,1,-1,0
202412,23090000,2,22,16,6,1.38
202412,23090000,2S2,4,0,4,NA
202412,23090000,2S3,6,0,6,NA
202412,23090000,3S2,3,1,2,3
202412,23090000,CA,1,4,-3,0.25
202412,23090020,3S3,39,0,39,NA
202412,23090022,2,0,1,-1,0
202412,23090022,3S3,599,0,599,NA
202412,23162000,2,1330,1175,155,1.13
202412,23162000,2B2,293,0,293,NA
202412,23162000,2R2,0,2,-2,0
202412,23162000,2R3,31,0,31,NA
202412,23162000,2S2,6,43,-37,0.14
202412,23162000,2S3,15,18,-3,0.83
202412,23162000,3,63,95,-32,0.66
202412,23162000,3S2,19,130,-111,0.15
202412,23162000,3S3,352,864,-512,0.41
202412,23162000,4,0,1,-1,0
202412,23162000,CA,100,197,-97,0.51
202412,23162002,2,0,2,-2,0
202412,23162003,2,0,4,-4,0
202412,23162003,3S3,0,1,-1,0
202412,23162006,2,0,1,-1,0
202412,23168000,2,0,1,-1,0
202412,23168000,3S2,2,0,2,NA
202412,23168000,CA,0,3,-3,0
202412,23168004,3S3,397,0,397,NA
202412,23182000,2,31,185,-154,0.17
202412,23182000,2B2,0,2,-2,0
202412,23182000,2S2,2,0,2,NA
202412,23182000,3,0,15,-15,0
202412,23182000,3S2,3,0,3,NA
202412,23182000,3S3,4,13,-9,0.31
202412,23182000,CA,2,12,-10,0.17
202412,23182000,V3,1,0,1,NA
202412,23182007,2,0,1,-1,0
202412,23182019,2,0,1,-1,0
202412,23182020,2,0,2,-2,0
202412,23182020,3S3,0,1,-1,0
202412,23182021,2,1,0,1,NA
202412,23189000,2,1319,422,897,3.13
202412,23189000,2B2,0,2,-2,0
202412,23189000,2R2,20,2,18,10
202412,23189000,2S2,5,3,2,1.67
202412,23189000,2S3,0,8,-8,0
202412,23189000,3,38,28,10,1.36
202412,23189000,3S2,139,79,60,1.76
202412,23189000,3S3,283,485,-202,0.58
202412,23189000,CA,0,25,-25,0
202412,23189000,V2,17,0,17,NA
202412,23189000,V3,53,1,52,53
202412,23189001,2,0,1,-1,0
202412,23189002,2,0,2,-2,0
202412,23189008,2,0,1,-1,0
202412,23189015,2,0,2,-2,0
202412,23300000,2,0,35,-35,0
202412,23300000,3,0,1,-1,0
202412,23300000,3S2,0,2,-2,0
202412,23300000,3S3,0,3,-3,0
202412,23300000,CA,0,6,-6,0
202412,23350000,2,6,29,-23,0.21
202412,23350000,2S3,0,1,-1,0
202412,23350000,3,1,1,0,1
202412,23350000,3S2,1,2,-1,0.5
202412,23350000,3S3,7,14,-7,0.5
202412,23350000,4,1,1,0,1
202412,23350000,CA,0,7,-7,0
202412,23350004,3S3,1,0,1,NA
202412,23417000,2,48,514,-466,0.09
202412,23417000,2B2,0,5,-5,0
202412,23417000,2R2,0,1,-1,0
202412,23417000,2S2,8,2,6,4
202412,23417000,3,0,18,-18,0
202412,23417000,3S2,0,21,-21,0
202412,23417000,3S3,12,102,-90,0.12
202412,23417000,CA,3,91,-88,0.03
202412,23417003,2,0,1,-1,0
202412,23417004,2,0,2,-2,0
202412,23417006,2,0,1,-1,0
202412,23417010,2,2,17,-15,0.12
202412,23417010,CA,1,0,1,NA
202412,23417011,2,0,2,-2,0
202412,23417016,2,9,2,7,4.5
202412,23417016,3,0,10,-10,0
202412,23417016,3S3,7,1,6,7
202412,23417020,3S2,0,1,-1,0
202412,23417024,2,0,3,-3,0
202412,23417027,2,0,1,-1,0
202412,23417036,3S3,0,5,-5,0
202412,23419000,2,0,18,-18,0
202412,23419000,3,0,1,-1,0
202412,23419000,CA,0,2,-2,0
202412,23419002,2,0,1,-1,0
202412,23464000,2,1,16,-15,0.06
202412,23464000,3,0,1,-1,0
202412,23464000,3S2,1,1,0,1
202412,23464000,3S3,0,12,-12,0
202412,23464000,CA,0,8,-8,0
202412,23464001,2,0,16,-16,0
202412,23464001,2R3,0,4,-4,0
202412,23464001,2S3,0,4,-4,0
202412,23464006,CA,1,0,1,NA
202412,23466000,2,48,367,-319,0.13
202412,23466000,2B2,0,4,-4,0
202412,23466000,2S2,1,4,-3,0.25
202412,23466000,2S3,0,1,-1,0
202412,23466000,3,7,14,-7,0.5
202412,23466000,3S2,0,12,-12,0
202412,23466000,3S3,444,2826,-2382,0.16
202412,23466000,3S4,9,0,9,NA
202412,23466000,CA,4,109,-105,0.04
202412,23466001,3S2,0,1,-1,0
202412,23466006,3S3,42,0,42,NA
202412,23466007,3S2,1,0,1,NA
202412,23466008,3R3,0,1,-1,0
202412,23466008,3S3,0,1,-1,0
202412,23466023,3S2,1,0,1,NA
202412,23466032,3S2,1,0,1,NA
202412,23500000,2,2,53,-51,0.04
202412,23500000,3,0,12,-12,0
202412,23500000,3S2,1,2,-1,0.5
202412,23500000,3S3,2,1,1,2
202412,23500000,CA,0,9,-9,0
202412,23555000,2,78,377,-299,0.21
202412,23555000,2B2,0,3,-3,0
202412,23555000,2R2,0,3,-3,0
202412,23555000,2R3,0,1,-1,0
202412,23555000,2S2,3,1,2,3
202412,23555000,2S3,4,1,3,4
202412,23555000,3,36,29,7,1.24
202412,23555000,3S2,15,31,-16,0.48
202412,23555000,3S3,2503,264,2239,9.48
202412,23555000,CA,6,54,-48,0.11
202412,23555004,2,0,2,-2,0
202412,23555008,2,0,2,-2,0
202412,23555011,2,0,4,-4,0
202412,23555012,2,1,1,0,1
202412,23555013,2,1,0,1,NA
202412,23555022,2,4,9,-5,0.44
202412,23570000,2,28,88,-60,0.32
202412,23570000,2B2,0,1,-1,0
202412,23570000,2S1,2,0,2,NA
202412,23570000,2S2,2,3,-1,0.67
202412,23570000,2S3,6,0,6,NA
202412,23570000,3,1,11,-10,0.09
202412,23570000,3S1,10,3,7,3.33
202412,23570000,3S2,23,5,18,4.6
202412,23570000,3S3,80,42,38,1.9
202412,23570000,3S4,22,5,17,4.4
202412,23570000,4,7,7,0,1
202412,23570000,CA,1,8,-7,0.12
202412,23570000,V2,0,17,-17,0
202412,23570000,V3,0,52,-52,0
202412,23570011,2,2,70,-68,0.03
202412,23570011,2S2,2,45,-43,0.04
202412,23570011,2S3,0,35,-35,0
202412,23570011,3,0,65,-65,0
202412,23570011,3S2,5,0,5,NA
202412,23570011,3S3,5,12,-7,0.42
202412,23570011,CA,3,24,-21,0.12
202412,23570013,2,146,14,132,10.43
202412,23570013,3,28,1,27,28
202412,23570013,3S3,0,7,-7,0
202412,23570013,CA,3,3,0,1
202412,23570024,2,0,1,-1,0
202412,23574000,2,1,22,-21,0.05
202412,23574000,3,1,0,1,NA
202412,23574000,3S3,0,7,-7,0
202412,23574000,CA,0,8,-8,0
202412,23574010,2,0,1,-1,0
202412,23580000,2,19,104,-85,0.18
202412,23580000,2B2,0,6,-6,0
202412,23580000,2S2,0,2,-2,0
202412,23580000,3,2,35,-33,0.06
202412,23580000,3S2,183,1,182,183
202412,23580000,3S3,3803,2701,1102,1.41
202412,23580000,3S4,9,9,0,1
202412,23580000,CA,1,13,-12,0.08
202412,23580000,V3,16,0,16,NA
202412,23580002,3S3,1037,0,1037,NA
202412,23580010,2,0,1,-1,0
202412,23580013,3S2,1,0,1,NA
202412,23586000,2,6,13,-7,0.46
202412,23586000,3,0,2,-2,0
202412,23586001,2,0,1,-1,0
202412,23660000,2,46,350,-304,0.13
202412,23660000,2B2,0,6,-6,0
202412,23660000,2R3,0,1,-1,0
202412,23660000,2S1,2,0,2,NA
202412,23660000,2S2,2,2,0,1
202412,23660000,2S3,2,3,-1,0.67
202412,23660000,3,15,17,-2,0.88
202412,23660000,3S1,1,2,-1,0.5
202412,23660000,3S2,4,5,-1,0.8
202412,23660000,3S3,387,105,282,3.69
202412,23660000,3S4,5,14,-9,0.36
202412,23660000,4,6,7,-1,0.86
202412,23660000,CA,5,76,-71,0.07
202412,23660004,2,0,3,-3,0
202412,23660005,2,2,0,2,NA
202412,23660005,2S2,1,3,-2,0.33
202412,23660005,3,0,4,-4,0
202412,23660005,3S2,2,0,2,NA
202412,23660005,3S3,10,9,1,1.11
202412,23660005,4,1,1,0,1
202412,23660006,2,7,1,6,7
202412,23660006,3S3,0,1,-1,0
202412,23660006,3S4,2,0,2,NA
202412,23660008,2,1,4,-3,0.25
202412,23660008,2S2,2,0,2,NA
202412,23660008,3S1,2,8,-6,0.25
202412,23660008,3S2,1,4,-3,0.25
202412,23660008,3S3,0,20,-20,0
202412,23660008,3S4,0,1,-1,0
202412,23660008,CA,1,0,1,NA
202412,23660012,CA,0,1,-1,0
202412,23660015,4,3,3,0,1
202412,23660037,2,0,1,-1,0
202412,23670000,2,1,66,-65,0.02
202412,23670000,3,0,2,-2,0
202412,23670000,3S3,2,0,2,NA
202412,23670000,CA,0,3,-3,0
202412,23670000,V3,0,1,-1,0
202412,23670011,2,1,4,-3,0.25
202412,23670011,CA,0,1,-1,0
202412,23670018,3S3,507,0,507,NA
202412,23672000,2,5,57,-52,0.09
202412,23672000,2B2,0,3,-3,0
202412,23672000,2R3,0,1,-1,0
202412,23672000,3,0,2,-2,0
202412,23672000,3S3,0,1,-1,0
202412,23672000,CA,0,13,-13,0
202412,23675000,2,0,82,-82,0
202412,23675000,2B2,0,1,-1,0
202412,23675000,2R3,0,1,-1,0
202412,23675000,2S2,1,1,0,1
202412,23675000,2S3,1,0,1,NA
202412,23675000,3,0,27,-27,0
202412,23675000,3S3,0,15,-15,0
202412,23675000,CA,0,4,-4,0
202412,23678000,2,3,26,-23,0.12
202412,23678000,3,0,4,-4,0
202412,23678000,3S2,1,1,0,1
202412,23678000,3S3,0,1,-1,0
202412,23678002,3,0,1,-1,0
202412,23682000,2,2,11,-9,0.18
202412,23682000,3,0,3,-3,0
202412,23682000,3S2,0,5,-5,0
202412,23682000,3S3,0,29,-29,0
202412,23682000,V3,0,16,-16,0
202412,23686000,2,5,42,-37,0.12
202412,23686000,3,0,14,-14,0
202412,23686000,3S2,0,1,-1,0
202412,23686000,CA,0,3,-3,0
202412,23686002,2,0,1,-1,0
202412,23686003,2,1,1,0,1
202412,23686003,2R2,0,1,-1,0
202412,23686003,3S2,4,3,1,1.33
202412,23686005,2,0,1,-1,0
202412,23686024,2,0,1,-1,0
202412,23686024,3S2,1,0,1,NA
202412,23807000,2,74,314,-240,0.24
202412,23807000,2B2,0,5,-5,0
202412,23807000,2S1,0,1,-1,0
202412,23807000,2S2,0,1,-1,0
202412,23807000,2S3,0,1,-1,0
202412,23807000,3,2,15,-13,0.13
202412,23807000,3S2,1,2,-1,0.5
202412,23807000,3S3,21,39,-18,0.54
202412,23807000,CA,1,79,-78,0.01
202412,23807027,2,0,19,-19,0
202412,23807027,3S3,0,1,-1,0
202412,23807027,CA,0,2,-2,0
202412,23807033,2,0,8,-8,0
202412,23807037,2,0,4,-4,0
202412,23807037,CA,0,1,-1,0
202412,23815000,2,2,10,-8,0.2
202412,23815000,3,0,3,-3,0
202412,23815000,3S2,0,1,-1,0
202412,23815000,3S3,0,1,-1,0
202412,23855000,2,31,67,-36,0.46
202412,23855000,3,14,17,-3,0.82
202412,23855000,3S2,0,1,-1,0
202412,23855000,3S3,0,9,-9,0
202412,23855000,CA,0,8,-8,0
202412,23855003,3S3,0,2,-2,0
202412,23855008,2,0,1,-1,0
202412,25001000,2,6,84,-78,0.07
202412,25001000,3S2,0,2,-2,0
202412,25001000,3S3,0,15,-15,0
202412,25001000,CA,0,74,-74,0
202412,25001002,CA,1,0,1,NA
202412,25019000,2,10,42,-32,0.24
202412,25019000,3,0,4,-4,0
202412,25019000,3S2,2,1,1,2
202412,25019000,3S3,0,1,-1,0
202412,25019000,CA,0,2,-2,0
202412,25019000,V2R2,0,1,-1,0
202412,25035000,2,16,164,-148,0.1
202412,25035000,3,0,1,-1,0
202412,25035000,3S3,0,59,-59,0
202412,25035000,CA,2,105,-103,0.02
202412,25035001,2,1,0,1,NA
202412,25040000,2,2,96,-94,0.02
202412,25040000,3,0,1,-1,0
202412,25040000,3S3,0,2,-2,0
202412,25040000,CA,0,49,-49,0
202412,25040002,3,0,1,-1,0
202412,25040003,3,1,0,1,NA
202412,25053000,2,0,354,-354,0
202412,25053000,CA,2,29,-27,0.07
202412,25053000,V2,0,1,-1,0
202412,25086000,2,0,12,-12,0
202412,25086000,3,0,1,-1,0
202412,25086000,CA,0,3,-3,0
202412,25095000,2,0,16,-16,0
202412,25095000,CA,0,3,-3,0
202412,25095001,2,0,1,-1,0
202412,25099000,2,64,91,-27,0.7
202412,25099000,2S2,0,1,-1,0
202412,25099000,3,0,5,-5,0
202412,25099000,3S2,1,0,1,NA
202412,25099000,3S3,5,4,1,1.25
202412,25099000,CA,15,41,-26,0.37
202412,25120000,2,0,22,-22,0
202412,25120000,3,0,3,-3,0
202412,25120000,CA,0,16,-16,0
202412,25123000,2,3,55,-52,0.05
202412,25123000,3,0,3,-3,0
202412,25123000,3S3,0,1,-1,0
202412,25123000,CA,0,35,-35,0
202412,25123000,V3,0,3,-3,0
202412,25126000,2,3089,1906,1183,1.62
202412,25126000,2B1,23,0,23,NA
202412,25126000,2R2,2,1,1,2
202412,25126000,2R3,0,1,-1,0
202412,25126000,2S2,389,168,221,2.32
202412,25126000,2S3,84,70,14,1.2
202412,25126000,3,57,113,-56,0.5
202412,25126000,3S2,906,608,298,1.49
202412,25126000,3S3,1369,932,437,1.47
202412,25126000,4,9,6,3,1.5
202412,25126000,CA,1090,960,130,1.14
202412,25126000,V3,191,53,138,3.6
202412,25126000,V4,0,12,-12,0
202412,25126007,3S3,0,1,-1,0
202412,25126008,CA,0,1,-1,0
202412,25126009,2,1,10,-9,0.1
202412,25126011,2,0,2,-2,0
202412,25148000,2,3,45,-42,0.07
202412,25148000,2S3,3,0,3,NA
202412,25148000,3,0,1,-1,0
202412,25148000,CA,0,18,-18,0
202412,25148005,2,0,3,-3,0
202412,25148005,2S3,0,1,-1,0
202412,25151000,2,17,108,-91,0.16
202412,25151000,2S2,2,1,1,2
202412,25151000,2S3,0,12,-12,0
202412,25151000,3,0,6,-6,0
202412,25151000,3S2,7,0,7,NA
202412,25151000,3S3,20,311,-291,0.06
202412,25151000,CA,11,102,-91,0.11
202412,25154000,2,0,25,-25,0
202412,25154000,CA,0,35,-35,0
202412,25168000,2,0,12,-12,0
202412,25168000,CA,0,4,-4,0
202412,25175000,2,813,2753,-1940,0.3
202412,25175000,2R2,1,1,0,1
202412,25175000,2S1,0,2,-2,0
202412,25175000,2S2,66,222,-156,0.3
202412,25175000,2S3,33,73,-40,0.45
202412,25175000,3,24,105,-81,0.23
202412,25175000,3S2,102,90,12,1.13
202412,25175000,3S3,121,387,-266,0.31
202412,25175000,3S4,7,9,-2,0.78
202412,25175000,CA,433,1911,-1478,0.23
202412,25175000,V2,1,3,-2,0.33
202412,25175008,CA,0,1,-1,0
202412,25178000,2,12,86,-74,0.14
202412,25178000,2S2,0,1,-1,0
202412,25178000,2S3,0,2,-2,0
202412,25178000,3,0,6,-6,0
202412,25178000,3S2,2,4,-2,0.5
202412,25178000,3S3,0,6,-6,0
202412,25178000,CA,1,13,-12,0.08
202412,25181000,2,1,106,-105,0.01
202412,25181000,3,0,23,-23,0
202412,25181000,3S3,0,2,-2,0
202412,25181000,CA,0,55,-55,0
202412,25181000,V2,0,5,-5,0
202412,25181000,V3,0,8,-8,0
202412,25183000,2,10,158,-148,0.06
202412,25183000,2S2,1,0,1,NA
202412,25183000,2S3,0,2,-2,0
202412,25183000,3,0,26,-26,0
202412,25183000,3S3,17,8,9,2.12
202412,25183000,CA,1,48,-47,0.02
202412,25183000,V2,0,3,-3,0
202412,25183000,V3,0,6,-6,0
202412,25183001,2,0,27,-27,0
202412,25183001,3,0,3,-3,0
202412,25183001,4,0,1,-1,0
202412,25200000,2,301,371,-70,0.81
202412,25200000,2B1,0,1,-1,0
202412,25200000,2S1,24,5,19,4.8
202412,25200000,2S2,397,50,347,7.94
202412,25200000,2S3,675,33,642,20.45
202412,25200000,3,22,12,10,1.83
202412,25200000,3S2,207,29,178,7.14
202412,25200000,3S3,910,555,355,1.64
202412,25200000,CA,37,94,-57,0.39
202412,25200000,V2,0,14,-14,0
202412,25200000,V3,0,21,-21,0
202412,25200010,3S3,3,0,3,NA
202412,25214000,2,22091,6236,15855,3.54
202412,25214000,2B1,15,1,14,15
202412,25214000,2R2,15,4,11,3.75
202412,25214000,2R3,4,1,3,4
202412,25214000,2S1,10,18,-8,0.56
202412,25214000,2S2,980,1377,-397,0.71
202412,25214000,2S3,594,349,245,1.7
202412,25214000,3,458,158,300,2.9
202412,25214000,3S1,5,9,-4,0.56
202412,25214000,3S2,624,610,14,1.02
202412,25214000,3S3,2368,3195,-827,0.74
202412,25214000,3S4,2,3,-1,0.67
202412,25214000,4,6,2,4,3
202412,25214000,CA,13134,1962,11172,6.69
202412,25214000,V2,0,2,-2,0
202412,25214000,V3,0,30,-30,0
202412,25214008,2,955,445,510,2.15
202412,25214008,2R3,9,3,6,3
202412,25214008,2S1,4,0,4,NA
202412,25214008,2S2,233,32,201,7.28
202412,25214008,2S3,346,37,309,9.35
202412,25214008,3,16,16,0,1
202412,25214008,3S2,41,18,23,2.28
202412,25214008,3S3,163,73,90,2.23
202412,25214008,3S4,0,2,-2,0
202412,25214008,4,3,5,-2,0.6
202412,25214008,CA,467,446,21,1.05
202412,25224000,2,1,27,-26,0.04
202412,25224000,3,14,7,7,2
202412,25224000,3S2,0,13,-13,0
202412,25224000,3S3,1438,131,1307,10.98
202412,25224000,4,10,3,7,3.33
202412,25224000,CA,0,14,-14,0
202412,25224000,V2,5,1,4,5
202412,25224000,V3,76,76,0,1
202412,25224000,V4,43,82,-39,0.52
202412,25224000,V4R2,0,11,-11,0
202412,25245000,2,8,93,-85,0.09
202412,25245000,3,2,8,-6,0.25
202412,25245000,3S3,0,15,-15,0
202412,25245000,3S4,0,4,-4,0
202412,25245000,CA,2,62,-60,0.03
202412,25245001,2,0,1,-1,0
202412,25245002,2,0,1,-1,0
202412,25245002,CA,0,6,-6,0
202412,25258000,2,0,5,-5,0
202412,25258000,CA,0,1,-1,0
202412,25258001,2,0,1,-1,0
202412,25260000,2,270,395,-125,0.68
202412,25260000,2S2,29,15,14,1.93
202412,25260000,2S3,15,10,5,1.5
202412,25260000,3,1,20,-19,0.05
202412,25260000,3S2,5,12,-7,0.42
202412,25260000,3S3,7,177,-170,0.04
202412,25260000,3S4,1,2,-1,0.5
202412,25260000,CA,51,239,-188,0.21
202412,25260000,V2,1,26,-25,0.04
202412,25260000,V2R2,1,0,1,NA
202412,25260000,V3,0,21,-21,0
202412,25260002,2,1,0,1,NA
202412,25269000,2,1787,2757,-970,0.65
202412,25269000,2B1,2,0,2,NA
202412,25269000,2S2,34,11,23,3.09
202412,25269000,2S3,254,21,233,12.1
202412,25269000,3,556,39,517,14.26
202412,25269000,3S2,1304,293,1011,4.45
202412,25269000,3S3,3626,1927,1699,1.88
202412,25269000,3S4,1,0,1,NA
202412,25269000,4,6,0,6,NA
202412,25269000,CA,143,1604,-1461,0.09
202412,25269000,V3,0,7,-7,0
202412,25269008,2,0,1,-1,0
202412,25269009,3S3,0,1,-1,0
202412,25269012,2,2,1,1,2
202412,25269013,2,0,1,-1,0
202412,25269017,2,11,8,3,1.38
202412,25279000,2,2,52,-50,0.04
202412,25279000,2S2,0,1,-1,0
202412,25279000,3,0,9,-9,0
202412,25279000,3S3,0,116,-116,0
202412,25279000,CA,0,38,-38,0
202412,25279000,V3,0,4,-4,0
202412,25281000,2,0,10,-10,0
202412,25281000,CA,0,7,-7,0
202412,25286000,2,40002,12794,27208,3.13
202412,25286000,2B1,12,3,9,4
202412,25286000,2B2,5,0,5,NA
202412,25286000,2R2,101,3,98,33.67
202412,25286000,2R3,2,0,2,NA
202412,25286000,2S1,26,66,-40,0.39
202412,25286000,2S2,4330,3697,633,1.17
202412,25286000,2S3,925,1229,-304,0.75
202412,25286000,3,375,193,182,1.94
202412,25286000,3S1,1,0,1,NA
202412,25286000,3S2,1079,1931,-852,0.56
202412,25286000,3S3,2838,6722,-3884,0.42
202412,25286000,3S4,10,9,1,1.11
202412,25286000,4,23,4,19,5.75
202412,25286000,CA,18952,3531,15421,5.37
202412,25286000,V2,50,7,43,7.14
202412,25286000,V3,0,1,-1,0
202412,25288000,2,10,33,-23,0.3
202412,25288000,2S2,18,12,6,1.5
202412,25288000,2S3,2,0,2,NA
202412,25288000,3,8,0,8,NA
202412,25288000,3S2,80,15,65,5.33
202412,25288000,3S3,47,8,39,5.88
202412,25288000,3S4,1,0,1,NA
202412,25288000,CA,7,14,-7,0.5
202412,25288001,2,1,4,-3,0.25
202412,25290000,2,168,1621,-1453,0.1
202412,25290000,2S2,8,15,-7,0.53
202412,25290000,2S3,7,2,5,3.5
202412,25290000,3,9,79,-70,0.11
202412,25290000,3S2,2,57,-55,0.04
202412,25290000,3S3,13,471,-458,0.03
202412,25290000,3S4,1,0,1,NA
202412,25290000,4,0,3,-3,0
202412,25290000,CA,103,440,-337,0.23
202412,25290000,V2,0,29,-29,0
202412,25290001,2,5,0,5,NA
202412,25290011,2,1,7,-6,0.14
202412,25290011,3S3,1,0,1,NA
202412,25290011,CA,0,2,-2,0
202412,25290012,3S3,0,40,-40,0
202412,25293000,2,1,9,-8,0.11
202412,25293000,3,0,2,-2,0
202412,25293000,CA,0,34,-34,0
202412,25295000,2,3469,1011,2458,3.43
202412,25295000,2S1,0,4,-4,0
202412,25295000,2S2,111,290,-179,0.38
202412,25295000,2S3,84,126,-42,0.67
202412,25295000,3,24,93,-69,0.26
202412,25295000,3S2,38,198,-160,0.19
202412,25295000,3S3,208,319,-111,0.65
202412,25295000,3S4,2,3,-1,0.67
202412,25295000,CA,35,327,-292,0.11
202412,25295000,V2,0,3,-3,0
202412,25295000,V3,7,11,-4,0.64
202412,25295005,2,345,0,345,NA
202412,25297000,2,3,42,-39,0.07
202412,25297000,3,0,11,-11,0
202412,25297000,3S3,2,1,1,2
202412,25297000,CA,1,59,-58,0.02
202412,25299000,2,0,11,-11,0
202412,25299000,CA,0,8,-8,0
202412,25307000,2,355,1852,-1497,0.19
202412,25307000,2R2,0,20,-20,0
202412,25307000,2R3,0,1,-1,0
202412,25307000,2S2,38,63,-25,0.6
202412,25307000,2S3,29,32,-3,0.91
202412,25307000,3,54,67,-13,0.81
202412,25307000,3S2,10,35,-25,0.29
202412,25307000,3S3,357,585,-228,0.61
202412,25307000,3S4,0,1,-1,0
202412,25307000,CA,477,688,-211,0.69
202412,25307000,V3,0,1,-1,0
202412,25312000,2,4,80,-76,0.05
202412,25312000,2S2,0,2,-2,0
202412,25312000,2S3,0,1,-1,0
202412,25312000,3,0,2,-2,0
202412,25312000,3S2,30,1,29,30
202412,25312000,3S3,3,9,-6,0.33
202412,25312000,3S4,3,0,3,NA
202412,25312000,CA,0,19,-19,0
202412,25317000,2,1,52,-51,0.02
202412,25317000,2S3,2,0,2,NA
202412,25317000,3,20,19,1,1.05
202412,25317000,3S3,1897,39,1858,48.64
202412,25317000,4,5,0,5,NA
202412,25317000,CA,0,23,-23,0
202412,25317000,V2,38,1,37,38
202412,25317000,V3,422,427,-5,0.99
202412,25317000,V3R2,1,0,1,NA
202412,25317000,V4,150,220,-70,0.68
202412,25317005,3S3,0,1,-1,0
202412,25320000,2,199,452,-253,0.44
202412,25320000,2S2,0,1,-1,0
202412,25320000,2S3,0,5,-5,0
202412,25320000,3,0,8,-8,0
202412,25320000,3S2,5,568,-563,0.01
202412,25320000,3S3,12,971,-959,0.01
202412,25320000,CA,3,130,-127,0.02
202412,25320000,V2,1,0,1,NA
202412,25320000,V3,0,4,-4,0
202412,25320002,2,0,1,-1,0
202412,25320003,2,0,2,-2,0
202412,25320003,3S3,1,1,0,1
202412,25320003,CA,1,1,0,1
202412,25322000,2,45,219,-174,0.21
202412,25322000,2S2,0,2,-2,0
202412,25322000,3,40,10,30,4
202412,25322000,3S2,18,1,17,18
202412,25322000,3S3,10,2,8,5
202412,25322000,CA,0,169,-169,0
202412,25322000,V2,0,2,-2,0
202412,25322000,V3,118,3,115,39.33
202412,25324000,2,2,6,-4,0.33
202412,25324000,CA,0,7,-7,0
202412,25326000,2,4,37,-33,0.11
202412,25326000,3,2,3,-1,0.67
202412,25326000,3S2,0,1,-1,0
202412,25326000,3S3,0,10,-10,0
202412,25326000,CA,2,20,-18,0.1
202412,25328000,2,0,35,-35,0
202412,25328000,2S1,1,0,1,NA
202412,25328000,2S3,0,1,-1,0
202412,25328000,3,0,5,-5,0
202412,25328000,3S2,0,1,-1,0
202412,25328000,3S3,0,9,-9,0
202412,25328000,CA,2,12,-10,0.17
202412,25328000,V2,0,2,-2,0
202412,25328001,3S3,0,3,-3,0
202412,25335000,2,3,39,-36,0.08
202412,25335000,2S2,2,1,1,2
202412,25335000,2S3,6,0,6,NA
202412,25335000,3,0,2,-2,0
202412,25335000,3S2,6,3,3,2
202412,25335000,3S3,6,37,-31,0.16
202412,25335000,CA,1,16,-15,0.06
202412,25335000,V3,0,1,-1,0
202412,25339000,2,0,2,-2,0
202412,25339000,CA,0,3,-3,0
202412,25368000,2,1,14,-13,0.07
202412,25368000,3,1,0,1,NA
202412,25368000,3S2,1,0,1,NA
202412,25368000,3S3,9,0,9,NA
202412,25368000,CA,0,3,-3,0
202412,25372000,2,0,2,-2,0
202412,25372000,CA,0,7,-7,0
202412,25377000,2,607,532,75,1.14
202412,25377000,2S1,1,0,1,NA
202412,25377000,2S2,3,4,-1,0.75
202412,25377000,2S3,0,2,-2,0
202412,25377000,3,230,59,171,3.9
202412,25377000,3S2,8,3,5,2.67
202412,25377000,3S3,572,86,486,6.65
202412,25377000,CA,7,401,-394,0.02
202412,25377000,V2,0,4,-4,0
202412,25377000,V3,185,7,178,26.43
202412,25377003,2,0,1,-1,0
202412,25377003,3S3,0,7,-7,0
202412,25386000,2,20,384,-364,0.05
202412,25386000,2S2,0,1,-1,0
202412,25386000,3,0,3,-3,0
202412,25386000,3S3,5,124,-119,0.04
202412,25386000,CA,6,160,-154,0.04
202412,25386001,2,0,7,-7,0
202412,25386003,CA,1,0,1,NA
202412,25394000,2,2,13,-11,0.15
202412,25394000,3,0,1,-1,0
202412,25394000,3S2,0,1,-1,0
202412,25394000,3S3,0,1,-1,0
202412,25394000,CA,0,12,-12,0
202412,25398000,2,1,15,-14,0.07
202412,25398000,CA,0,11,-11,0
202412,25402000,2,25,300,-275,0.08
202412,25402000,2R3,1,0,1,NA
202412,25402000,2S3,0,6,-6,0
202412,25402000,3,0,14,-14,0
202412,25402000,3S3,0,7,-7,0
202412,25402000,4,2,1,1,2
202412,25402000,CA,8,53,-45,0.15
202412,25402000,V2,0,2,-2,0
202412,25402002,2,1,0,1,NA
202412,25407000,2,5,78,-73,0.06
202412,25407000,2S3,1,0,1,NA
202412,25407000,3,0,1,-1,0
202412,25407000,3S2,1,0,1,NA
202412,25407000,3S3,651,77,574,8.45
202412,25407000,4,11,22,-11,0.5
202412,25407000,CA,0,35,-35,0
202412,25407000,V2,0,10,-10,0
202412,25407000,V3,46,82,-36,0.56
202412,25407000,V4,26,14,12,1.86
202412,25407000,V4R2,1,0,1,NA
202412,25426000,2,0,44,-44,0
202412,25426000,CA,0,8,-8,0
202412,25426005,CA,1,1,0,1
202412,25430000,2,5974,3278,2696,1.82
202412,25430000,2B1,1,7,-6,0.14
202412,25430000,2B2,4,17,-13,0.24
202412,25430000,2R2,5,10,-5,0.5
202412,25430000,2S1,0,9,-9,0
202412,25430000,2S2,1347,695,652,1.94
202412,25430000,2S3,309,162,147,1.91
202412,25430000,3,230,149,81,1.54
202412,25430000,3S1,12,1,11,12
202412,25430000,3S2,355,460,-105,0.77
202412,25430000,3S3,1490,2272,-782,0.66
202412,25430000,3S4,9,3,6,3
202412,25430000,4,2,11,-9,0.18
202412,25430000,CA,1561,1050,511,1.49
202412,25430000,V2,3,4,-1,0.75
202412,25430000,V3,2,314,-312,0.01
202412,25430000,V4,0,114,-114,0
202412,25430003,2,1,1,0,1
202412,25430003,3S3,5,7,-2,0.71
202412,25430004,2,2,8,-6,0.25
202412,25430004,2S1,1,0,1,NA
202412,25430004,2S2,45,0,45,NA
202412,25430004,2S3,6,0,6,NA
202412,25430004,3S1,1,0,1,NA
202412,25430004,3S2,38,0,38,NA
202412,25430004,3S3,1,7,-6,0.14
202412,25430004,CA,0,1,-1,0
202412,25430005,2,5,0,5,NA
202412,25430006,2,5,7,-2,0.71
202412,25436000,2,0,4,-4,0
202412,25436000,3,0,4,-4,0
202412,25436000,CA,0,3,-3,0
202412,25438000,2,8,41,-33,0.2
202412,25438000,2S3,0,1,-1,0
202412,25438000,3,0,2,-2,0
202412,25438000,3S3,2,13,-11,0.15
202412,25438000,CA,10,18,-8,0.56
202412,25438000,V2,0,27,-27,0
202412,25473000,2,10333,4520,5813,2.29
202412,25473000,2B1,0,20,-20,0
202412,25473000,2B2,0,1,-1,0
202412,25473000,2R2,1,1,0,1
202412,25473000,2R3,0,1,-1,0
202412,25473000,2S1,4,5,-1,0.8
202412,25473000,2S2,1080,904,176,1.19
202412,25473000,2S3,304,193,111,1.58
202412,25473000,3,109,273,-164,0.4
202412,25473000,3S1,2,2,0,1
202412,25473000,3S2,322,426,-104,0.76
202412,25473000,3S3,1555,3757,-2202,0.41
202412,25473000,3S4,4,4,0,1
202412,25473000,4,0,32,-32,0
202412,25473000,CA,3663,1418,2245,2.58
202412,25473000,V2,20,44,-24,0.45
202412,25473000,V3,143,47,96,3.04
202412,25473000,V4,0,6,-6,0
202412,25473004,2,0,2,-2,0
202412,25473004,3,0,1,-1,0
202412,25473004,3S2,0,1,-1,0
202412,25473004,3S3,0,1,-1,0
202412,25483000,2,1,10,-9,0.1
202412,25483000,CA,1,10,-9,0.1
202412,25486000,2,158,263,-105,0.6
202412,25486000,3,63,0,63,NA
202412,25486000,3S2,3,8,-5,0.38
202412,25486000,3S3,166,2,164,83
202412,25486000,3S4,1,0,1,NA
202412,25486000,CA,1,147,-146,0.01
202412,25486000,V2,0,3,-3,0
202412,25486000,V3,1035,67,968,15.45
202412,25486000,V4,222,0,222,NA
202412,25486001,2,1,0,1,NA
202412,25486002,2,0,3,-3,0
202412,25488000,2,5,71,-66,0.07
202412,25488000,2S3,6,0,6,NA
202412,25488000,3,2,12,-10,0.17
202412,25488000,3S3,4,7,-3,0.57
202412,25488000,CA,3,40,-37,0.07
202412,25488001,2,0,1,-1,0
202412,25489000,2,0,35,-35,0
202412,25489000,CA,0,5,-5,0
202412,25489000,V3,0,1,-1,0
202412,25489001,2,0,5,-5,0
202412,25491000,2,2,21,-19,0.1
202412,25491000,CA,1,18,-17,0.06
202412,25506000,2,2,14,-12,0.14
202412,25506000,CA,0,5,-5,0
202412,25513000,2,17,156,-139,0.11
202412,25513000,2S3,1,0,1,NA
202412,25513000,3,0,13,-13,0
202412,25513000,3S2,1,1,0,1
202412,25513000,3S3,4,11,-7,0.36
202412,25513000,CA,5,89,-84,0.06
202412,25513000,V3,0,3,-3,0
202412,25513001,CA,0,1,-1,0
202412,25518000,2,0,6,-6,0
202412,25518000,3,0,1,-1,0
202412,25518000,CA,0,1,-1,0
202412,25518002,2,0,3,-3,0
202412,25518002,CA,0,1,-1,0
202412,25518004,2,1,2,-1,0.5
202412,25524000,2,1,11,-10,0.09
202412,25524000,CA,0,5,-5,0
202412,25530000,2,7,44,-37,0.16
202412,25530000,2S2,1,1,0,1
202412,25530000,3,2,29,-27,0.07
202412,25530000,3S2,10,3,7,3.33
202412,25530000,3S3,2,43,-41,0.05
202412,25530000,CA,2,13,-11,0.15
202412,25530000,V3,0,8,-8,0
202412,25530001,2,0,1,-1,0
202412,25530001,3,1,1,0,1
202412,25530001,V3,0,3,-3,0
202412,25530002,2,0,1,-1,0
202412,25535000,2,1,28,-27,0.04
202412,25535000,3,1,0,1,NA
202412,25535000,3S3,0,3,-3,0
202412,25535000,CA,1,14,-13,0.07
202412,25535000,V2,0,10,-10,0
202412,25535000,V3,0,1,-1,0
202412,25572000,2,20,128,-108,0.16
202412,25572000,2R2,0,1,-1,0
202412,25572000,2S3,0,2,-2,0
202412,25572000,3,1,2,-1,0.5
202412,25572000,3R3,1,0,1,NA
202412,25572000,3S2,36,2,34,18
202412,25572000,3S3,198,121,77,1.64
202412,25572000,CA,5,42,-37,0.12
202412,25572000,V3,0,1,-1,0
202412,25572003,2,1,1,0,1
202412,25580000,2,0,7,-7,0
202412,25580000,3S2,0,1,-1,0
202412,25580000,CA,0,7,-7,0
202412,25592000,2,1,13,-12,0.08
202412,25592000,3,0,3,-3,0
202412,25592000,CA,0,17,-17,0
202412,25594000,2,1,34,-33,0.03
202412,25594000,3S2,2,0,2,NA
202412,25594000,3S3,0,10,-10,0
202412,25594000,CA,0,12,-12,0
202412,25594002,2,1,7,-6,0.14
202412,25594002,3S2,2,0,2,NA
202412,25594002,3S3,0,1,-1,0
202412,25594002,CA,0,14,-14,0
202412,25596000,2,0,9,-9,0
202412,25596000,3,0,1,-1,0
202412,25596000,CA,0,3,-3,0
202412,25596003,3S3,0,1,-1,0
202412,25599000,2,0,50,-50,0
202412,25599000,3S3,0,4,-4,0
202412,25599000,CA,0,54,-54,0
202412,25599002,2,0,5,-5,0
202412,25599002,CA,0,1,-1,0
202412,25612000,2,8,230,-222,0.03
202412,25612000,2R2,0,2,-2,0
202412,25612000,2S2,1,2,-1,0.5
202412,25612000,3,50,4,46,12.5
202412,25612000,3S2,3,2,1,1.5
202412,25612000,3S3,3,189,-186,0.02
202412,25612000,4,1,0,1,NA
202412,25612000,CA,4,156,-152,0.03
202412,25612000,V2,1,0,1,NA
202412,25612000,V3,36,0,36,NA
202412,25612000,V4,8,0,8,NA
202412,25645000,2,1,26,-25,0.04
202412,25645000,3,0,2,-2,0
202412,25645000,3S3,0,4,-4,0
202412,25645000,CA,0,19,-19,0
202412,25645001,2,0,1,-1,0
202412,25649000,2,1,53,-52,0.02
202412,25649000,3,1,0,1,NA
202412,25649000,CA,2,24,-22,0.08
202412,25653000,2,2,2,0,1
202412,25653000,3,1,0,1,NA
202412,25658000,2,6,77,-71,0.08
202412,25658000,3,1,9,-8,0.11
202412,25658000,3S2,0,9,-9,0
202412,25658000,3S3,1,6,-5,0.17
202412,25658000,CA,1,17,-16,0.06
202412,25662000,2,1,45,-44,0.02
202412,25662000,CA,0,14,-14,0
202412,25662001,2,5,10,-5,0.5
202412,25662001,3,1,0,1,NA
202412,25662001,3S3,0,1,-1,0
202412,25662001,CA,1,7,-6,0.14
202412,25718000,2,42,232,-190,0.18
202412,25718000,3,24,1,23,24
202412,25718000,CA,25,36,-11,0.69
202412,25718000,V2,0,9,-9,0
202412,25736000,2,609,226,383,2.69
202412,25736000,2B1,1,0,1,NA
202412,25736000,2S2,31,71,-40,0.44
202412,25736000,2S3,13,51,-38,0.25
202412,25736000,3,4,12,-8,0.33
202412,25736000,3S2,27,19,8,1.42
202412,25736000,3S3,1010,266,744,3.8
202412,25736000,CA,101,64,37,1.58
202412,25736000,V2,114,0,114,NA
202412,25736000,V3,85,0,85,NA
202412,25736002,2,1,0,1,NA
202412,25740000,2,831,1336,-505,0.62
202412,25740000,2S1,0,2,-2,0
202412,25740000,2S2,124,85,39,1.46
202412,25740000,2S3,11,34,-23,0.32
202412,25740000,3,29,62,-33,0.47
202412,25740000,3S2,108,277,-169,0.39
202412,25740000,3S3,1304,1722,-418,0.76
202412,25740000,3S4,4,0,4,NA
202412,25740000,CA,911,448,463,2.03
202412,25740000,V2,0,30,-30,0
202412,25740000,V3,2,0,2,NA
202412,25740005,2,0,2,-2,0
202412,25743000,2,12,278,-266,0.04
202412,25743000,2S2,2,1,1,2
202412,25743000,2S3,2,0,2,NA
202412,25743000,3,0,22,-22,0
202412,25743000,3S2,0,5,-5,0
202412,25743000,3S3,6,22,-16,0.27
202412,25743000,3S4,2,7,-5,0.29
202412,25743000,4,1,0,1,NA
202412,25743000,CA,1,66,-65,0.02
202412,25743000,V2,0,11,-11,0
202412,25743005,2,2,1,1,2
202412,25743005,2S2,5,0,5,NA
202412,25743005,3S2,11,0,11,NA
202412,25743005,CA,0,1,-1,0
202412,25745000,2,5,119,-114,0.04
202412,25745000,2S2,1,4,-3,0.25
202412,25745000,2S3,9,31,-22,0.29
202412,25745000,3,1,1,0,1
202412,25745000,3S2,123,0,123,NA
202412,25745000,3S3,50,13,37,3.85
202412,25745000,CA,2,96,-94,0.02
202412,25754000,2,4714,4136,578,1.14
202412,25754000,2B1,0,3,-3,0
202412,25754000,2R2,0,1,-1,0
202412,25754000,2S2,173,104,69,1.66
202412,25754000,2S3,94,48,46,1.96
202412,25754000,3,784,143,641,5.48
202412,25754000,3S2,39,108,-69,0.36
202412,25754000,3S3,2020,1158,862,1.74
202412,25754000,3S4,1,1,0,1
202412,25754000,4,58,2,56,29
202412,25754000,CA,1786,1834,-48,0.97
202412,25754000,V2,67,3,64,22.33
202412,25754000,V3,110,14,96,7.86
202412,25754001,2,377,2,375,188.5
202412,25754001,2S2,86,1,85,86
202412,25754001,2S3,55,0,55,NA
202412,25754001,3S2,2,0,2,NA
202412,25754001,3S3,1,2,-1,0.5
202412,25754001,CA,5,0,5,NA
202412,25758000,2,984,1116,-132,0.88
202412,25758000,2R3,0,1,-1,0
202412,25758000,2S2,13,65,-52,0.2
202412,25758000,2S3,13,18,-5,0.72
202412,25758000,3,504,139,365,3.63
202412,25758000,3S2,440,38,402,11.58
202412,25758000,3S3,1117,211,906,5.29
202412,25758000,4,27,9,18,3
202412,25758000,CA,66,269,-203,0.25
202412,25758000,V2,0,22,-22,0
202412,25758000,V3,5,1942,-1937,0
202412,25758000,V4,0,236,-236,0
202412,25758006,2,31,14,17,2.21
202412,25758006,2S2,1,17,-16,0.06
202412,25758006,2S3,3,2,1,1.5
202412,25758006,3,1,2,-1,0.5
202412,25758006,3S3,471,13,458,36.23
202412,25758006,CA,6,5,1,1.2
202412,25758006,V3,14,0,14,NA
202412,25769000,2,27,382,-355,0.07
202412,25769000,2S2,0,2,-2,0
202412,25769000,2S3,0,1,-1,0
202412,25769000,3,2,6,-4,0.33
202412,25769000,3S3,0,10,-10,0
202412,25769000,CA,3,181,-178,0.02
202412,25769000,V2,0,2,-2,0
202412,25769002,CA,0,1,-1,0
202412,25772000,2,183,322,-139,0.57
202412,25772000,2S2,1,0,1,NA
202412,25772000,2S3,1,9,-8,0.11
202412,25772000,3,5,32,-27,0.16
202412,25772000,3S2,3,3,0,1
202412,25772000,3S3,413,1079,-666,0.38
202412,25772000,CA,3,123,-120,0.02
202412,25772000,V2,0,1,-1,0
202412,25772004,2,10,1,9,10
202412,25777000,2,0,32,-32,0
202412,25777000,CA,0,15,-15,0
202412,25779000,2,0,17,-17,0
202412,25779000,3S3,0,1,-1,0
202412,25779000,3S4,0,1,-1,0
202412,25779000,CA,0,23,-23,0
202412,25781000,2,0,19,-19,0
202412,25781000,3,9,14,-5,0.64
202412,25781000,3S2,4,0,4,NA
202412,25781000,3S3,537,9,528,59.67
202412,25781000,4,4,0,4,NA
202412,25781000,CA,0,10,-10,0
202412,25781000,V2,8,0,8,NA
202412,25781000,V3,170,37,133,4.59
202412,25781000,V4,55,5,50,11
202412,25785000,2,61,183,-122,0.33
202412,25785000,2S2,0,2,-2,0
202412,25785000,3S2,0,3,-3,0
202412,25785000,3S3,3,17,-14,0.18
202412,25785000,4,1,0,1,NA
202412,25785000,CA,8,205,-197,0.04
202412,25785000,V2,0,11,-11,0
202412,25785000,V3,0,5,-5,0
202412,25793000,2,7,31,-24,0.23
202412,25793000,2S2,1,0,1,NA
202412,25793000,3,1,1,0,1
202412,25793000,3S2,1,3,-2,0.33
202412,25793000,3S3,1165,16,1149,72.81
202412,25793000,CA,0,18,-18,0
202412,25793000,V2,0,11,-11,0
202412,25793000,V3,26,35,-9,0.74
202412,25793000,V4,3,4,-1,0.75
202412,25793003,3S3,0,9,-9,0
202412,25797000,2,1,49,-48,0.02
202412,25797000,3,0,12,-12,0
202412,25797000,CA,1,9,-8,0.11
202412,25797001,2,0,1,-1,0
202412,25797001,3S2,1,0,1,NA
202412,25797001,CA,0,6,-6,0
202412,25799000,2,17780,3544,14236,5.02
202412,25799000,2B1,2,0,2,NA
202412,25799000,2R2,48,2,46,24
202412,25799000,2R3,14,8,6,1.75
202412,25799000,2S1,86,39,47,2.21
202412,25799000,2S2,1947,1950,-3,1
202412,25799000,2S3,353,319,34,1.11
202412,25799000,3,57,67,-10,0.85
202412,25799000,3S1,3,2,1,1.5
202412,25799000,3S2,542,733,-191,0.74
202412,25799000,3S3,687,688,-1,1
202412,25799000,3S4,6,0,6,NA
202412,25799000,CA,13210,1068,12142,12.37
202412,25799000,V2,0,15,-15,0
202412,25799000,V3,0,6,-6,0
202412,25799001,2,8,18,-10,0.44
202412,25799001,2S2,1,6,-5,0.17
202412,25799001,3,1,1,0,1
202412,25799001,3S2,1,1,0,1
202412,25799001,3S3,0,2,-2,0
202412,25799001,CA,1,3,-2,0.33
202412,25805000,2,0,22,-22,0
202412,25805000,CA,0,8,-8,0
202412,25807000,2,0,3,-3,0
202412,25807000,3,0,8,-8,0
202412,25807000,3S3,0,1,-1,0
202412,25807000,CA,0,4,-4,0
202412,25815000,2,3,82,-79,0.04
202412,25815000,3,1,1,0,1
202412,25815000,3S2,1,2,-1,0.5
202412,25815000,3S3,0,22,-22,0
202412,25815000,CA,0,57,-57,0
202412,25817000,2,8907,5540,3367,1.61
202412,25817000,2B1,16,10,6,1.6
202412,25817000,2R2,16,6,10,2.67
202412,25817000,2R3,29,2,27,14.5
202412,25817000,2S1,3,8,-5,0.38
202412,25817000,2S2,2858,1458,1400,1.96
202412,25817000,2S3,1790,1049,741,1.71
202412,25817000,3,683,94,589,7.27
202412,25817000,3S1,3,1,2,3
202412,25817000,3S2,1168,751,417,1.56
202412,25817000,3S3,8640,7115,1525,1.21
202412,25817000,3S4,6,9,-3,0.67
202412,25817000,4,2,2,0,1
202412,25817000,CA,3153,1259,1894,2.5
202412,25817000,V2,0,3,-3,0
202412,25817000,V3,0,35,-35,0
202412,25817000,V4,0,5,-5,0
202412,25817001,3S3,4,0,4,NA
202412,25817002,2,3,12,-9,0.25
202412,25817002,2S2,0,3,-3,0
202412,25817002,3S3,0,4,-4,0
202412,25817005,2,1,2,-1,0.5
202412,25817005,3S3,0,1,-1,0
202412,25817005,CA,0,1,-1,0
202412,25817006,2,5,3,2,1.67
202412,25817014,2,2,4,-2,0.5
202412,25817014,3,0,24,-24,0
202412,25817014,3S3,228,218,10,1.05
202412,25817014,V2,3,0,3,NA
202412,25823000,2,0,5,-5,0
202412,25839000,2,0,34,-34,0
202412,25839000,3,35,9,26,3.89
202412,25839000,CA,0,10,-10,0
202412,25839000,V2,5,0,5,NA
202412,25839000,V3,1043,0,1043,NA
202412,25839003,2,0,3,-3,0
202412,25839003,CA,0,2,-2,0
202412,25841000,2,0,42,-42,0
202412,25841000,3,0,7,-7,0
202412,25841000,3S2,0,4,-4,0
202412,25841000,3S3,0,36,-36,0
202412,25841000,CA,8,16,-8,0.5
202412,25843000,2,71,385,-314,0.18
202412,25843000,2R2,0,1,-1,0
202412,25843000,2S3,0,1,-1,0
202412,25843000,3,41,55,-14,0.75
202412,25843000,3S2,43,7,36,6.14
202412,25843000,3S3,56,136,-80,0.41
202412,25843000,4,0,12,-12,0
202412,25843000,CA,9,250,-241,0.04
202412,25843000,V2,0,100,-100,0
202412,25843000,V3,0,210,-210,0
202412,25843000,V4,0,39,-39,0
202412,25843000,V4R2,0,1,-1,0
202412,25845000,2,3,11,-8,0.27
202412,25845000,3,0,7,-7,0
202412,25845000,3S2,4,0,4,NA
202412,25845000,3S3,0,8,-8,0
202412,25845000,CA,0,12,-12,0
202412,25851000,2,0,52,-52,0
202412,25851000,3,0,5,-5,0
202412,25851000,3S2,0,1,-1,0
202412,25851000,3S4,2,0,2,NA
202412,25851000,CA,0,42,-42,0
202412,25851000,V3,0,3,-3,0
202412,25862000,2,2,14,-12,0.14
202412,25862000,3S2,0,1,-1,0
202412,25862000,CA,0,11,-11,0
202412,25862005,CA,0,1,-1,0
202412,25867000,2,0,10,-10,0
202412,25867000,CA,0,7,-7,0
202412,25871000,2,0,2,-2,0
202412,25871000,CA,0,2,-2,0
202412,25873000,2,9,116,-107,0.08
202412,25873000,2S3,0,1,-1,0
202412,25873000,3,3,7,-4,0.43
202412,25873000,3S2,0,1,-1,0
202412,25873000,3S3,14,44,-30,0.32
202412,25873000,CA,7,113,-106,0.06
202412,25875000,2,49,555,-506,0.09
202412,25875000,2S2,1,0,1,NA
202412,25875000,2S3,0,2,-2,0
202412,25875000,3,6,17,-11,0.35
202412,25875000,3S2,7,1,6,7
202412,25875000,3S2S3,1,1,0,1
202412,25875000,3S3,8,84,-76,0.1
202412,25875000,CA,11,205,-194,0.05
202412,25875000,V3,0,2,-2,0
202412,25878000,2,12,58,-46,0.21
202412,25878000,3,0,3,-3,0
202412,25878000,3S3,0,5,-5,0
202412,25878000,CA,0,72,-72,0
202412,25885000,2,3,42,-39,0.07
202412,25885000,CA,0,6,-6,0
202412,25885006,CA,0,1,-1,0
202412,25898000,2,0,16,-16,0
202412,25898000,3S3,0,1,-1,0
202412,25898000,CA,0,3,-3,0
202412,25898006,3S3,0,2,-2,0
202412,25899000,2,757,2420,-1663,0.31
202412,25899000,2S1,0,3,-3,0
202412,25899000,2S2,85,95,-10,0.89
202412,25899000,2S3,94,42,52,2.24
202412,25899000,3,44,45,-1,0.98
202412,25899000,3S2,124,61,63,2.03
202412,25899000,3S3,683,604,79,1.13
202412,25899000,3S4,0,1,-1,0
202412,25899000,4,12,3,9,4
202412,25899000,CA,203,1739,-1536,0.12
202412,25899000,V2,0,7,-7,0
202412,25899000,V3,96,136,-40,0.71
202412,25899000,V4,8,0,8,NA
202412,27001000,2,214,1943,-1729,0.11
202412,27001000,2S2,6,13,-7,0.46
202412,27001000,2S3,0,2,-2,0
202412,27001000,3,7,114,-107,0.06
202412,27001000,3S2,0,15,-15,0
202412,27001000,3S3,2,117,-115,0.02
202412,27001000,4,1,20,-19,0.05
202412,27001000,CA,4,128,-124,0.03
202412,27001004,2,0,1,-1,0
202412,27001032,2,1,3,-2,0.33
202412,27001032,3S2,0,1,-1,0
202412,27001032,CA,0,1,-1,0
202412,27001060,2,0,3,-3,0
202412,27006000,2,0,7,-7,0
202412,27025003,3S3,1,0,1,NA
202412,27025003,CA,0,1,-1,0
202412,27050000,2,0,2,-2,0
202412,27073000,2,0,6,-6,0
202412,27073000,3,0,1,-1,0
202412,27075000,2,0,3,-3,0
202412,27077000,2,0,1,-1,0
202412,27077024,2,0,1,-1,0
202412,27086000,2,5,9893,-9888,0
202412,27086000,2S2,0,1,-1,0
202412,27086000,3,0,27,-27,0
202412,27086000,3S2,0,1,-1,0
202412,27086000,3S3,1,14,-13,0.07
202412,27086000,4,0,2,-2,0
202412,27086000,CA,0,3,-3,0
202412,27099001,2,0,1,-1,0
202412,27135000,2,0,2,-2,0
202412,27135001,2,0,2,-2,0
202412,27150000,2,0,6,-6,0
202412,27160000,2,1,9,-8,0.11
202412,27160000,3,2,1,1,2
202412,27160000,CA,0,1,-1,0
202412,27205000,2,3,150,-147,0.02
202412,27205000,3,0,17,-17,0
202412,27205000,3S2,0,1,-1,0
202412,27205000,3S3,0,9,-9,0
202412,27205000,CA,1,15,-14,0.07
202412,27205015,3S2,0,1,-1,0
202412,27245000,2,0,59,-59,0
202412,27245000,2S3,0,1,-1,0
202412,27245000,3,1,22,-21,0.05
202412,27245000,3S2,1,19,-18,0.05
202412,27245000,3S3,119,16,103,7.44
202412,27245000,CA,0,3,-3,0
202412,27245000,V3,0,2,-2,0
202412,27245007,3S3,1,0,1,NA
202412,27361000,2,69,737,-668,0.09
202412,27361000,2S3,0,1,-1,0
202412,27361000,3,1,48,-47,0.02
202412,27361000,3S2,4,4,0,1
202412,27361000,3S3,1,32,-31,0.03
202412,27361000,4,0,7,-7,0
202412,27361000,CA,4,68,-64,0.06
202412,27361000,V3,0,1,-1,0
202412,27361024,2,2,3,-1,0.67
202412,27361024,3,0,1,-1,0
202412,27361024,3S2,0,1,-1,0
202412,27361024,3S3,0,1,-1,0
202412,27413000,2,0,9,-9,0
202412,27413000,3,1,3,-2,0.33
202412,27413000,3S2,0,1,-1,0
202412,27413000,3S3,0,4,-4,0
202412,27413000,CA,0,1,-1,0
202412,27425000,2,0,1,-1,0
202412,27430000,2,0,2,-2,0
202412,27430000,3,0,15,-15,0
202412,27430011,2,0,17,-17,0
202412,27430011,3,0,1,-1,0
202412,27430011,4,0,1,-1,0
202412,27450000,2,0,3,-3,0
202412,27450000,3,0,2,-2,0
202412,27450006,3S2,0,1,-1,0
202412,27450009,2,1,2,-1,0.5
202412,27450009,3,0,2,-2,0
202412,27491000,2,0,10,-10,0
202412,27491000,3,0,2,-2,0
202412,27491000,3S2,0,5,-5,0
202412,27491000,3S3,0,1,-1,0
202412,27491008,2,0,1,-1,0
202412,27495007,2,0,3,-3,0
202412,27600000,2,0,1,-1,0
202412,27615000,2,1,15,-14,0.07
202412,27615000,3,1,8,-7,0.12
202412,27615000,3S2,3,1,2,3
202412,27615000,3S3,1,4,-3,0.25
202412,27615000,4,0,1,-1,0
202412,27615000,CA,0,2,-2,0
202412,27660000,2,0,6,-6,0
202412,27660000,3,0,1,-1,0
202412,27745000,2,0,2,-2,0
202412,27787000,2,1,46,-45,0.02
202412,27787000,3,1,10,-9,0.1
202412,27787000,3S2,3,0,3,NA
202412,27787000,3S3,0,2,-2,0
202412,27787000,CA,0,9,-9,0
202412,27787010,2,0,1,-1,0
202412,27787017,3,0,1,-1,0
202412,27800000,2,0,6,-6,0
202412,27800001,2S2,0,1,-1,0
202412,27810000,2,0,8,-8,0
202412,27810000,3,1,0,1,NA
202412,27810000,3S2,0,2,-2,0
202412,27810000,3S3,0,2,-2,0
202412,27810000,CA,0,7,-7,0
202412,27810002,2,1,25,-24,0.04
202412,27810002,3,0,2,-2,0
202412,41001000,2,2735,4326,-1591,0.63
202412,41001000,2B1,1,1,0,1
202412,41001000,2R2,67,40,27,1.68
202412,41001000,2R3,0,7,-7,0
202412,41001000,2S1,1,2,-1,0.5
202412,41001000,2S2,84,436,-352,0.19
202412,41001000,2S3,36,74,-38,0.49
202412,41001000,3,208,156,52,1.33
202412,41001000,3S1,1,1,0,1
202412,41001000,3S2,197,339,-142,0.58
202412,41001000,3S2S3,1,0,1,NA
202412,41001000,3S3,1903,2313,-410,0.82
202412,41001000,3S3S2,0,1,-1,0
202412,41001000,3S4,1,2,-1,0.5
202412,41001000,4,11,15,-4,0.73
202412,41001000,CA,712,872,-160,0.82
202412,41001000,V3,2,1,1,2
202412,41001001,CA,0,25,-25,0
202412,41001003,2,0,3,-3,0
202412,41001003,3S2,1,0,1,NA
202412,41001003,3S3,0,8,-8,0
202412,41001003,CA,1,1,0,1
202412,41001009,2,0,1,-1,0
202412,41001009,3,0,1,-1,0
202412,41006000,2,10,305,-295,0.03
202412,41006000,2S3,1,1,0,1
202412,41006000,3,8,7,1,1.14
202412,41006000,3S3,1,49,-48,0.02
202412,41006000,CA,1,31,-30,0.03
202412,41006005,2,0,1,-1,0
202412,41006005,3S2,1,1,0,1
202412,41013000,2,0,15,-15,0
202412,41013000,3S2,0,4,-4,0
202412,41013000,3S3,0,12,-12,0
202412,41013000,CA,0,1,-1,0
202412,41016000,2,83,66,17,1.26
202412,41016000,2R2,0,1,-1,0
202412,41016000,2S1,0,1,-1,0
202412,41016000,2S2,5,6,-1,0.83
202412,41016000,2S3,2,0,2,NA
202412,41016000,3,9,364,-355,0.02
202412,41016000,3S1,2,1,1,2
202412,41016000,3S2,9,21,-12,0.43
202412,41016000,3S3,27,203,-176,0.13
202412,41016000,4,6,1,5,6
202412,41016000,CA,1,40,-39,0.03
202412,41016000,V4,0,1,-1,0
202412,41016001,2,0,7,-7,0
202412,41020000,2,14,35,-21,0.4
202412,41020000,3,1,0,1,NA
202412,41020000,3S3,0,4,-4,0
202412,41020000,CA,1,15,-14,0.07
202412,41026000,2,2,6,-4,0.33
202412,41026000,3S3,1,6,-5,0.17
202412,41078000,2,0,2,-2,0
202412,41078000,3S2,0,1,-1,0
202412,41078000,3S3,0,3,-3,0
202412,41078000,CA,1,2,-1,0.5
202412,41132000,2,15,205,-190,0.07
202412,41132000,2S2,0,2,-2,0
202412,41132000,3,26,0,26,NA
202412,41132000,3S2,0,4,-4,0
202412,41132000,3S3,44,115,-71,0.38
202412,41132000,3S4,0,2,-2,0
202412,41132000,4,2,0,2,NA
202412,41132000,CA,2,51,-49,0.04
202412,41132000,V3,52,0,52,NA
202412,41206000,CA,1,1,0,1
202412,41244000,2,0,2,-2,0
202412,41298000,2,98,536,-438,0.18
202412,41298000,2R2,0,1,-1,0
202412,41298000,2S3,1,1,0,1
202412,41298000,3,14,37,-23,0.38
202412,41298000,3S2,0,2,-2,0
202412,41298000,3S3,110,244,-134,0.45
202412,41298000,4,0,1,-1,0
202412,41298000,CA,10,97,-87,0.1
202412,41298002,2,0,5,-5,0
202412,41298002,3,0,7,-7,0
202412,41298004,2,2,3,-1,0.67
202412,41298004,3S3,0,4,-4,0
202412,41298004,CA,0,1,-1,0
202412,41298017,2,1,0,1,NA
202412,41306000,2,18,59,-41,0.31
202412,41306000,2S3,0,8,-8,0
202412,41306000,3,3,6,-3,0.5
202412,41306000,3S2,2,0,2,NA
202412,41306000,3S3,45,36,9,1.25
202412,41306000,CA,2,10,-8,0.2
202412,41306010,2,0,1,-1,0
202412,41306011,3S3,0,1,-1,0
202412,41319000,2,1,43,-42,0.02
202412,41319000,2S3,0,1,-1,0
202412,41319000,3,1,1,0,1
202412,41319000,3S3,18,8,10,2.25
202412,41319000,CA,0,1,-1,0
202412,41349000,2,13,21,-8,0.62
202412,41349000,3,39,0,39,NA
202412,41349000,3S2,1,0,1,NA
202412,41349000,3S3,61,17,44,3.59
202412,41349000,CA,0,7,-7,0
202412,41357000,2,1,2,-1,0.5
202412,41357000,CA,1,4,-3,0.25
202412,41359000,2,77,82,-5,0.94
202412,41359000,3,0,5,-5,0
202412,41359000,3S3,1,16,-15,0.06
202412,41359000,CA,0,21,-21,0
202412,41359002,2,0,1,-1,0
202412,41359002,3,0,1,-1,0
202412,41359002,3S3,0,17,-17,0
202412,41359004,2,0,2,-2,0
202412,41378000,2,0,55,-55,0
202412,41378000,2S3,1,0,1,NA
202412,41378000,3,0,12,-12,0
202412,41378000,3S2,0,1,-1,0
202412,41378000,3S3,0,3,-3,0
202412,41378000,CA,0,4,-4,0
202412,41396000,2,48,345,-297,0.14
202412,41396000,2S2,0,1,-1,0
202412,41396000,2S3,0,2,-2,0
202412,41396000,3,1,16,-15,0.06
202412,41396000,3S2,0,1,-1,0
202412,41396000,3S3,3,114,-111,0.03
202412,41396000,CA,0,95,-95,0
202412,41396001,2,0,1,-1,0
202412,41483000,2,0,1,-1,0
202412,41483000,3,0,4,-4,0
202412,41483000,CA,0,1,-1,0
202412,41503000,2,3,12,-9,0.25
202412,41503000,3,2,1,1,2
202412,41518000,2,2,13,-11,0.15
202412,41518000,3,291,21,270,13.86
202412,41518000,CA,0,1,-1,0
202412,41524000,2,139,277,-138,0.5
202412,41524000,2S1,1,5,-4,0.2
202412,41524000,2S2,15,19,-4,0.79
202412,41524000,2S3,10,2,8,5
202412,41524000,3,1,10,-9,0.1
202412,41524000,3S1,2,2,0,1
202412,41524000,3S2,11,31,-20,0.35
202412,41524000,3S3,447,462,-15,0.97
202412,41524000,3S4,7,0,7,NA
202412,41524000,4,6,11,-5,0.55
202412,41524000,CA,38,79,-41,0.48
202412,41524001,3S3,0,1,-1,0
202412,41524006,2,0,1,-1,0
202412,41524006,3,0,12,-12,0
202412,41530000,2,4,15,-11,0.27
202412,41530000,2S2,0,1,-1,0
202412,41530000,3,0,1,-1,0
202412,41530000,3S3,1,0,1,NA
202412,41530000,CA,0,33,-33,0
202412,41548000,2,0,12,-12,0
202412,41548000,2S2,1,0,1,NA
202412,41548000,3,0,3,-3,0
202412,41548000,3S3,0,4,-4,0
202412,41548000,CA,0,2,-2,0
202412,41551000,2,535,2051,-1516,0.26
202412,41551000,2R2,0,1,-1,0
202412,41551000,2R3,0,1,-1,0
202412,41551000,2S2,12,35,-23,0.34
202412,41551000,2S3,11,68,-57,0.16
202412,41551000,3,10,57,-47,0.18
202412,41551000,3S2,53,87,-34,0.61
202412,41551000,3S3,274,470,-196,0.58
202412,41551000,3S4,3,1,2,3
202412,41551000,4,0,1,-1,0
202412,41551000,CA,161,342,-181,0.47
202412,41551000,V3,2,5,-3,0.4
202412,41551001,2,23,19,4,1.21
202412,41551001,2S3,0,3,-3,0
202412,41551001,3,1,4,-3,0.25
202412,41551001,3S3,7,13,-6,0.54
202412,41551001,CA,0,27,-27,0
202412,41615000,2,119,64,55,1.86
202412,41615000,2S3,49,0,49,NA
202412,41615000,3,22,27,-5,0.81
202412,41615000,3S3,122,218,-96,0.56
202412,41615000,CA,23,73,-50,0.32
202412,41615000,V3,0,52,-52,0
202412,41660000,2,1,13,-12,0.08
202412,41660000,3,0,12,-12,0
202412,41660000,3S3,0,5,-5,0
202412,41660000,CA,0,29,-29,0
202412,41668000,2,72,235,-163,0.31
202412,41668000,2S2,1,0,1,NA
202412,41668000,2S3,1,0,1,NA
202412,41668000,3,3,6,-3,0.5
202412,41668000,3S3,3,33,-30,0.09
202412,41668000,CA,0,44,-44,0
202412,41668007,2,0,5,-5,0
202412,41668007,CA,0,2,-2,0
202412,41676000,2,0,20,-20,0
202412,41676000,CA,1,4,-3,0.25
202412,41770000,2,4,45,-41,0.09
202412,41770000,3,0,1,-1,0
202412,41770000,3S2,0,2,-2,0
202412,41770000,3S3,3,30,-27,0.1
202412,41770001,2,0,3,-3,0
202412,41770001,3,0,2,-2,0
202412,41791000,2,22,18,4,1.22
202412,41791000,3,3,1,2,3
202412,41791000,3S3,0,13,-13,0
202412,41791000,CA,1,1,0,1
202412,41797000,2,6,44,-38,0.14
202412,41797000,2S2,0,9,-9,0
202412,41797000,2S3,1,3,-2,0.33
202412,41797000,3,8,197,-189,0.04
202412,41797000,3S2,1,7,-6,0.14
202412,41797000,3S3,185,54,131,3.43
202412,41797000,3S4,2,2,0,1
202412,41797000,CA,1,10,-9,0.1
202412,41799000,2,2,25,-23,0.08
202412,41799000,3,1,0,1,NA
202412,41799000,3S2,1,30,-29,0.03
202412,41799000,3S3,0,30,-30,0
202412,41799000,CA,1,5,-4,0.2
202412,41801000,2,0,13,-13,0
202412,41801000,CA,2,27,-25,0.07
202412,41807000,2,10,76,-66,0.13
202412,41807000,3,0,5,-5,0
202412,41807000,3S2,1,2,-1,0.5
202412,41807000,3S3,4,105,-101,0.04
202412,41807000,CA,1,8,-7,0.12
202412,41807000,V3,0,2,-2,0
202412,41872000,2,2,10,-8,0.2
202412,41872000,3S2,26,1,25,26
202412,41872000,3S3,28,20,8,1.4
202412,41872000,CA,0,18,-18,0
202412,41872001,2,0,5,-5,0
202412,41885000,2,3,28,-25,0.11
202412,41885000,2S1,0,1,-1,0
202412,41885000,2S3,0,1,-1,0
202412,41885000,3,4,3,1,1.33
202412,41885000,3S1,1,0,1,NA
202412,41885000,3S3,7,17,-10,0.41
202412,41885000,4,1,0,1,NA
202412,41885000,CA,1,8,-7,0.12
202412,44001000,2,279,1913,-1634,0.15
202412,44001000,2B1,0,1,-1,0
202412,44001000,2B2,0,1,-1,0
202412,44001000,2R2,0,10,-10,0
202412,44001000,2S2,4,21,-17,0.19
202412,44001000,2S3,1,18,-17,0.06
202412,44001000,3,9,29,-20,0.31
202412,44001000,3S2,27,63,-36,0.43
202412,44001000,3S3,159,371,-212,0.43
202412,44001000,3S4,1,1,0,1
202412,44001000,4,0,1,-1,0
202412,44001000,CA,98,275,-177,0.36
202412,44001000,V2,3,0,3,NA
202412,44001000,V3,12,0,12,NA
202412,44001002,3S2,0,2,-2,0
202412,44001003,2,1,2,-1,0.5
202412,44001003,2S2,1,0,1,NA
202412,44001003,3,0,1,-1,0
202412,44001003,CA,0,1,-1,0
202412,44001005,2,0,1,-1,0
202412,44001005,2S3,1,0,1,NA
202412,44001008,2,0,7,-7,0
202412,44001011,3S2,8,0,8,NA
202412,44001016,3S2,0,6,-6,0
202412,44001020,3S2,4,0,4,NA
202412,44001020,3S3,9,0,9,NA
202412,44001025,3S2,29,3,26,9.67
202412,44001025,3S3,24,0,24,NA
202412,44001025,V3R3,15,0,15,NA
202412,44001026,2,0,1,-1,0
202412,44001027,3S3,0,1,-1,0
202412,44035000,2,42,295,-253,0.14
202412,44035000,2S2,118,62,56,1.9
202412,44035000,2S3,6,10,-4,0.6
202412,44035000,3,0,4,-4,0
202412,44035000,3S2,9,16,-7,0.56
202412,44035000,3S3,60,210,-150,0.29
202412,44035000,3S4,3,9,-6,0.33
202412,44035000,CA,7,88,-81,0.08
202412,44035001,2,14,17,-3,0.82
202412,44035001,2S2,1,3,-2,0.33
202412,44035001,2S3,0,1,-1,0
202412,44035001,3,2,2,0,1
202412,44035001,3S2,1,5,-4,0.2
202412,44035001,3S3,1,7,-6,0.14
202412,44035001,CA,1,1,0,1
202412,44078000,2,12,111,-99,0.11
202412,44078000,2S3,1,5,-4,0.2
202412,44078000,3,0,2,-2,0
202412,44078000,3S2,0,1,-1,0
202412,44078000,3S3,1,64,-63,0.02
202412,44078000,CA,2,26,-24,0.08
202412,44078001,2,0,1,-1,0
202412,44078006,2,0,1,-1,0
202412,44090000,2,9,81,-72,0.11
202412,44090000,2S3,0,2,-2,0
202412,44090000,3S3,41,2951,-2910,0.01
202412,44090000,3S4,1,0,1,NA
202412,44090000,4,0,1,-1,0
202412,44090000,CA,1,3,-2,0.33
202412,44090003,2,19,26,-7,0.73
202412,44090003,2S2,0,2,-2,0
202412,44090003,2S3,0,2,-2,0
202412,44090003,3,1,0,1,NA
202412,44090003,3R3,0,4,-4,0
202412,44090003,3S2,0,2,-2,0
202412,44090003,3S3,1,2341,-2340,0
202412,44090003,CA,2,5,-3,0.4
202412,44090004,2,17,28,-11,0.61
202412,44090004,2S3,0,1,-1,0
202412,44090004,3,1,0,1,NA
202412,44090004,3S3,1,5,-4,0.2
202412,44090004,CA,2,15,-13,0.13
202412,44090004,V2,15,0,15,NA
202412,44090004,V3,1,0,1,NA
202412,44090006,2,0,1,-1,0
202412,44098000,2,4,27,-23,0.15
202412,44098000,3S2,1,0,1,NA
202412,44098000,CA,0,1,-1,0
202412,44098001,2,1,1,0,1
202412,44098001,CA,0,4,-4,0
202412,44098002,2,0,22,-22,0
202412,44110000,2,1,19,-18,0.05
202412,44110000,3S3,0,5,-5,0
202412,44110000,CA,0,1,-1,0
202412,44279000,2,55,381,-326,0.14
202412,44279000,2R2,0,1,-1,0
202412,44279000,2S2,1,2,-1,0.5
202412,44279000,2S3,1,1,0,1
202412,44279000,3,0,3,-3,0
202412,44279000,3S3,37,99,-62,0.37
202412,44279000,CA,1,61,-60,0.02
202412,44279002,2,0,1,-1,0
202412,44279005,2,0,1,-1,0
202412,44378000,2,35,108,-73,0.32
202412,44378000,2S3,1,0,1,NA
202412,44378000,3,3,1,2,3
202412,44378000,3R3,3,0,3,NA
202412,44378000,3S3,1156,6,1150,192.67
202412,44378000,CA,0,16,-16,0
202412,44420000,2,0,3,-3,0
202412,44420000,3S3,0,1,-1,0
202412,44430000,2,326,2105,-1779,0.15
202412,44430000,2B1,0,2,-2,0
202412,44430000,2B2,0,3,-3,0
202412,44430000,2R2,0,34,-34,0
202412,44430000,2S2,17,88,-71,0.19
202412,44430000,2S3,3,43,-40,0.07
202412,44430000,3,0,74,-74,0
202412,44430000,3S2,2,42,-40,0.05
202412,44430000,3S3,57,1104,-1047,0.05
202412,44430000,CA,8,247,-239,0.03
202412,44430000,V2,0,5,-5,0
202412,44430000,V3,1,8,-7,0.12
202412,44430005,3S2,0,3,-3,0
202412,44430005,3S3,0,4,-4,0
202412,44430007,2,5,116,-111,0.04
202412,44430007,2R2,0,3,-3,0
202412,44430007,2S2,5,28,-23,0.18
202412,44430007,2S3,5,9,-4,0.56
202412,44430007,3,0,3,-3,0
202412,44430007,3S2,27,38,-11,0.71
202412,44430007,3S3,63,389,-326,0.16
202412,44430007,CA,0,17,-17,0
202412,44560000,2,5,115,-110,0.04
202412,44560000,2R2,0,1,-1,0
202412,44560000,2S2,0,1,-1,0
202412,44560000,2S3,1,2,-1,0.5
202412,44560000,3,0,3,-3,0
202412,44560000,3S2,1,0,1,NA
202412,44560000,3S3,1,29,-28,0.03
202412,44560000,CA,4,30,-26,0.13
202412,44560000,V2,0,8,-8,0
202412,44560000,V3,0,7,-7,0
202412,44560003,2,0,1,-1,0
202412,44560007,2,2,6,-4,0.33
202412,44560007,2S2,0,1,-1,0
202412,44650000,2,48,174,-126,0.28
202412,44650000,2R2,0,1,-1,0
202412,44650000,2S2,1,0,1,NA
202412,44650000,2S3,0,2,-2,0
202412,44650000,3,0,4,-4,0
202412,44650000,3S2,1,13,-12,0.08
202412,44650000,3S3,3,33,-30,0.09
202412,44650000,CA,3,39,-36,0.08
202412,44650009,2,0,1,-1,0
202412,44847000,2,169,311,-142,0.54
202412,44847000,2R2,0,12,-12,0
202412,44847000,2S2,11,7,4,1.57
202412,44847000,2S3,1,4,-3,0.25
202412,44847000,3,8,6,2,1.33
202412,44847000,3S2,11,9,2,1.22
202412,44847000,3S3,287,172,115,1.67
202412,44847000,3S4,0,1,-1,0
202412,44847000,CA,0,85,-85,0
202412,44847000,V2,0,5,-5,0
202412,44847000,V3,1,0,1,NA
202412,44847003,2,1,2,-1,0.5
202412,44847003,CA,2,0,2,NA
202412,44855000,2,1,41,-40,0.02
202412,44855000,3S3,1,7,-6,0.14
202412,44855000,CA,0,11,-11,0
202412,44874000,2,4,125,-121,0.03
202412,44874000,3S2,0,3,-3,0
202412,44874000,3S3,2,15,-13,0.13
202412,44874000,CA,0,25,-25,0
202412,47001000,2,2000,7399,-5399,0.27
202412,47001000,2B1,0,4,-4,0
202412,47001000,2B2,3,1,2,3
202412,47001000,2R2,3,210,-207,0.01
202412,47001000,2S2,823,469,354,1.75
202412,47001000,2S3,171,210,-39,0.81
202412,47001000,3,108,165,-57,0.65
202412,47001000,3R3,1,0,1,NA
202412,47001000,3S2,1312,2324,-1012,0.56
202412,47001000,3S2S3,0,1,-1,0
202412,47001000,3S3,12071,7906,4165,1.53
202412,47001000,3S3S2,1,0,1,NA
202412,47001000,3S4,4,3,1,1.33
202412,47001000,4,3,2,1,1.5
202412,47001000,CA,560,1417,-857,0.4
202412,47001000,V2,1,0,1,NA
202412,47001000,V3,4,0,4,NA
202412,47001000,V3R3,4,20,-16,0.2
202412,47001001,3S3,1,0,1,NA
202412,47001002,2,1,16,-15,0.06
202412,47001003,2,1,0,1,NA
202412,47001003,3S2,26,0,26,NA
202412,47001003,CA,0,1,-1,0
202412,47001005,2,6,2,4,3
202412,47001005,2S3,0,1,-1,0
202412,47001005,3,3,0,3,NA
202412,47001005,3S3,4,2,2,2
202412,47001006,2,6,11,-5,0.55
202412,47001006,3,0,1,-1,0
202412,47001006,3S2,88,68,20,1.29
202412,47001006,3S3,32,1,31,32
202412,47001006,CA,1,1,0,1
202412,47001009,CA,0,5,-5,0
202412,47001009,V3,0,1,-1,0
202412,47001010,2,0,4,-4,0
202412,47001011,2,3,2,1,1.5
202412,47001011,3S2,22,22,0,1
202412,47001011,3S3,29,0,29,NA
202412,47001011,CA,0,4,-4,0
202412,47001019,3S3,0,3,-3,0
202412,47030000,2,3,22,-19,0.14
202412,47030000,2S2,1,1,0,1
202412,47030000,2S3,1,0,1,NA
202412,47030000,3S2,1,1,0,1
202412,47030000,3S3,2,5,-3,0.4
202412,47030000,CA,0,4,-4,0
202412,47030004,2,2,0,2,NA
202412,47053000,2,14,128,-114,0.11
202412,47053000,2S2,3,1,2,3
202412,47053000,2S3,7,0,7,NA
202412,47053000,3,7,0,7,NA
202412,47053000,3S2,19,15,4,1.27
202412,47053000,3S3,202,114,88,1.77
202412,47053000,CA,0,11,-11,0
202412,47053000,V3R3,2,25,-23,0.08
202412,47053008,2,4,12,-8,0.33
202412,47053008,2B2,0,2,-2,0
202412,47053008,3,0,1,-1,0
202412,47053008,3S2,1,0,1,NA
202412,47053008,3S3,0,1,-1,0
202412,47053013,2,1,2,-1,0.5
202412,47058000,2,21,67,-46,0.31
202412,47058000,2S2,1,2,-1,0.5
202412,47058000,2S3,0,1,-1,0
202412,47058000,3,1,8,-7,0.12
202412,47058000,3S1,0,3,-3,0
202412,47058000,3S2,8,70,-62,0.11
202412,47058000,3S3,6,97,-91,0.06
202412,47058000,CA,0,5,-5,0
202412,47058003,2,5,5,0,1
202412,47058003,3S1,2,0,2,NA
202412,47058003,3S2,0,1,-1,0
202412,47058003,3S3,15,1,14,15
202412,47058003,3S4,3,0,3,NA
202412,47058005,2,0,1,-1,0
202412,47058005,CA,0,3,-3,0
202412,47161000,2,0,2,-2,0
202412,47161000,CA,0,1,-1,0
202412,47170000,2,5,64,-59,0.08
202412,47170000,3,0,6,-6,0
202412,47170000,3S3,1,9,-8,0.11
202412,47170000,CA,0,5,-5,0
202412,47170003,2,1,0,1,NA
202412,47189000,2,214,897,-683,0.24
202412,47189000,2B1,0,2,-2,0
202412,47189000,2R2,0,15,-15,0
202412,47189000,2S2,8,18,-10,0.44
202412,47189000,2S3,8,7,1,1.14
202412,47189000,3,27,43,-16,0.63
202412,47189000,3S2,16,57,-41,0.28
202412,47189000,3S2S3,2,0,2,NA
202412,47189000,3S3,470,313,157,1.5
202412,47189000,3S4,2,2,0,1
202412,47189000,CA,5,239,-234,0.02
202412,47189000,V3,0,1,-1,0
202412,47189004,2,0,5,-5,0
202412,47189009,2,4,6,-2,0.67
202412,47189009,2S2,9,7,2,1.29
202412,47189009,3S2,7,7,0,1
202412,47189018,2,0,2,-2,0
202412,47189022,3S2,6,6,0,1
202412,47189022,3S3,28,0,28,NA
202412,47205000,2,1,9,-8,0.11
202412,47205001,3S3,1,0,1,NA
202412,47205002,3S3,0,1,-1,0
202412,47245000,2,46,591,-545,0.08
202412,47245000,2B2,0,11,-11,0
202412,47245000,2R2,0,2,-2,0
202412,47245000,2S3,0,4,-4,0
202412,47245000,3,2,19,-17,0.11
202412,47245000,3S2,3,5,-2,0.6
202412,47245000,3S3,2,36,-34,0.06
202412,47245000,CA,21,49,-28,0.43
202412,47245001,2,0,5,-5,0
202412,47245005,2,0,1,-1,0
202412,47245005,3S3,0,3,-3,0
202412,47245020,2,0,1,-1,0
202412,47245028,3S2,0,1,-1,0
202412,47245028,3S3,0,4,-4,0
202412,47258000,2,0,30,-30,0
202412,47258000,CA,0,3,-3,0
202412,47258005,2,0,2,-2,0
202412,47258015,3S3,1,1,0,1
202412,47268000,2,7,71,-64,0.1
202412,47268000,3S2,21,18,3,1.17
202412,47268000,3S3,1,2,-1,0.5
202412,47268000,CA,1,3,-2,0.33
202412,47288000,2,102,626,-524,0.16
202412,47288000,2S2,2,24,-22,0.08
202412,47288000,2S3,1,6,-5,0.17
202412,47288000,3,7,27,-20,0.26
202412,47288000,3S2,19,14,5,1.36
202412,47288000,3S3,30,120,-90,0.25
202412,47288000,CA,6,88,-82,0.07
202412,47318000,2,19,170,-151,0.11
202412,47318000,2B2,0,3,-3,0
202412,47318000,2R2,0,1,-1,0
202412,47318000,3,0,5,-5,0
202412,47318000,3S2,0,1,-1,0
202412,47318000,3S3,0,16,-16,0
202412,47318000,CA,12,43,-31,0.28
202412,47318005,2,0,2,-2,0
202412,47318005,2S3,1,0,1,NA
202412,47318012,2,0,2,-2,0
202412,47318012,2S2,1,0,1,NA
202412,47318012,3S3,1,0,1,NA
202412,47318012,CA,4,4,0,1
202412,47318014,3S3,0,1,-1,0
202412,47318014,CA,0,2,-2,0
202412,47460000,2,7,13,-6,0.54
202412,47460000,3S2,0,1,-1,0
202412,47460000,3S3,0,8,-8,0
202412,47460000,CA,0,4,-4,0
202412,47460000,V3,0,1,-1,0
202412,47460001,CA,0,3,-3,0
202412,47460002,2,1,1,0,1
202412,47460004,2,0,2,-2,0
202412,47460004,3S2,1,0,1,NA
202412,47460005,2,0,9,-9,0
202412,47460005,3S3,0,2,-2,0
202412,47460005,CA,0,4,-4,0
202412,47541000,2,0,4,-4,0
202412,47545000,2,9,13,-4,0.69
202412,47545000,3,0,3,-3,0
202412,47545000,3S3,0,1,-1,0
202412,47551000,2,8,208,-200,0.04
202412,47551000,2R2,0,1,-1,0
202412,47551000,3S3,11,2,9,5.5
202412,47551000,CA,0,49,-49,0
202412,47551009,2,1,2,-1,0.5
202412,47551009,3,0,1,-1,0
202412,47555000,2,76,335,-259,0.23
202412,47555000,2B2,0,2,-2,0
202412,47555000,2R3,0,2,-2,0
202412,47555000,2S2,2,2,0,1
202412,47555000,2S3,2,1,1,2
202412,47555000,3,0,11,-11,0
202412,47555000,3S2,47,4,43,11.75
202412,47555000,3S3,532,52,480,10.23
202412,47555000,CA,2,28,-26,0.07
202412,47555001,3S2,32,0,32,NA
202412,47555001,3S3,50,0,50,NA
202412,47570000,2,1,2,-1,0.5
202412,47570000,CA,0,3,-3,0
202412,47605000,2,0,11,-11,0
202412,47605000,3S3,0,1,-1,0
202412,47605000,CA,0,1,-1,0
202412,47660000,2,14,6,8,2.33
202412,47660000,2S2,2,0,2,NA
202412,47660000,2S3,9,1,8,9
202412,47660000,3,0,16,-16,0
202412,47660000,3S2,1,0,1,NA
202412,47660000,3S3,1,2,-1,0.5
202412,47660011,2,2,0,2,NA
202412,47660011,2S2,4,0,4,NA
202412,47660011,3S2,1,0,1,NA
202412,47675000,2,1,12,-11,0.08
202412,47675000,3S3,0,1,-1,0
202412,47675000,CA,0,1,-1,0
202412,47692000,2,3,42,-39,0.07
202412,47692000,3,0,2,-2,0
202412,47692000,3S3,116,11,105,10.55
202412,47703000,2,1,2,-1,0.5
202412,47707000,2,3,60,-57,0.05
202412,47707000,2S2,6,0,6,NA
202412,47707000,3,0,4,-4,0
202412,47707000,3S2,2,0,2,NA
202412,47707000,3S3,7,8,-1,0.88
202412,47707000,CA,0,8,-8,0
202412,47707001,2,0,1,-1,0
202412,47707004,2,0,1,-1,0
202412,47720000,2,0,3,-3,0
202412,47720001,CA,0,1,-1,0
202412,47745000,2,16,44,-28,0.36
202412,47745000,2S2,2,2,0,1
202412,47745000,2S3,78,111,-33,0.7
202412,47745000,3,1,5,-4,0.2
202412,47745000,3S2,129,10,119,12.9
202412,47745000,3S3,3671,2660,1011,1.38
202412,47745000,3S4,2,0,2,NA
202412,47745000,CA,1,7,-6,0.14
202412,47745000,V2,69,6,63,11.5
202412,47745000,V3,340,14,326,24.29
202412,47745000,V4,66,0,66,NA
202412,47745003,2,336,88,248,3.82
202412,47745003,2S2,0,1,-1,0
202412,47745003,2S3,7,6,1,1.17
202412,47745003,3,101,6,95,16.83
202412,47745003,3S2,109,37,72,2.95
202412,47745003,3S3,1555,436,1119,3.57
202412,47745003,CA,0,19,-19,0
202412,47745003,V2,1,12,-11,0.08
202412,47745003,V3,36,62,-26,0.58
202412,47745003,V3R2,15,0,15,NA
202412,47745003,V4,10,0,10,NA
202412,47798000,2,2,9,-7,0.22
202412,47798000,3,1,2,-1,0.5
202412,47798000,3S3,1,5,-4,0.2
202412,47798000,CA,1,2,-1,0.5
202412,47960000,2,1,1,0,1
202412,47960000,3,0,5,-5,0
202412,47980000,2,232,101,131,2.3
202412,47980000,2S2,1,0,1,NA
202412,47980000,2S3,1,0,1,NA
202412,47980000,3,0,10,-10,0
202412,47980000,3S2,359,138,221,2.6
202412,47980000,3S3,248,47,201,5.28
202412,47980000,CA,1,13,-12,0.08
202412,47980001,2,109,21,88,5.19
202412,47980001,3S2,127,68,59,1.87
202412,47980001,CA,0,9,-9,0
202412,47980002,2,8,3,5,2.67
202412,47980002,2S2,1,0,1,NA
202412,47980002,2S3,0,1,-1,0
202412,47980002,3S2,16,19,-3,0.84
202412,47980002,3S3,11,8,3,1.38
202412,47980002,CA,1,1,0,1
202412,47980003,2,2,7,-5,0.29
202412,47980003,2R2,0,1,-1,0
202412,47980003,2S2,0,4,-4,0
202412,47980003,2S3,0,3,-3,0
202412,47980003,3,0,4,-4,0
202412,47980003,3S2,5,4,1,1.25
202412,47980003,3S3,1,25,-24,0.04
202412,47980003,CA,0,1,-1,0
202412,47980004,2,176,59,117,2.98
202412,47980004,2R2,0,5,-5,0
202412,47980004,2S3,0,4,-4,0
202412,47980004,3,0,1,-1,0
202412,47980004,3S2,245,192,53,1.28
202412,47980004,3S3,0,4,-4,0
202412,47980006,2,118,94,24,1.26
202412,47980006,2S2,1,0,1,NA
202412,47980006,3,0,1,-1,0
202412,47980006,3S2,48,45,3,1.07
202412,47980006,3S3,21,2,19,10.5
202412,47980006,CA,0,3,-3,0
202412,47980007,2,1,0,1,NA
202412,47980007,3S2,0,2,-2,0
202412,47980007,3S3,0,1,-1,0
202412,47980008,2,66,52,14,1.27
202412,47980008,3S2,151,135,16,1.12
202412,47980008,3S3,5,1,4,5
202412,47980008,CA,0,1,-1,0
202412,47980010,2,10,5,5,2
202412,47980010,2S3,1,1,0,1
202412,47980010,3,0,2,-2,0
202412,47980010,3S2,72,48,24,1.5
202412,47980010,3S3,15,13,2,1.15
202412,47980010,V3R3,15,0,15,NA
202412,47980011,2,0,2,-2,0
202412,47980011,3S2,14,3,11,4.67
202412,47980012,2,2,0,2,NA
202412,47980012,3S3,282,0,282,NA
202412,47980013,3S2,0,1,-1,0
202412,47980013,3S3,30,4,26,7.5
202412,47980013,V3R2,3,0,3,NA
202412,50001000,2,3463,7549,-4086,0.46
202412,50001000,2B1,1,2,-1,0.5
202412,50001000,2B2,47,0,47,NA
202412,50001000,2R2,2,16,-14,0.12
202412,50001000,2S1,8,37,-29,0.22
202412,50001000,2S2,266,678,-412,0.39
202412,50001000,2S3,271,279,-8,0.97
202412,50001000,3,410,366,44,1.12
202412,50001000,3R3,0,1,-1,0
202412,50001000,3S1,3,15,-12,0.2
202412,50001000,3S2,1020,1091,-71,0.93
202412,50001000,3S3,2448,3778,-1330,0.65
202412,50001000,3S4,2,6,-4,0.33
202412,50001000,4,20,7,13,2.86
202412,50001000,CA,884,1656,-772,0.53
202412,50001000,V2,3,10,-7,0.3
202412,50001000,V3,36,8,28,4.5
202412,50001000,V3R2,5,2,3,2.5
202412,50001000,V3R3,19,1,18,19
202412,50001000,V4,1,0,1,NA
202412,50001001,3S2,0,1,-1,0
202412,50001001,3S3,0,3,-3,0
202412,50001002,2,1,15,-14,0.07
202412,50001002,3,1,1,0,1
202412,50001002,3S2,5,18,-13,0.28
202412,50001002,3S3,6,69,-63,0.09
202412,50001002,CA,1,3,-2,0.33
202412,50001002,V3,2,0,2,NA
202412,50001004,2,0,2,-2,0
202412,50001013,2,0,2,-2,0
202412,50001015,2,9,11,-2,0.82
202412,50001015,2S3,1,1,0,1
202412,50001015,3S2,4,1,3,4
202412,50001015,3S3,12,72,-60,0.17
202412,50001015,CA,3,1,2,3
202412,50001019,2,61,3,58,20.33
202412,50001019,2S3,1,1,0,1
202412,50001019,3,83,1,82,83
202412,50001019,3S2,19,10,9,1.9
202412,50001019,3S3,37,216,-179,0.17
202412,50001019,CA,2,10,-8,0.2
202412,50006000,2,383,1188,-805,0.32
202412,50006000,2B2,0,9,-9,0
202412,50006000,2R2,0,1,-1,0
202412,50006000,2S1,2,0,2,NA
202412,50006000,2S2,42,24,18,1.75
202412,50006000,2S3,22,16,6,1.38
202412,50006000,3,204,100,104,2.04
202412,50006000,3S1,19,12,7,1.58
202412,50006000,3S2,1251,207,1044,6.04
202412,50006000,3S3,1299,706,593,1.84
202412,50006000,3S4,7,5,2,1.4
202412,50006000,4,2,0,2,NA
202412,50006000,CA,42,291,-249,0.14
202412,50006000,V2,15,151,-136,0.1
202412,50006000,V3,999,542,457,1.84
202412,50006001,2,0,3,-3,0
202412,50006001,3S3,1,2,-1,0.5
202412,50006001,CA,1,2,-1,0.5
202412,50006003,2,12,39,-27,0.31
202412,50006003,2S1,0,1,-1,0
202412,50006003,2S2,3,10,-7,0.3
202412,50006003,2S3,3,0,3,NA
202412,50006003,3,1,4,-3,0.25
202412,50006003,3S1,1,3,-2,0.33
202412,50006003,3S2,51,18,33,2.83
202412,50006003,3S3,23,42,-19,0.55
202412,50006003,3S4,4,0,4,NA
202412,50006003,4,0,1,-1,0
202412,50006003,CA,27,9,18,3
202412,50006003,V2,0,10,-10,0
202412,50006003,V3,21,36,-15,0.58
202412,50110000,2,25,62,-37,0.4
202412,50110000,2S2,8,5,3,1.6
202412,50110000,2S3,5,3,2,1.67
202412,50110000,3,3,19,-16,0.16
202412,50110000,3S2,504,83,421,6.07
202412,50110000,3S3,1006,166,840,6.06
202412,50110000,3S4,3,0,3,NA
202412,50110000,CA,9,27,-18,0.33
202412,50110000,V2,0,25,-25,0
202412,50110000,V3,154,39,115,3.95
202412,50110001,3S3,25,0,25,NA
202412,50110004,3S3,0,1,-1,0
202412,50124000,2,14,92,-78,0.15
202412,50124000,2S2,5,5,0,1
202412,50124000,2S3,8,6,2,1.33
202412,50124000,3,5,39,-34,0.13
202412,50124000,3S2,1243,12,1231,103.58
202412,50124000,3S3,2881,97,2784,29.7
202412,50124000,3S4,2,2,0,1
202412,50124000,4,4,0,4,NA
202412,50124000,CA,3,11,-8,0.27
202412,50124000,V2,0,86,-86,0
202412,50124000,V3,5,569,-564,0.01
202412,50124004,3S3,1,0,1,NA
202412,50150000,2,49,259,-210,0.19
202412,50150000,2S2,6,29,-23,0.21
202412,50150000,2S3,6,46,-40,0.13
202412,50150000,3,9,23,-14,0.39
202412,50150000,3S1,15,8,7,1.88
202412,50150000,3S2,146,421,-275,0.35
202412,50150000,3S3,143,260,-117,0.55
202412,50150000,3S4,2,5,-3,0.4
202412,50150000,4,0,1,-1,0
202412,50150000,CA,6,71,-65,0.08
202412,50150000,V2,6,85,-79,0.07
202412,50150000,V3,48,59,-11,0.81
202412,50150001,CA,0,3,-3,0
202412,50150002,3S3,0,1,-1,0
202412,50223000,2,4,35,-31,0.11
202412,50223000,2S2,1,0,1,NA
202412,50223000,3,0,2,-2,0
202412,50223000,3S2,2,2,0,1
202412,50223000,3S3,0,5,-5,0
202412,50223000,CA,1,8,-7,0.12
202412,50226000,2,47,214,-167,0.22
202412,50226000,2B2,0,3,-3,0
202412,50226000,2R3,0,1,-1,0
202412,50226000,2S2,0,2,-2,0
202412,50226000,2S3,1,0,1,NA
202412,50226000,3,11,58,-47,0.19
202412,50226000,3S2,46,5,41,9.2
202412,50226000,3S3,168,53,115,3.17
202412,50226000,CA,4,69,-65,0.06
202412,50226000,V2,30,0,30,NA
202412,50226000,V3,0,10,-10,0
202412,50226004,2,1,0,1,NA
202412,50226005,2,1,1,0,1
202412,50226005,3,0,2,-2,0
202412,50226005,3S3,0,1,-1,0
202412,50245000,CA,1,0,1,NA
202412,50251000,2,15,50,-35,0.3
202412,50251000,3S2,1,1,0,1
202412,50251000,3S3,0,2,-2,0
202412,50251000,CA,0,8,-8,0
202412,50251001,2,1,2,-1,0.5
202412,50270000,2,0,25,-25,0
202412,50270000,3,0,3,-3,0
202412,50270000,3S3,0,1,-1,0
202412,50270000,CA,0,5,-5,0
202412,50270000,V2,1,0,1,NA
202412,50287000,2,1,44,-43,0.02
202412,50287000,2B2,0,3,-3,0
202412,50287000,2S3,0,1,-1,0
202412,50287000,3,0,1,-1,0
202412,50287000,3S2,0,1,-1,0
202412,50287000,3S3,3,2,1,1.5
202412,50287000,CA,0,2,-2,0
202412,50313000,2,131,1261,-1130,0.1
202412,50313000,2B2,0,5,-5,0
202412,50313000,2S2,1,9,-8,0.11
202412,50313000,2S3,0,18,-18,0
202412,50313000,3,7,24,-17,0.29
202412,50313000,3S2,2,15,-13,0.13
202412,50313000,3S3,101,273,-172,0.37
202412,50313000,CA,15,269,-254,0.06
202412,50313002,2,0,23,-23,0
202412,50313002,2S2,0,22,-22,0
202412,50313002,2S3,0,6,-6,0
202412,50313006,2,0,1,-1,0
202412,50318000,2,121,156,-35,0.78
202412,50318000,2B2,0,2,-2,0
202412,50318000,2S1,1,0,1,NA
202412,50318000,2S2,6,7,-1,0.86
202412,50318000,2S3,3,2,1,1.5
202412,50318000,3,244,60,184,4.07
202412,50318000,3S1,5,4,1,1.25
202412,50318000,3S2,1069,221,848,4.84
202412,50318000,3S3,950,341,609,2.79
202412,50318000,3S4,2,1,1,2
202412,50318000,CA,12,53,-41,0.23
202412,50318000,V2,248,7,241,35.43
202412,50318000,V3,990,4,986,247.5
202412,50318001,2,1,1,0,1
202412,50318001,V3,5,0,5,NA
202412,50325000,2,0,5,-5,0
202412,50325000,3,0,4,-4,0
202412,50325000,3S2,14,0,14,NA
202412,50325000,3S3,48,6,42,8
202412,50325000,CA,1,1,0,1
202412,50330000,2,4,62,-58,0.06
202412,50330000,2B2,0,4,-4,0
202412,50330000,3,0,1,-1,0
202412,50330000,3S2,1,0,1,NA
202412,50330000,3S3,1,4,-3,0.25
202412,50330000,CA,0,9,-9,0
202412,50330008,2S3,0,1,-1,0
202412,50330008,3S3,0,1,-1,0
202412,50350000,2,0,17,-17,0
202412,50350000,3,0,1,-1,0
202412,50350000,3S3,0,1,-1,0
202412,50350000,CA,1,0,1,NA
202412,50350003,2,0,1,-1,0
202412,50350003,CA,1,0,1,NA
202412,50370000,2,0,26,-26,0
202412,50370000,3S3,0,7,-7,0
202412,50370000,CA,1,2,-1,0.5
202412,50370001,CA,1,0,1,NA
202412,50400000,2,1,27,-26,0.04
202412,50400000,2S2,0,1,-1,0
202412,50400000,3,0,1,-1,0
202412,50400000,3S3,1,5,-4,0.2
202412,50400000,CA,1,14,-13,0.07
202412,50400000,V2,0,1,-1,0
202412,50400001,2,0,1,-1,0
202412,50450000,2,4,8,-4,0.5
202412,50450000,3,0,2,-2,0
202412,50450000,3S3,0,2,-2,0
202412,50568000,2,181,927,-746,0.2
202412,50568000,2B2,0,4,-4,0
202412,50568000,2S2,15,35,-20,0.43
202412,50568000,2S3,33,54,-21,0.61
202412,50568000,3,18,92,-74,0.2
202412,50568000,3R2,0,24,-24,0
202412,50568000,3R3,0,17,-17,0
202412,50568000,3S1,0,4,-4,0
202412,50568000,3S2,1535,449,1086,3.42
202412,50568000,3S2S3,0,1,-1,0
202412,50568000,3S3,2927,1401,1526,2.09
202412,50568000,3S4,3,11,-8,0.27
202412,50568000,4,1,0,1,NA
202412,50568000,CA,26,182,-156,0.14
202412,50568000,V2,1,0,1,NA
202412,50568000,V2R2,0,15,-15,0
202412,50568000,V2R3,0,85,-85,0
202412,50568000,V3,2,0,2,NA
202412,50568000,V3R2,0,21,-21,0
202412,50568000,V3R3,0,360,-360,0
202412,50568000,V4,2,0,2,NA
202412,50568001,2,3,7,-4,0.43
202412,50568001,2S2,0,1,-1,0
202412,50568001,3S3,0,2,-2,0
202412,50568004,2,0,1,-1,0
202412,50568006,2,0,1,-1,0
202412,50568007,2,0,2,-2,0
202412,50568007,3S3,2,3,-1,0.67
202412,50568007,V3R2,0,1,-1,0
202412,50568007,V3R3,0,1,-1,0
202412,50568009,3S2,0,8,-8,0
202412,50568009,3S3,0,7,-7,0
202412,50568010,2,8,23,-15,0.35
202412,50568010,2S2,3,5,-2,0.6
202412,50568010,2S3,3,5,-2,0.6
202412,50568010,3S2,1,2,-1,0.5
202412,50568010,3S3,10,9,1,1.11
202412,50568010,CA,3,8,-5,0.38
202412,50568011,2,52,192,-140,0.27
202412,50568011,2S2,12,22,-10,0.55
202412,50568011,2S3,5,18,-13,0.28
202412,50568011,3,0,16,-16,0
202412,50568011,3R2,0,2,-2,0
202412,50568011,3R3,0,1,-1,0
202412,50568011,3S2,74,341,-267,0.22
202412,50568011,3S2S3,1,0,1,NA
202412,50568011,3S3,222,710,-488,0.31
202412,50568011,3S4,16,7,9,2.29
202412,50568011,CA,11,62,-51,0.18
202412,50568011,V2R2,0,1,-1,0
202412,50568011,V2R3,0,13,-13,0
202412,50568011,V3,5,0,5,NA
202412,50568011,V3R2,0,14,-14,0
202412,50568011,V3R3,0,153,-153,0
202412,50568011,V4R2,0,5,-5,0
202412,50573000,2,100,291,-191,0.34
202412,50573000,2B2,0,9,-9,0
202412,50573000,2S2,2,11,-9,0.18
202412,50573000,2S3,54,48,6,1.12
202412,50573000,3,17,19,-2,0.89
202412,50573000,3R2,26,0,26,NA
202412,50573000,3R3,18,0,18,NA
202412,50573000,3S1,2,0,2,NA
202412,50573000,3S2,214,35,179,6.11
202412,50573000,3S3,737,159,578,4.64
202412,50573000,4,1,6,-5,0.17
202412,50573000,CA,6,63,-57,0.1
202412,50573000,V2,86,0,86,NA
202412,50573000,V2R2,16,0,16,NA
202412,50573000,V2R3,98,0,98,NA
202412,50573000,V3,551,0,551,NA
202412,50573000,V3R2,28,0,28,NA
202412,50573000,V3R3,493,0,493,NA
202412,50573000,V4R2,5,0,5,NA
202412,50573001,3S3,11,0,11,NA
202412,50573001,V3R2,3,0,3,NA
202412,50573001,V3R3,2,0,2,NA
202412,50573003,2,2,4,-2,0.5
202412,50573003,3,1,0,1,NA
202412,50573003,3S2,0,1,-1,0
202412,50573003,3S3,5,2,3,2.5
202412,50573010,2,0,1,-1,0
202412,50577000,2,6,22,-16,0.27
202412,50577000,2S2,2,2,0,1
202412,50577000,3S2,1,0,1,NA
202412,50577000,3S3,1,2,-1,0.5
202412,50590000,2,2,21,-19,0.1
202412,50590000,2S2,0,6,-6,0
202412,50590000,3,1,1,0,1
202412,50590000,3S2,6,0,6,NA
202412,50590000,3S3,73,33,40,2.21
202412,50590000,CA,1,9,-8,0.11
202412,50590000,V3,128,0,128,NA
202412,50606000,2,13,130,-117,0.1
202412,50606000,2B2,0,2,-2,0
202412,50606000,2S2,6,10,-4,0.6
202412,50606000,2S3,0,2,-2,0
202412,50606000,3,4,61,-57,0.07
202412,50606000,3S2,2,8,-6,0.25
202412,50606000,3S3,5,47,-42,0.11
202412,50606000,4,0,4,-4,0
202412,50606000,CA,3,41,-38,0.07
202412,50606000,V2,3,0,3,NA
202412,50680000,2,18,76,-58,0.24
202412,50680000,2S2,1,5,-4,0.2
202412,50680000,2S3,6,4,2,1.5
202412,50680000,3,2,90,-88,0.02
202412,50680000,3S1,0,1,-1,0
202412,50680000,3S2,102,110,-8,0.93
202412,50680000,3S3,537,286,251,1.88
202412,50680000,4,2,0,2,NA
202412,50680000,CA,1,22,-21,0.05
202412,50680000,V2,0,10,-10,0
202412,50680000,V3,1,1372,-1371,0
202412,50680002,2,2,0,2,NA
202412,50680002,CA,3,0,3,NA
202412,50680003,2,0,3,-3,0
202412,50683000,2,3,13,-10,0.23
202412,50683000,2S2,0,3,-3,0
202412,50683000,2S3,1,0,1,NA
202412,50683000,3,0,4,-4,0
202412,50683000,3S3,3,0,3,NA
202412,50683000,CA,1,1,0,1
202412,50683000,V3,0,1,-1,0
202412,50686000,CA,1,0,1,NA
202412,50689000,2,103,192,-89,0.54
202412,50689000,2B2,0,2,-2,0
202412,50689000,2S2,7,0,7,NA
202412,50689000,2S3,2,0,2,NA
202412,50689000,3,13,5,8,2.6
202412,50689000,3S1,3,0,3,NA
202412,50689000,3S2,37,2,35,18.5
202412,50689000,3S3,298,21,277,14.19
202412,50689000,3S4,2,0,2,NA
202412,50689000,4,0,2,-2,0
202412,50689000,CA,54,26,28,2.08
202412,50689000,V3,0,128,-128,0
202412,50711000,2,4,86,-82,0.05
202412,50711000,2S2,1,0,1,NA
202412,50711000,3,1,0,1,NA
202412,50711000,3S2,0,1,-1,0
202412,50711000,3S3,1,16,-15,0.06
202412,50711000,CA,0,9,-9,0
202412,52001000,2,3299,4890,-1591,0.67
202412,52001000,2B1,0,1,-1,0
202412,52001000,2R2,0,2,-2,0
202412,52001000,2S2,47,328,-281,0.14
202412,52001000,2S3,10,69,-59,0.14
202412,52001000,3,19,99,-80,0.19
202412,52001000,3S2,172,419,-247,0.41
202412,52001000,3S3,450,2016,-1566,0.22
202412,52001000,3S4,2,0,2,NA
202412,52001000,CA,1191,481,710,2.48
202412,52001000,V2,2,1,1,2
202412,52001001,2,32,34,-2,0.94
202412,52001001,2S2,0,1,-1,0
202412,52001001,3S2,32,0,32,NA
202412,52001001,3S3,1,0,1,NA
202412,52001001,CA,6,23,-17,0.26
202412,52001003,2,0,7,-7,0
202412,52001003,3,1,0,1,NA
202412,52001003,CA,0,19,-19,0
202412,52001006,2,3,7,-4,0.43
202412,52001006,2S2,0,2,-2,0
202412,52001006,CA,1,1,0,1
202412,52001010,2,0,3,-3,0
202412,52001024,2,0,1,-1,0
202412,52001029,3S2,1,0,1,NA
202412,52001061,2,0,1,-1,0
202412,52019000,2,0,36,-36,0
202412,52019000,3,0,1,-1,0
202412,52019003,2,0,6,-6,0
202412,52019003,CA,0,18,-18,0
202412,52022000,2,1,18,-17,0.06
202412,52022000,3S3,0,1,-1,0
202412,52022000,CA,0,14,-14,0
202412,52036000,2,2,4,-2,0.5
202412,52036000,CA,0,13,-13,0
202412,52051000,2,0,3,-3,0
202412,52051000,CA,0,2,-2,0
202412,52079000,2,5,86,-81,0.06
202412,52079000,2S3,0,1,-1,0
202412,52079000,3,0,1,-1,0
202412,52079000,3S2,0,1,-1,0
202412,52079000,3S3,0,2,-2,0
202412,52079000,CA,0,19,-19,0
202412,52079012,2,0,1,-1,0
202412,52083000,2,4,15,-11,0.27
202412,52083000,CA,0,15,-15,0
202412,52110000,2,11,43,-32,0.26
202412,52110000,3,1,1,0,1
202412,52110000,3S2,1,2,-1,0.5
202412,52110000,3S3,0,15,-15,0
202412,52110000,CA,2,19,-17,0.11
202412,52110000,V2,0,1,-1,0
202412,52110007,2,1,3,-2,0.33
202412,52203000,2,0,17,-17,0
202412,52203000,CA,0,28,-28,0
202412,52203007,2,1,12,-11,0.08
202412,52203007,CA,0,1,-1,0
202412,52207000,2,3,24,-21,0.12
202412,52207000,3S2,0,1,-1,0
202412,52207000,3S3,0,1,-1,0
202412,52207000,CA,0,14,-14,0
202412,52210000,2,2,3,-1,0.67
202412,52210000,CA,0,1,-1,0
202412,52210002,2,0,1,-1,0
202412,52215000,2,0,23,-23,0
202412,52215000,3,0,1,-1,0
202412,52215000,CA,1,19,-18,0.05
202412,52215002,2,0,3,-3,0
202412,52224000,2,0,5,-5,0
202412,52224000,2S2,3,1,2,3
202412,52224000,3,0,1,-1,0
202412,52224000,CA,0,6,-6,0
202412,52227000,2,4,82,-78,0.05
202412,52227000,3S3,3,39,-36,0.08
202412,52227000,CA,0,27,-27,0
202412,52227001,CA,0,1,-1,0
202412,52233000,2,0,3,-3,0
202412,52233000,CA,0,1,-1,0
202412,52233003,2,0,1,-1,0
202412,52240000,2,2,35,-33,0.06
202412,52240000,3,0,1,-1,0
202412,52240000,3S2,1,0,1,NA
202412,52240000,3S3,2,3,-1,0.67
202412,52240000,CA,28,27,1,1.04
202412,52254000,2,0,17,-17,0
202412,52254000,CA,0,1,-1,0
202412,52256000,2,1,4,-3,0.25
202412,52256000,3S2,0,1,-1,0
202412,52256000,CA,0,16,-16,0
202412,52256003,2,0,2,-2,0
202412,52256005,2,0,3,-3,0
202412,52256017,2,0,3,-3,0
202412,52256021,2,0,2,-2,0
202412,52256021,3S3,0,2,-2,0
202412,52258000,2,0,26,-26,0
202412,52258003,2,0,7,-7,0
202412,52258003,CA,0,1,-1,0
202412,52260000,2,19,41,-22,0.46
202412,52260000,2S2,1,0,1,NA
202412,52260000,2S3,1,0,1,NA
202412,52260000,3,0,1,-1,0
202412,52260000,3S2,2,0,2,NA
202412,52260000,3S3,0,2,-2,0
202412,52260000,CA,0,14,-14,0
202412,52260009,2,0,2,-2,0
202412,52260009,2S3,0,1,-1,0
202412,52287000,2,1,11,-10,0.09
202412,52287000,CA,0,7,-7,0
202412,52317000,2,0,112,-112,0
202412,52317000,2S2,1,0,1,NA
202412,52317000,3,2,0,2,NA
202412,52317000,3S2,3,2,1,1.5
202412,52317000,3S3,2,32,-30,0.06
202412,52317000,CA,0,26,-26,0
202412,52320000,2,4,19,-15,0.21
202412,52320000,3,0,1,-1,0
202412,52320000,3S3,0,4,-4,0
202412,52320000,CA,0,5,-5,0
202412,52320001,2,0,5,-5,0
202412,52320001,2S2,0,2,-2,0
202412,52320001,2S3,0,1,-1,0
202412,52320001,3S3,0,1,-1,0
202412,52320001,CA,0,3,-3,0
202412,52320003,2,1,1,0,1
202412,52320003,CA,0,1,-1,0
202412,52320016,2,0,1,-1,0
202412,52323000,2,0,15,-15,0
202412,52323000,3S3,0,1,-1,0
202412,52323000,CA,0,1,-1,0
202412,52352000,2,0,25,-25,0
202412,52352000,3,1,0,1,NA
202412,52352000,CA,0,11,-11,0
202412,52354000,2,2,0,2,NA
202412,52354000,3S2,0,2,-2,0
202412,52354000,CA,0,15,-15,0
202412,52354000,V2,1,2,-1,0.5
202412,52354002,2,0,1,-1,0
202412,52354002,3S3,0,1,-1,0
202412,52356000,2,566,2991,-2425,0.19
202412,52356000,2R2,0,1,-1,0
202412,52356000,2S1,0,1,-1,0
202412,52356000,2S2,52,235,-183,0.22
202412,52356000,2S3,29,62,-33,0.47
202412,52356000,3,15,26,-11,0.58
202412,52356000,3S1,0,1,-1,0
202412,52356000,3S2,68,167,-99,0.41
202412,52356000,3S3,871,936,-65,0.93
202412,52356000,3S4,0,1,-1,0
202412,52356000,CA,159,301,-142,0.53
202412,52356001,2,0,1,-1,0
202412,52356002,2,0,2,-2,0
202412,52356003,2,0,18,-18,0
202412,52356003,3S2,0,3,-3,0
202412,52356003,3S3,0,96,-96,0
202412,52356006,2,0,5,-5,0
202412,52378000,2,2,65,-63,0.03
202412,52378000,3,0,10,-10,0
202412,52378000,3S3,0,3,-3,0
202412,52378000,CA,0,22,-22,0
202412,52378009,2,0,3,-3,0
202412,52381000,2,0,7,-7,0
202412,52381000,CA,0,16,-16,0
202412,52381001,2,0,1,-1,0
202412,52385000,2,2,16,-14,0.12
202412,52385000,CA,0,8,-8,0
202412,52385007,2,0,1,-1,0
202412,52385012,2,0,1,-1,0
202412,52390000,2,0,1,-1,0
202412,52399000,2,102,260,-158,0.39
202412,52399000,3,6,2,4,3
202412,52399000,3S2,1,2,-1,0.5
202412,52399000,3S3,7,47,-40,0.15
202412,52399000,CA,30,94,-64,0.32
202412,52399000,V2,1,0,1,NA
202412,52405000,2,0,11,-11,0
202412,52405000,3,0,1,-1,0
202412,52405000,CA,0,2,-2,0
202412,52405001,2,0,3,-3,0
202412,52405001,3,0,1,-1,0
202412,52405005,2,0,1,-1,0
202412,52405005,3S3,0,5,-5,0
202412,52405008,2,1,1,0,1
202412,52405008,CA,0,9,-9,0
202412,52411000,2,1,37,-36,0.03
202412,52411000,CA,0,17,-17,0
202412,52418000,2,2,19,-17,0.11
202412,52418000,3,0,2,-2,0
202412,52418000,3S3,0,1,-1,0
202412,52418000,CA,0,3,-3,0
202412,52427006,2,0,2,-2,0
202412,52435000,2,6,4,2,1.5
202412,52435000,3,10,0,10,NA
202412,52435000,3S2,2,0,2,NA
202412,52435000,CA,0,9,-9,0
202412,52473000,2,5,1,4,5
202412,52473000,2S2,0,1,-1,0
202412,52473000,2S3,0,1,-1,0
202412,52473000,3S3,0,3,-3,0
202412,52473000,CA,0,1,-1,0
202412,52473010,2,0,3,-3,0
202412,52480000,2,1,15,-14,0.07
202412,52480000,2S2,3,1,2,3
202412,52480000,CA,0,3,-3,0
202412,52506000,2,0,6,-6,0
202412,52506000,CA,0,9,-9,0
202412,52540000,2,3,19,-16,0.16
202412,52540000,3S2,1,0,1,NA
202412,52540000,CA,0,1,-1,0
202412,52540002,2,0,3,-3,0
202412,52560000,2,0,7,-7,0
202412,52560000,CA,0,20,-20,0
202412,52560011,CA,0,1,-1,0
202412,52565000,2,0,2,-2,0
202412,52565000,CA,0,8,-8,0
202412,52573000,2,1,20,-19,0.05
202412,52573000,2S3,0,1,-1,0
202412,52573000,CA,0,15,-15,0
202412,52573004,2,0,3,-3,0
202412,52585000,2,3,86,-83,0.03
202412,52585000,3,0,1,-1,0
202412,52585000,3S2,0,1,-1,0
202412,52585000,3S3,0,16,-16,0
202412,52585000,CA,0,44,-44,0
202412,52612000,2,0,41,-41,0
202412,52612000,3,0,1,-1,0
202412,52612000,CA,0,10,-10,0
202412,52612008,2,0,1,-1,0
202412,52678000,2,10,78,-68,0.13
202412,52678000,3S3,0,11,-11,0
202412,52678000,CA,0,25,-25,0
202412,52678017,2,0,4,-4,0
202412,52678017,2S2,0,3,-3,0
202412,52678017,2S3,0,29,-29,0
202412,52678017,3S3,0,6,-6,0
202412,52683000,2,28,96,-68,0.29
202412,52683000,3,0,1,-1,0
202412,52683000,3S3,4,7,-3,0.57
202412,52683000,CA,0,28,-28,0
202412,52683000,V3,1,0,1,NA
202412,52685000,2,13,22,-9,0.59
202412,52685000,3S3,0,1,-1,0
202412,52685000,CA,0,12,-12,0
202412,52687000,2,1,22,-21,0.05
202412,52687000,3S3,0,13,-13,0
202412,52687000,CA,0,16,-16,0
202412,52693000,2,3,84,-81,0.04
202412,52693000,3,0,1,-1,0
202412,52693000,3S3,0,4,-4,0
202412,52693000,CA,0,28,-28,0
202412,52694000,2,0,2,-2,0
202412,52699000,2,0,1,-1,0
202412,52720000,2,0,11,-11,0
202412,52720000,3S2,0,2,-2,0
202412,52720001,2,2,0,2,NA
202412,52720001,3S2,1,0,1,NA
202412,52720001,3S3,1,1,0,1
202412,52786000,2,2,58,-56,0.03
202412,52786000,3,0,6,-6,0
202412,52786000,3S3,2,3,-1,0.67
202412,52786000,CA,0,28,-28,0
202412,52786001,CA,0,3,-3,0
202412,52786019,2,1,12,-11,0.08
202412,52786019,3,0,1,-1,0
202412,52786019,3S2,13,2,11,6.5
202412,52786019,3S3,3,14,-11,0.21
202412,52788000,2,2,6,-4,0.33
202412,52788000,CA,0,10,-10,0
202412,52788007,2,0,1,-1,0
202412,52835000,2,94,1136,-1042,0.08
202412,52835000,2S2,0,9,-9,0
202412,52835000,2S3,1,1,0,1
202412,52835000,3,33,52,-19,0.63
202412,52835000,3S2,27,15,12,1.8
202412,52835000,3S3,96,252,-156,0.38
202412,52835000,CA,18,139,-121,0.13
202412,52835017,2,0,1,-1,0
202412,52835031,2,2,72,-70,0.03
202412,52835031,3S2,0,6,-6,0
202412,52835031,3S3,0,3,-3,0
202412,52835031,CA,1,2,-1,0.5
202412,52835046,CA,0,1,-1,0
202412,52835062,2,0,1,-1,0
202412,52835143,2S2,0,2,-2,0
202412,52835143,2S3,0,3,-3,0
202412,52835143,3S3,0,1,-1,0
202412,52835148,CA,1,0,1,NA
202412,52835163,3,0,17,-17,0
202412,52838000,2,40,346,-306,0.12
202412,52838000,2S2,0,2,-2,0
202412,52838000,2S3,0,2,-2,0
202412,52838000,3,0,7,-7,0
202412,52838000,3S3,3,88,-85,0.03
202412,52838000,CA,80,70,10,1.14
202412,52838009,2,0,1,-1,0
202412,52885000,2,3,23,-20,0.13
202412,52885000,3S2,1,0,1,NA
202412,52885000,3S3,0,1,-1,0
202412,52885000,CA,0,11,-11,0
202412,54001000,2,4713,10077,-5364,0.47
202412,54001000,2B1,0,1,-1,0
202412,54001000,2B2,0,2,-2,0
202412,54001000,2R2,108,30,78,3.6
202412,54001000,2S1,1,0,1,NA
202412,54001000,2S2,181,509,-328,0.36
202412,54001000,2S3,52,92,-40,0.57
202412,54001000,3,230,399,-169,0.58
202412,54001000,3R3,0,12,-12,0
202412,54001000,3S2,341,546,-205,0.62
202412,54001000,3S3,4390,4647,-257,0.94
202412,54001000,3S4,1,2,-1,0.5
202412,54001000,4,3,2,1,1.5
202412,54001000,CA,1090,1488,-398,0.73
202412,54001000,V2,285,141,144,2.02
202412,54001000,V3,87,37,50,2.35
202412,54001000,V4,35,364,-329,0.1
202412,54001001,2,1,17,-16,0.06
202412,54001001,2S2,1,0,1,NA
202412,54001001,3,0,1,-1,0
202412,54001001,3S2,0,1,-1,0
202412,54001001,3S3,0,17,-17,0
202412,54001001,CA,0,24,-24,0
202412,54001002,2,0,1,-1,0
202412,54001002,3,0,1,-1,0
202412,54001017,2S2,0,1,-1,0
202412,54001017,3S2,1,2,-1,0.5
202412,54001017,3S3,50,0,50,NA
202412,54001018,3S2,1,0,1,NA
202412,54001018,V2,36,0,36,NA
202412,54001025,2,0,1,-1,0
202412,54001027,2,0,1,-1,0
202412,54001027,3S3,1,0,1,NA
202412,54001042,2,2,8,-6,0.25
202412,54001042,3,0,1,-1,0
202412,54001042,3S3,0,6,-6,0
202412,54001045,2,1,0,1,NA
202412,54001045,2S2,0,1,-1,0
202412,54001046,3S3,157,0,157,NA
202412,54001047,2,0,5,-5,0
202412,54001047,3,0,8,-8,0
202412,54001047,3S3,0,1,-1,0
202412,54003000,2,36,277,-241,0.13
202412,54003000,2S2,2,2,0,1
202412,54003000,2S3,0,1,-1,0
202412,54003000,3,0,28,-28,0
202412,54003000,3S2,0,1,-1,0
202412,54003000,3S3,1,14,-13,0.07
202412,54003000,CA,0,20,-20,0
202412,54003020,2,0,1,-1,0
202412,54051000,2,1,18,-17,0.06
202412,54051000,CA,0,25,-25,0
202412,54099000,2,10,36,-26,0.28
202412,54099000,2S2,1,0,1,NA
202412,54099000,3,11,0,11,NA
202412,54099000,3R3,15,0,15,NA
202412,54099000,3S2,0,1,-1,0
202412,54099000,3S3,294,11,283,26.73
202412,54099000,V2,10,0,10,NA
202412,54099000,V3,54,0,54,NA
202412,54099000,V4,3,0,3,NA
202412,54099002,2,19,1,18,19
202412,54099002,2S2,0,1,-1,0
202412,54099002,3S3,13,0,13,NA
202412,54099002,CA,0,1,-1,0
202412,54099002,V2,36,0,36,NA
202412,54099002,V3,23,0,23,NA
202412,54109000,2,5,26,-21,0.19
202412,54109000,CA,0,8,-8,0
202412,54109002,2,0,1,-1,0
202412,54125000,2,0,1,-1,0
202412,54128000,2,5,6,-1,0.83
202412,54128000,CA,0,5,-5,0
202412,54128003,2,1,0,1,NA
202412,54128012,2,0,1,-1,0
202412,54172000,2,7,93,-86,0.08
202412,54172000,2S2,4,4,0,1
202412,54172000,3,0,8,-8,0
202412,54172000,3S2,6,2,4,3
202412,54172000,3S3,5,1,4,5
202412,54172000,CA,1,38,-37,0.03
202412,54172000,V2,0,30,-30,0
202412,54174000,2,8,18,-10,0.44
202412,54174000,3S3,0,3,-3,0
202412,54174000,CA,0,11,-11,0
202412,54174000,V2,14,0,14,NA
202412,54174005,2,0,1,-1,0
202412,54206000,2,1,14,-13,0.07
202412,54206000,CA,0,2,-2,0
202412,54206010,2,1,4,-3,0.25
202412,54206010,3,0,1,-1,0
202412,54206010,3S3,0,8,-8,0
202412,54206013,2,0,56,-56,0
202412,54206013,2R3,0,2,-2,0
202412,54223000,2,2,12,-10,0.17
202412,54223000,3S3,0,1,-1,0
202412,54223000,CA,0,26,-26,0
202412,54239000,2,1,9,-8,0.11
202412,54239000,3,0,2,-2,0
202412,54239000,V2,23,0,23,NA
202412,54245000,2,5,15,-10,0.33
202412,54245006,2,0,1,-1,0
202412,54250000,2,0,6,-6,0
202412,54250002,2,0,1,-1,0
202412,54261000,2,62,198,-136,0.31
202412,54261000,2S2,1,2,-1,0.5
202412,54261000,2S3,1,0,1,NA
202412,54261000,3,13,22,-9,0.59
202412,54261000,3R3,1,0,1,NA
202412,54261000,3S2,4,5,-1,0.8
202412,54261000,3S3,2474,51,2423,48.51
202412,54261000,CA,2,94,-92,0.02
202412,54261000,V2,16,154,-138,0.1
202412,54261000,V3,7,1,6,7
202412,54261000,V4,66,0,66,NA
202412,54261003,2,1,7,-6,0.14
202412,54261003,2S2,1,0,1,NA
202412,54261003,3S2,0,1,-1,0
202412,54261003,3S3,2,0,2,NA
202412,54261005,2,0,1,-1,0
202412,54261007,2,0,2,-2,0
202412,54261007,2S2,2,1,1,2
202412,54261007,3S2,2,1,1,2
202412,54261007,3S3,1,6,-5,0.17
202412,54261007,CA,0,24,-24,0
202412,54313000,2,0,8,-8,0
202412,54313000,3S3,0,1,-1,0
202412,54344001,3S3,6,0,6,NA
202412,54347000,2,6,2,4,3
202412,54347000,V2,24,0,24,NA
202412,54377000,2,1,6,-5,0.17
202412,54377000,CA,0,30,-30,0
202412,54385000,2,39,21,18,1.86
202412,54385000,2S3,1,1,0,1
202412,54385000,3,0,5,-5,0
202412,54385000,3S3,29,5,24,5.8
202412,54385000,CA,0,18,-18,0
202412,54398000,2,1,7,-6,0.14
202412,54405000,2,641,404,237,1.59
202412,54405000,2S2,3,6,-3,0.5
202412,54405000,2S3,0,3,-3,0
202412,54405000,3,88,22,66,4
202412,54405000,3R3,0,4,-4,0
202412,54405000,3S2,3,8,-5,0.38
202412,54405000,3S3,199,864,-665,0.23
202412,54405000,4,0,1,-1,0
202412,54405000,CA,10,144,-134,0.07
202412,54405000,V2,135,26,109,5.19
202412,54405000,V3,0,48,-48,0
202412,54405001,3S2,2,2,0,1
202412,54405003,2,16,0,16,NA
202412,54405003,2S2,1,0,1,NA
202412,54405003,3,1,1,0,1
202412,54405003,3S3,1,0,1,NA
202412,54405004,2,2,0,2,NA
202412,54405004,3,2,0,2,NA
202412,54405004,3S2,0,2,-2,0
202412,54418000,2,0,3,-3,0
202412,54480000,2,3,8,-5,0.38
202412,54480001,2,0,4,-4,0
202412,54498000,2,241,2826,-2585,0.09
202412,54498000,2R2,0,2,-2,0
202412,54498000,2S2,0,6,-6,0
202412,54498000,2S3,3,3,0,1
202412,54498000,3,8,85,-77,0.09
202412,54498000,3S2,1,12,-11,0.08
202412,54498000,3S2S3,0,1,-1,0
202412,54498000,3S3,38,333,-295,0.11
202412,54498000,3S4,0,2,-2,0
202412,54498000,CA,17,124,-107,0.14
202412,54498000,V2,0,1,-1,0
202412,54498000,V3,0,13,-13,0
202412,54498001,2,0,5,-5,0
202412,54498002,2,2,4,-2,0.5
202412,54498003,3S3,0,2,-2,0
202412,54498009,2,0,2,-2,0
202412,54498011,2,0,3,-3,0
202412,54498021,CA,0,1,-1,0
202412,54518000,2,28,536,-508,0.05
202412,54518000,2S2,2,1,1,2
202412,54518000,2S3,2,0,2,NA
202412,54518000,3,1,14,-13,0.07
202412,54518000,3S2,2,0,2,NA
202412,54518000,3S3,427,52,375,8.21
202412,54518000,CA,4,72,-68,0.06
202412,54518000,V2,0,14,-14,0
202412,54520000,2,6,12,-6,0.5
202412,54520000,3S2,1,0,1,NA
202412,54520000,3S3,2,0,2,NA
202412,54520000,CA,0,1,-1,0
202412,54520000,V2,53,0,53,NA
202412,54520000,V3,20,0,20,NA
202412,54520000,V4,6,0,6,NA
202412,54520001,2,2,2,0,1
202412,54520001,2S2,2,0,2,NA
202412,54520001,3S2,1,0,1,NA
202412,54520001,3S3,0,3,-3,0
202412,54553000,2,3,168,-165,0.02
202412,54553000,3,0,1,-1,0
202412,54553000,3S3,39,20,19,1.95
202412,54553000,CA,1,38,-37,0.03
202412,54599000,2,1,5,-4,0.2
202412,54660000,2,10,12,-2,0.83
202412,54660000,2S2,2,0,2,NA
202412,54660000,3S3,1,0,1,NA
202412,54660000,CA,0,29,-29,0
202412,54660000,V2,17,0,17,NA
202412,54670000,2,0,1,-1,0
202412,54670000,CA,0,1,-1,0
202412,54673000,2,4,39,-35,0.1
202412,54673000,2S2,10,9,1,1.11
202412,54673000,3,0,7,-7,0
202412,54673000,3S2,1,1,0,1
202412,54673000,3S3,355,7,348,50.71
202412,54673000,CA,0,25,-25,0
202412,54673000,V2,34,251,-217,0.14
202412,54673000,V3,0,95,-95,0
202412,54673000,V4,27,7,20,3.86
202412,54673002,2,0,1,-1,0
202412,54673005,2,0,2,-2,0
202412,54673005,3,0,1,-1,0
202412,54673005,3S2,0,1,-1,0
202412,54673005,3S3,10,0,10,NA
202412,54673005,V2,0,41,-41,0
202412,54680000,2,1,0,1,NA
202412,54680000,3S3,1,0,1,NA
202412,54680000,CA,0,24,-24,0
202412,54680000,V2,0,23,-23,0
202412,54720000,2,8,77,-69,0.1
202412,54720000,2S2,2,2,0,1
202412,54720000,2S3,14,0,14,NA
202412,54720000,3,0,5,-5,0
202412,54720000,3S2,6,5,1,1.2
202412,54720000,3S3,4055,32,4023,126.72
202412,54720000,4,3,1,2,3
202412,54720000,CA,0,5,-5,0
202412,54720000,V2,52,0,52,NA
202412,54720000,V3,4,0,4,NA
202412,54720000,V4,267,0,267,NA
202412,54720002,2,0,6,-6,0
202412,54720024,2,0,3,-3,0
202412,54720024,3,0,3,-3,0
202412,54720024,3S3,0,1,-1,0
202412,54743000,2,1,11,-10,0.09
202412,54743000,CA,0,6,-6,0
202412,54743001,2,0,1,-1,0
202412,54800000,2,0,3,-3,0
202412,54800019,2,0,4,-4,0
202412,54810000,2,9,155,-146,0.06
202412,54810000,2S3,1,0,1,NA
202412,54810000,3,1,16,-15,0.06
202412,54810000,3S2,4,4,0,1
202412,54810000,3S3,250,107,143,2.34
202412,54810000,4,0,2,-2,0
202412,54810000,CA,0,33,-33,0
202412,54810000,V3,0,1,-1,0
202412,54810002,2,0,1,-1,0
202412,54810002,3S3,0,1,-1,0
202412,54810003,2,0,1,-1,0
202412,54810017,2,0,1,-1,0
202412,54810017,2S2,0,2,-2,0
202412,54810017,3S2,8,1,7,8
202412,54810017,3S3,94,2,92,47
202412,54810017,CA,0,24,-24,0
202412,54820000,2,3,47,-44,0.06
202412,54820000,3S2,1,2,-1,0.5
202412,54820000,3S3,164,1,163,164
202412,54820000,CA,2,27,-25,0.07
202412,54820006,2,0,2,-2,0
202412,54820015,2,5,1,4,5
202412,54820015,3S3,0,1,-1,0
202412,54871000,2,0,2,-2,0
202412,54874000,2,158,290,-132,0.54
202412,54874000,2S2,1,3,-2,0.33
202412,54874000,2S3,0,2,-2,0
202412,54874000,3,3,10,-7,0.3
202412,54874000,3S2,6,22,-16,0.27
202412,54874000,3S3,16,632,-616,0.03
202412,54874000,4,0,1,-1,0
202412,54874000,CA,6,264,-258,0.02
202412,54874000,V2,0,24,-24,0
202412,54874001,3,0,1,-1,0
202412,54874001,3S2,1,1,0,1
202412,54874005,2,10,0,10,NA
202412,54874005,2S2,0,2,-2,0
202412,54874005,3,1,0,1,NA
202412,54874005,3S3,1,0,1,NA
202412,54874007,3S3,14,0,14,NA
202412,63001000,2,1958,5460,-3502,0.36
202412,63001000,2R2,2,30,-28,0.07
202412,63001000,2S2,15,186,-171,0.08
202412,63001000,2S3,10,54,-44,0.19
202412,63001000,3,113,273,-160,0.41
202412,63001000,3S1,0,1,-1,0
202412,63001000,3S2,39,96,-57,0.41
202412,63001000,3S3,504,1221,-717,0.41
202412,63001000,3S4,1,0,1,NA
202412,63001000,4,16,6,10,2.67
202412,63001000,CA,441,1538,-1097,0.29
202412,63001000,V2R2,2,0,2,NA
202412,63001000,V3,0,5,-5,0
202412,63001001,2,23,2,21,11.5
202412,63001001,3S3,8,0,8,NA
202412,63001001,V2R2,0,1,-1,0
202412,63111000,2,45,19,26,2.37
202412,63111000,3,1,3,-2,0.33
202412,63111000,CA,0,1,-1,0
202412,63130000,2,108,686,-578,0.16
202412,63130000,2R2,0,1,-1,0
202412,63130000,2S2,1,4,-3,0.25
202412,63130000,2S3,1,1,0,1
202412,63130000,3,2,80,-78,0.03
202412,63130000,3S2,141,128,13,1.1
202412,63130000,3S3,79,313,-234,0.25
202412,63130000,CA,8,168,-160,0.05
202412,63130000,V2R2,2,1,1,2
202412,63130000,V3,0,1,-1,0
202412,63130001,2,4,11,-7,0.36
202412,63130001,CA,0,2,-2,0
202412,63130004,CA,0,2,-2,0
202412,63190000,2,98,244,-146,0.4
202412,63190000,2S2,1,3,-2,0.33
202412,63190000,2S3,0,1,-1,0
202412,63190000,3,1,63,-62,0.02
202412,63190000,3S3,0,4,-4,0
202412,63190000,CA,6,53,-47,0.11
202412,63212000,2,2,15,-13,0.13
202412,63212000,CA,0,3,-3,0
202412,63272000,2,3,111,-108,0.03
202412,63272000,3,1,0,1,NA
202412,63272000,3S3,0,14,-14,0
202412,63272000,CA,0,47,-47,0
202412,63272000,V2,0,4,-4,0
202412,63302000,2,12,17,-5,0.71
202412,63302000,CA,1,52,-51,0.02
202412,63401000,2,1137,844,293,1.35
202412,63401000,2R2,98,5,93,19.6
202412,63401000,2S2,54,35,19,1.54
202412,63401000,2S3,20,25,-5,0.8
202412,63401000,3,8,6,2,1.33
202412,63401000,3S2,253,75,178,3.37
202412,63401000,3S3,172,175,-3,0.98
202412,63401000,CA,24,228,-204,0.11
202412,63401001,2S2,0,4,-4,0
202412,63401001,2S3,1,2,-1,0.5
202412,63401001,3S2,4,3,1,1.33
202412,63401001,3S3,3,7,-4,0.43
202412,63470000,2,79,258,-179,0.31
202412,63470000,3,0,11,-11,0
202412,63470000,3S2,0,8,-8,0
202412,63470000,3S3,0,24,-24,0
202412,63470000,CA,1,123,-122,0.01
202412,63470003,2,5,21,-16,0.24
202412,63470003,3,0,1,-1,0
202412,63470003,3S3,0,1,-1,0
202412,63548000,2,29,32,-3,0.91
202412,63548000,3,0,5,-5,0
202412,63548000,CA,0,12,-12,0
202412,63594000,2,307,323,-16,0.95
202412,63594000,2S2,1,1,0,1
202412,63594000,2S3,0,1,-1,0
202412,63594000,3,1,95,-94,0.01
202412,63594000,3S3,7,14,-7,0.5
202412,63594000,CA,1,186,-185,0.01
202412,63594000,V2,0,2,-2,0
202412,63690000,2,13,88,-75,0.15
202412,63690000,CA,0,45,-45,0
202412,66001000,2,13711,10576,3135,1.3
202412,66001000,2B2,1,0,1,NA
202412,66001000,2R2,201,8,193,25.12
202412,66001000,2S2,1163,1451,-288,0.8
202412,66001000,2S3,182,427,-245,0.43
202412,66001000,3,552,195,357,2.83
202412,66001000,3S2,593,1029,-436,0.58
202412,66001000,3S3,1527,3450,-1923,0.44
202412,66001000,3S4,4,5,-1,0.8
202412,66001000,4,4,7,-3,0.57
202412,66001000,CA,2956,3181,-225,0.93
202412,66001000,V2R2,1,1,0,1
202412,66001002,2,1,0,1,NA
202412,66001003,2,0,1,-1,0
202412,66001004,2,0,1,-1,0
202412,66001005,2,69,20,49,3.45
202412,66001005,3,0,56,-56,0
202412,66001005,3S3,0,1,-1,0
202412,66001015,2,0,3,-3,0
202412,66001018,2,2,1,1,2
202412,66001018,2S2,13,0,13,NA
202412,66001018,3S3,0,7,-7,0
202412,66001060,2,0,1,-1,0
202412,66001072,2,33,4,29,8.25
202412,66001072,3,0,8,-8,0
202412,66001073,2,0,1,-1,0
202412,66001080,2,2,554,-552,0
202412,66001080,3,4,0,4,NA
202412,66001080,3S2,72,0,72,NA
202412,66045000,2,18,115,-97,0.16
202412,66045000,3S2,1,0,1,NA
202412,66045000,3S3,6,16,-10,0.38
202412,66045000,CA,1,40,-39,0.03
202412,66045001,2,0,1,-1,0
202412,66045001,2S2,1,0,1,NA
202412,66075000,2,16,25,-9,0.64
202412,66075000,2S2,0,1,-1,0
202412,66075000,3S3,373,108,265,3.45
202412,66075000,CA,0,3,-3,0
202412,66075006,CA,0,13,-13,0
202412,66088000,2,33,156,-123,0.21
202412,66088000,3,0,1,-1,0
202412,66088000,3S3,0,12,-12,0
202412,66088000,CA,1,96,-95,0.01
202412,66170000,2,9377,4028,5349,2.33
202412,66170000,2B2,2,0,2,NA
202412,66170000,2R2,15,5,10,3
202412,66170000,2S1,0,3,-3,0
202412,66170000,2S2,259,236,23,1.1
202412,66170000,2S3,159,130,29,1.22
202412,66170000,3,105,318,-213,0.33
202412,66170000,3S2,567,676,-109,0.84
202412,66170000,3S3,1096,1356,-260,0.81
202412,66170000,3S4,2,2,0,1
202412,66170000,4,3,2,1,1.5
202412,66170000,CA,6317,631,5686,10.01
202412,66170006,CA,0,1,-1,0
202412,66170008,2,1,6,-5,0.17
202412,66170008,3S3,0,1,-1,0
202412,66170021,2,0,1,-1,0
202412,66318000,2,51,153,-102,0.33
202412,66318000,3,0,1,-1,0
202412,66318000,3S2,26,8,18,3.25
202412,66318000,3S3,75,23,52,3.26
202412,66318000,CA,0,24,-24,0
202412,66318002,2,0,3,-3,0
202412,66318002,3S2,2,0,2,NA
202412,66318002,3S3,2,0,2,NA
202412,66318003,CA,1,0,1,NA
202412,66383000,2,4,32,-28,0.12
202412,66383000,3,0,1,-1,0
202412,66383000,CA,0,17,-17,0
202412,66400000,2,682,441,241,1.55
202412,66400000,2S2,3,17,-14,0.18
202412,66400000,2S3,2,19,-17,0.11
202412,66400000,3,11,16,-5,0.69
202412,66400000,3S2,12,31,-19,0.39
202412,66400000,3S3,103,128,-25,0.8
202412,66400000,3S4,1,0,1,NA
202412,66400000,CA,8,116,-108,0.07
202412,66400001,3S3,0,1,-1,0
202412,66440000,2,35,90,-55,0.39
202412,66440000,3,2,0,2,NA
202412,66440000,CA,0,65,-65,0
202412,66440009,2S2,0,2,-2,0
202412,66440009,3S3,0,2,-2,0
202412,66456000,2,8,79,-71,0.1
202412,66456000,3,0,2,-2,0
202412,66456000,CA,0,110,-110,0
202412,66572000,2,5,43,-38,0.12
202412,66572000,3,0,9,-9,0
202412,66572000,3S2,0,1,-1,0
202412,66572000,3S3,1,1,0,1
202412,66572000,CA,0,149,-149,0
202412,66572001,2,1,13,-12,0.08
202412,66572001,3,1,0,1,NA
202412,66572001,CA,0,2,-2,0
202412,66594000,2,72,115,-43,0.63
202412,66594000,3,1,2,-1,0.5
202412,66594000,CA,3,50,-47,0.06
202412,66594002,2,4,5,-1,0.8
202412,66594002,3,0,1,-1,0
202412,66594002,3S2,0,1,-1,0
202412,66594002,3S3,1,36,-35,0.03
202412,66594002,3S4,1,0,1,NA
202412,66682000,2,132,721,-589,0.18
202412,66682000,2R2,0,7,-7,0
202412,66682000,2S2,20,14,6,1.43
202412,66682000,2S3,3,1,2,3
202412,66682000,3,4,16,-12,0.25
202412,66682000,3S2,2,5,-3,0.4
202412,66682000,3S3,56,33,23,1.7
202412,66682000,CA,6,304,-298,0.02
202412,66687000,2,14,88,-74,0.16
202412,66687000,3,0,11,-11,0
202412,66687000,3S3,0,6,-6,0
202412,66687000,CA,0,22,-22,0
202412,66687002,3S3,0,1,-1,0
202412,68001000,2,13034,13747,-713,0.95
202412,68001000,2B1,0,11,-11,0
202412,68001000,2B2,1,0,1,NA
202412,68001000,2R2,3,60,-57,0.05
202412,68001000,2R3,0,28,-28,0
202412,68001000,2S1,2,1,1,2
202412,68001000,2S2,191,785,-594,0.24
202412,68001000,2S3,154,345,-191,0.45
202412,68001000,3,1413,405,1008,3.49
202412,68001000,3S1,0,6,-6,0
202412,68001000,3S2,670,1049,-379,0.64
202412,68001000,3S3,3107,5691,-2584,0.55
202412,68001000,3S3S2,0,1,-1,0
202412,68001000,3S4,2,0,2,NA
202412,68001000,4,4,6,-2,0.67
202412,68001000,CA,1891,4751,-2860,0.4
202412,68001000,V2,0,439,-439,0
202412,68001000,V3,4,1,3,4
202412,68001005,2,1,0,1,NA
202412,68001005,3S3,29,4,25,7.25
202412,68001006,2,5,0,5,NA
202412,68001006,3,0,3,-3,0
202412,68001006,3S3,1,27,-26,0.04
202412,68001010,2,30,8,22,3.75
202412,68001010,3,1,0,1,NA
202412,68001010,3S3,6,11,-5,0.55
202412,68001011,2,0,1,-1,0
202412,68051000,2,59,216,-157,0.27
202412,68051000,3,1,44,-43,0.02
202412,68051000,3S3,8,0,8,NA
202412,68051000,CA,1,9,-8,0.11
202412,68051000,V2,0,2,-2,0
202412,68051000,V3,0,7,-7,0
202412,68077000,2,87,642,-555,0.14
202412,68077000,2S2,0,18,-18,0
202412,68077000,2S3,0,2,-2,0
202412,68077000,3,6,22,-16,0.27
202412,68077000,3S2,2,15,-13,0.13
202412,68077000,3S3,3,187,-184,0.02
202412,68077000,3S4,2,0,2,NA
202412,68077000,4,0,1,-1,0
202412,68077000,CA,2,74,-72,0.03
202412,68077000,V2,0,16,-16,0
202412,68079000,2,5,40,-35,0.12
202412,68079000,CA,0,21,-21,0
202412,68081000,2,1596,3063,-1467,0.52
202412,68081000,2R2,0,65,-65,0
202412,68081000,2R3,0,1,-1,0
202412,68081000,2S1,2,0,2,NA
202412,68081000,2S2,48,116,-68,0.41
202412,68081000,2S3,82,83,-1,0.99
202412,68081000,3,204,560,-356,0.36
202412,68081000,3R3,0,1,-1,0
202412,68081000,3S1,4,6,-2,0.67
202412,68081000,3S2,373,534,-161,0.7
202412,68081000,3S3,5219,3628,1591,1.44
202412,68081000,3S3S2,4,8,-4,0.5
202412,68081000,3S4,2,1,1,2
202412,68081000,4,0,11,-11,0
202412,68081000,CA,225,740,-515,0.3
202412,68081000,V2,56,32,24,1.75
202412,68081000,V3,134,141,-7,0.95
202412,68081000,V4,0,1,-1,0
202412,68081001,2,0,5,-5,0
202412,68081001,3S2,0,2,-2,0
202412,68081001,3S3,8,13,-5,0.62
202412,68081001,3S4,2,0,2,NA
202412,68081001,CA,0,2,-2,0
202412,68081002,2,0,4,-4,0
202412,68081002,3S3,0,4,-4,0
202412,68081002,3S3S2,0,1,-1,0
202412,68081003,2,4,7,-3,0.57
202412,68081003,2S2,0,1,-1,0
202412,68081003,3S2,2,2,0,1
202412,68081003,3S3,121,44,77,2.75
202412,68081003,CA,0,1,-1,0
202412,68081010,2,1,2,-1,0.5
202412,68081010,2S2,0,2,-2,0
202412,68081010,3,1,1,0,1
202412,68081010,3S2,15,2,13,7.5
202412,68081010,3S3,298,22,276,13.55
202412,68092000,2,143,18,125,7.94
202412,68092000,2S2,0,1,-1,0
202412,68092000,2S3,1,3,-2,0.33
202412,68092000,3,23,37,-14,0.62
202412,68092000,3S2,25,34,-9,0.74
202412,68092000,3S3,709,454,255,1.56
202412,68092000,CA,0,12,-12,0
202412,68092000,V2,1,3,-2,0.33
202412,68092000,V3,3,8,-5,0.38
202412,68092003,3S2,1,0,1,NA
202412,68092003,3S3,15,55,-40,0.27
202412,68101000,2,0,16,-16,0
202412,68101000,CA,0,9,-9,0
202412,68101010,2,16,18,-2,0.89
202412,68101010,2S2,0,1,-1,0
202412,68121000,CA,0,1,-1,0
202412,68132000,2,0,2,-2,0
202412,68132000,CA,0,5,-5,0
202412,68147000,2,18,46,-28,0.39
202412,68147000,3S3,13,1,12,13
202412,68147000,CA,0,3,-3,0
202412,68152000,2,0,1,-1,0
202412,68162000,2,0,8,-8,0
202412,68162000,3,1,2,-1,0.5
202412,68162000,3S2,12,0,12,NA
202412,68162000,3S3,10,9,1,1.11
202412,68162000,CA,16,17,-1,0.94
202412,68167000,2,1,94,-93,0.01
202412,68167000,CA,0,11,-11,0
202412,68169000,2,0,1,-1,0
202412,68176000,2,0,4,-4,0
202412,68179000,2,0,1,-1,0
202412,68179000,V2,0,1,-1,0
202412,68190000,2,61,213,-152,0.29
202412,68190000,2S2,5,0,5,NA
202412,68190000,2S3,5,0,5,NA
202412,68190000,3,19,22,-3,0.86
202412,68190000,3S2,404,24,380,16.83
202412,68190000,3S3,2813,448,2365,6.28
202412,68190000,3S4,2,0,2,NA
202412,68190000,CA,2,57,-55,0.04
202412,68190000,V2,1,0,1,NA
202412,68190000,V3,12,10,2,1.2
202412,68190002,2,6,9,-3,0.67
202412,68190002,3,0,1,-1,0
202412,68190002,3S3,30,21,9,1.43
202412,68190002,CA,1,1,0,1
202412,68190003,2,62,1,61,62
202412,68190003,2S3,1,0,1,NA
202412,68190003,3,8,0,8,NA
202412,68190003,3S2,1,0,1,NA
202412,68190003,3S3,123,11,112,11.18
202412,68190003,CA,0,1,-1,0
202412,68207000,2,0,3,-3,0
202412,68207000,3S3,0,2,-2,0
202412,68209000,2,20,16,4,1.25
202412,68209000,3S3,0,2,-2,0
202412,68209001,2,0,1,-1,0
202412,68211000,2,2,17,-15,0.12
202412,68211000,CA,0,2,-2,0
202412,68217000,2,0,1,-1,0
202412,68229000,2,24,55,-31,0.44
202412,68229000,2R2,5,0,5,NA
202412,68229000,3,0,1,-1,0
202412,68229000,3S2,1,0,1,NA
202412,68229000,3S3,163,1,162,163
202412,68229000,CA,1,9,-8,0.11
202412,68235000,2,2,35,-33,0.06
202412,68235000,3,0,6,-6,0
202412,68235000,3S3,6,1,5,6
202412,68235000,CA,0,14,-14,0
202412,68235000,V3,0,13,-13,0
202412,68235007,2,0,2,-2,0
202412,68245000,2,0,2,-2,0
202412,68245003,2,0,1,-1,0
202412,68250000,2,0,7,-7,0
202412,68250000,V2,0,1,-1,0
202412,68255000,2,13,132,-119,0.1
202412,68255000,3,0,29,-29,0
202412,68255000,3S2,0,4,-4,0
202412,68255000,3S3,0,9,-9,0
202412,68255000,3S4,0,1,-1,0
202412,68255000,CA,16,44,-28,0.36
202412,68255000,V2,0,3,-3,0
202412,68255000,V3,0,13,-13,0
202412,68264000,2,0,3,-3,0
202412,68264000,CA,0,1,-1,0
202412,68266000,2,0,9,-9,0
202412,68271000,2,0,7,-7,0
202412,68271000,2S3,0,2,-2,0
202412,68271000,3S3,0,1,-1,0
202412,68271000,CA,0,5,-5,0
202412,68276000,2,2498,5383,-2885,0.46
202412,68276000,2R2,3,10,-7,0.3
202412,68276000,2R3,0,1,-1,0
202412,68276000,2S1,2,4,-2,0.5
202412,68276000,2S2,4,37,-33,0.11
202412,68276000,2S3,2,3,-1,0.67
202412,68276000,3,145,91,54,1.59
202412,68276000,3S2,264,53,211,4.98
202412,68276000,3S3,73,126,-53,0.58
202412,68276000,4,0,1,-1,0
202412,68276000,CA,1185,1102,83,1.08
202412,68276000,V2,385,1,384,385
202412,68276013,2,1,1,0,1
202412,68276013,CA,0,4,-4,0
202412,68296000,2,0,3,-3,0
202412,68298000,2,1,8,-7,0.12
202412,68298000,CA,0,1,-1,0
202412,68298000,V2,0,2,-2,0
202412,68307000,2,12127,4393,7734,2.76
202412,68307000,2B1,0,8,-8,0
202412,68307000,2R2,1,5,-4,0.2
202412,68307000,2R3,0,3,-3,0
202412,68307000,2S1,0,4,-4,0
202412,68307000,2S2,78,130,-52,0.6
202412,68307000,2S3,16,31,-15,0.52
202412,68307000,3,873,307,566,2.84
202412,68307000,3S1,6,0,6,NA
202412,68307000,3S2,961,810,151,1.19
202412,68307000,3S3,986,4290,-3304,0.23
202412,68307000,4,28,0,28,NA
202412,68307000,CA,4370,761,3609,5.74
202412,68307000,V2,46,14,32,3.29
202412,68307000,V3,38,15,23,2.53
202412,68307012,2,0,1,-1,0
202412,68307018,3S2,5,0,5,NA
202412,68307018,3S3,1,0,1,NA
202412,68318000,2,0,11,-11,0
202412,68318000,3,0,5,-5,0
202412,68318000,CA,0,5,-5,0
202412,68318001,CA,0,2,-2,0
202412,68320000,2,2,8,-6,0.25
202412,68320000,3S3,0,5,-5,0
202412,68322000,2,0,3,-3,0
202412,68322000,V2,0,1,-1,0
202412,68324000,2,1,4,-3,0.25
202412,68324000,V2,0,1,-1,0
202412,68327000,2,2,8,-6,0.25
202412,68327000,3S2,2,2,0,1
202412,68327000,3S3,0,1,-1,0
202412,68327000,V2,0,4,-4,0
202412,68344000,2,0,5,-5,0
202412,68344000,V2,0,3,-3,0
202412,68368000,2,10,8,2,1.25
202412,68370000,2,0,1,-1,0
202412,68377000,2,1,8,-7,0.12
202412,68377000,3,0,1,-1,0
202412,68377000,CA,1,3,-2,0.33
202412,68385000,2,17,56,-39,0.3
202412,68385000,3,49,5,44,9.8
202412,68385000,3S2,3,2,1,1.5
202412,68385000,3S3,274,1,273,274
202412,68385000,3S4,0,1,-1,0
202412,68385000,CA,48,71,-23,0.68
202412,68385000,V2,106,0,106,NA
202412,68385000,V3,201,0,201,NA
202412,68385000,V4,38,0,38,NA
202412,68385012,2,0,1,-1,0
202412,68397000,2,0,2,-2,0
202412,68406000,2,1407,1931,-524,0.73
202412,68406000,2B1,0,2,-2,0
202412,68406000,2R3,0,1,-1,0
202412,68406000,2S2,2,56,-54,0.04
202412,68406000,2S3,1,2,-1,0.5
202412,68406000,3,114,119,-5,0.96
202412,68406000,3S2,89,41,48,2.17
202412,68406000,3S3,22,281,-259,0.08
202412,68406000,4,0,1,-1,0
202412,68406000,CA,671,294,377,2.28
202412,68406000,V2,17,6,11,2.83
202412,68406008,2,0,2,-2,0
202412,68406008,V2,0,3,-3,0
202412,68406009,3,0,1,-1,0
202412,68406013,3,0,1,-1,0
202412,68418000,2,926,1308,-382,0.71
202412,68418000,2S1,2,0,2,NA
202412,68418000,2S3,0,2,-2,0
202412,68418000,3,2,414,-412,0
202412,68418000,3S2,0,172,-172,0
202412,68418000,3S3,0,32,-32,0
202412,68418000,CA,2,33,-31,0.06
202412,68418000,V2,0,16,-16,0
202412,68418000,V3,0,11,-11,0
202412,68418003,CA,1,0,1,NA
202412,68425000,2,0,1,-1,0
202412,68432000,2,14,181,-167,0.08
202412,68432000,2S2,0,2,-2,0
202412,68432000,2S3,0,1,-1,0
202412,68432000,3,0,5,-5,0
202412,68432000,3S2,25,0,25,NA
202412,68432000,3S3,32,21,11,1.52
202412,68432000,4,0,1,-1,0
202412,68432000,CA,11,27,-16,0.41
202412,68444000,2,0,6,-6,0
202412,68444000,3,0,1,-1,0
202412,68444000,3S2,0,1,-1,0
202412,68444000,CA,0,8,-8,0
202412,68464000,2,17,123,-106,0.14
202412,68464000,3,4,1,3,4
202412,68464000,CA,0,3,-3,0
202412,68468000,2,0,1,-1,0
202412,68498000,2,2,7,-5,0.29
202412,68498000,CA,0,1,-1,0
202412,68498000,V2,0,4,-4,0
202412,68500000,2,20,170,-150,0.12
202412,68500000,2S3,1,1,0,1
202412,68500000,3,1,6,-5,0.17
202412,68500000,3S3,1,11,-10,0.09
202412,68500000,CA,2,15,-13,0.13
202412,68500000,V2,0,17,-17,0
202412,68502000,2,1,13,-12,0.08
202412,68502000,3,0,1,-1,0
202412,68502000,CA,0,5,-5,0
202412,68522000,2,0,2,-2,0
202412,68522000,3S3,1,0,1,NA
202412,68524000,2,0,8,-8,0
202412,68524000,CA,25,35,-10,0.71
202412,68533000,2,1,84,-83,0.01
202412,68547000,2,1487,2225,-738,0.67
202412,68547000,2B2,0,1,-1,0
202412,68547000,2R3,0,1,-1,0
202412,68547000,2S2,10,35,-25,0.29
202412,68547000,2S3,4,4,0,1
202412,68547000,3,199,195,4,1.02
202412,68547000,3S2,40,10,30,4
202412,68547000,3S3,1013,443,570,2.29
202412,68547000,CA,264,666,-402,0.4
202412,68547000,V2,0,6,-6,0
202412,68547008,2,1,0,1,NA
202412,68547008,3,1,0,1,NA
202412,68547008,3S2,1,0,1,NA
202412,68547008,3S3,2,0,2,NA
202412,68547011,2,1,0,1,NA
202412,68547011,3S3,227,0,227,NA
202412,68549000,2,0,112,-112,0
202412,68549000,3,0,16,-16,0
202412,68549000,3S3,17,83,-66,0.2
202412,68549000,CA,0,5,-5,0
202412,68549000,V2,0,3,-3,0
202412,68572000,2,2,110,-108,0.02
202412,68572000,3,0,2,-2,0
202412,68572000,3S2,1,2,-1,0.5
202412,68572000,3S3,113,107,6,1.06
202412,68572000,CA,0,15,-15,0
202412,68573000,2,4,35,-31,0.11
202412,68573000,3,0,17,-17,0
202412,68573000,3S2,3,1,2,3
202412,68573000,3S3,83,12,71,6.92
202412,68573000,3S3S2,5,1,4,5
202412,68573000,CA,0,7,-7,0
202412,68573000,V2,0,7,-7,0
202412,68573000,V3,3,5,-2,0.6
202412,68573002,2,0,1,-1,0
202412,68573002,CA,0,1,-1,0
202412,68575000,2,17,135,-118,0.13
202412,68575000,2S2,0,2,-2,0
202412,68575000,2S3,0,2,-2,0
202412,68575000,3,4,7,-3,0.57
202412,68575000,3S2,29,4,25,7.25
202412,68575000,3S3,244,79,165,3.09
202412,68575000,3S4,0,2,-2,0
202412,68575000,4,0,1,-1,0
202412,68575000,CA,1,41,-40,0.02
202412,68575000,V2,21,0,21,NA
202412,68575000,V3,32,19,13,1.68
202412,68575000,V3R3,2,0,2,NA
202412,68575001,2,0,3,-3,0
202412,68575002,3S3,0,1,-1,0
202412,68575003,2,0,1,-1,0
202412,68575007,CA,0,1,-1,0
202412,68575015,2,0,2,-2,0
202412,68575015,3S2,0,1,-1,0
202412,68575015,CA,0,2,-2,0
202412,68575018,2,0,1,-1,0
202412,68575024,2,0,4,-4,0
202412,68575024,CA,0,6,-6,0
202412,68615000,2,218,890,-672,0.24
202412,68615000,2S2,1,1,0,1
202412,68615000,2S3,0,1,-1,0
202412,68615000,3,171,122,49,1.4
202412,68615000,3S2,97,36,61,2.69
202412,68615000,3S3,73,16,57,4.56
202412,68615000,CA,1,41,-40,0.02
202412,68615000,V2,0,12,-12,0
202412,68615013,3S2,1,0,1,NA
202412,68615013,3S3,18,0,18,NA
202412,68615013,CA,0,5,-5,0
202412,68615031,2,1,2,-1,0.5
202412,68615031,3,16,0,16,NA
202412,68655000,2,884,311,573,2.84
202412,68655000,2S1,0,1,-1,0
202412,68655000,2S2,1,2,-1,0.5
202412,68655000,2S3,2,2,0,1
202412,68655000,3,144,358,-214,0.4
202412,68655000,3S1,2,0,2,NA
202412,68655000,3S2,3,7,-4,0.43
202412,68655000,3S3,213,176,37,1.21
202412,68655000,3S3S2,4,0,4,NA
202412,68655000,4,1,15,-14,0.07
202412,68655000,CA,11,121,-110,0.09
202412,68655000,V2,11,1,10,11
202412,68655000,V3,47,7,40,6.71
202412,68655001,3S3,2,0,2,NA
202412,68669000,2,1,24,-23,0.04
202412,68669000,3,0,1,-1,0
202412,68669000,3S3,0,5,-5,0
202412,68669000,CA,1,0,1,NA
202412,68673000,2,0,4,-4,0
202412,68673000,CA,0,1,-1,0
202412,68673001,2,3,1,2,3
202412,68673001,CA,0,1,-1,0
202412,68673001,V2,0,2,-2,0
202412,68679000,2,128,1007,-879,0.13
202412,68679000,2B1,0,8,-8,0
202412,68679000,2S2,1,1,0,1
202412,68679000,2S3,5,7,-2,0.71
202412,68679000,3,1,38,-37,0.03
202412,68679000,3S2,3,13,-10,0.23
202412,68679000,3S3,237,404,-167,0.59
202412,68679000,CA,38,342,-304,0.11
202412,68679000,V2,0,2,-2,0
202412,68684000,2,0,3,-3,0
202412,68686000,2,0,6,-6,0
202412,68686000,CA,0,6,-6,0
202412,68689000,2,12,70,-58,0.17
202412,68689000,2S2,0,1,-1,0
202412,68689000,3,8,2,6,4
202412,68689000,3S2,2,3,-1,0.67
202412,68689000,3S3,19,6,13,3.17
202412,68689000,CA,1,70,-69,0.01
202412,68689000,V2,0,2,-2,0
202412,68689000,V3,0,17,-17,0
202412,68689001,3S3,0,9,-9,0
202412,68689012,2,3,5,-2,0.6
202412,68689012,3S2,2,0,2,NA
202412,68689012,3S3,0,1,-1,0
202412,68689012,CA,26,60,-34,0.43
202412,68689024,2,30,1,29,30
202412,68689024,3,11,0,11,NA
202412,68689024,3S2,1,0,1,NA
202412,68689024,3S3,172,3,169,57.33
202412,68705000,2,1,6,-5,0.17
202412,68720000,2,0,37,-37,0
202412,68720000,CA,0,8,-8,0
202412,68745000,2,6,13,-7,0.46
202412,68745000,3,0,77,-77,0
202412,68745000,3S2,7,0,7,NA
202412,68745000,3S3,108,6,102,18
202412,68745000,CA,0,1,-1,0
202412,68755000,2,105,469,-364,0.22
202412,68755000,2S2,0,2,-2,0
202412,68755000,2S3,2,0,2,NA
202412,68755000,3,2,10,-8,0.2
202412,68755000,3S2,0,2,-2,0
202412,68755000,3S3,29,79,-50,0.37
202412,68755000,CA,27,150,-123,0.18
202412,68755000,V2,87,0,87,NA
202412,68770000,2,5,21,-16,0.24
202412,68770000,3,0,11,-11,0
202412,68770000,3S2,0,2,-2,0
202412,68770000,3S3,0,4,-4,0
202412,68770000,CA,1,3,-2,0.33
202412,68770000,V2,0,3,-3,0
202412,68770001,2,0,2,-2,0
202412,68770001,3,0,2,-2,0
202412,68770003,2,0,4,-4,0
202412,68770003,CA,0,2,-2,0
202412,68773000,CA,0,1,-1,0
202412,68773003,CA,1,0,1,NA
202412,68820000,2,32,72,-40,0.44
202412,68820000,3,0,1,-1,0
202412,68820000,3S3,0,1,-1,0
202412,68820000,CA,0,7,-7,0
202412,68820001,2,2,16,-14,0.12
202412,68820001,CA,0,13,-13,0
202412,68855000,2,4,59,-55,0.07
202412,68855000,3S3,3,1,2,3
202412,68855000,CA,0,3,-3,0
202412,68855000,V2,0,7,-7,0
202412,68861000,2,8,205,-197,0.04
202412,68861000,3,2,7,-5,0.29
202412,68861000,3S2,0,2,-2,0
202412,68861000,3S3,6,48,-42,0.12
202412,68861000,3S4,1,0,1,NA
202412,68861000,CA,10,52,-42,0.19
202412,68861000,V2,0,6,-6,0
202412,68867000,2,0,4,-4,0
202412,68867000,CA,0,1,-1,0
202412,68872000,2,4,107,-103,0.04
202412,68872000,3,0,1,-1,0
202412,68872000,CA,1,0,1,NA
202412,68872000,V2,0,20,-20,0
202412,68895000,2,32,210,-178,0.15
202412,68895000,2S1,5,0,5,NA
202412,68895000,3,5,32,-27,0.16
202412,68895000,CA,21,35,-14,0.6
202412,70001000,2,1394,3473,-2079,0.4
202412,70001000,2B2,1,32,-31,0.03
202412,70001000,2R2,1,4,-3,0.25
202412,70001000,2R3,1,2,-1,0.5
202412,70001000,2S2,7,75,-68,0.09
202412,70001000,2S3,6,38,-32,0.16
202412,70001000,3,14,234,-220,0.06
202412,70001000,3S2,142,418,-276,0.34
202412,70001000,3S3,109,548,-439,0.2
202412,70001000,3S4,0,1,-1,0
202412,70001000,4,1,4,-3,0.25
202412,70001000,CA,338,484,-146,0.7
202412,70001001,2,1,6,-5,0.17
202412,70001002,2,0,2,-2,0
202412,70001003,2,2,3,-1,0.67
202412,70110000,2,0,26,-26,0
202412,70110000,2B2,0,1,-1,0
202412,70110000,3,0,3,-3,0
202412,70110000,3S2,1,0,1,NA
202412,70110000,3S3,0,6,-6,0
202412,70124000,2,1,38,-37,0.03
202412,70124000,2R2,2,2,0,1
202412,70124000,2S1,0,2,-2,0
202412,70124000,2S2,4,0,4,NA
202412,70124000,3S1,3,5,-2,0.6
202412,70124000,3S2,16,15,1,1.07
202412,70124000,3S3,5,20,-15,0.25
202412,70124000,4,3,3,0,1
202412,70124000,CA,0,1,-1,0
202412,70204000,2,3,9,-6,0.33
202412,70204000,3,0,1,-1,0
202412,70204000,3S2,1,0,1,NA
202412,70204000,3S3,0,1,-1,0
202412,70215000,2,359,355,4,1.01
202412,70215000,2B2,0,2,-2,0
202412,70215000,2R2,0,1,-1,0
202412,70215000,2R3,0,2,-2,0
202412,70215000,2S2,0,3,-3,0
202412,70215000,2S3,1,1,0,1
202412,70215000,3,13,19,-6,0.68
202412,70215000,3S2,17,9,8,1.89
202412,70215000,3S3,332,493,-161,0.67
202412,70215000,CA,51,104,-53,0.49
202412,70221000,2,37,235,-198,0.16
202412,70221000,2B2,0,14,-14,0
202412,70221000,2S2,0,7,-7,0
202412,70221000,3,2,9,-7,0.22
202412,70221000,3S2,1,0,1,NA
202412,70221000,3S3,3,8,-5,0.38
202412,70221000,3S4,1,1,0,1
202412,70221000,CA,13,42,-29,0.31
202412,70221005,CA,0,6,-6,0
202412,70230000,2,2,6,-4,0.33
202412,70230000,3S3,1,1,0,1
202412,70230000,CA,0,3,-3,0
202412,70233000,2,4,16,-12,0.25
202412,70233000,3,0,4,-4,0
202412,70233000,3S3,17,35,-18,0.49
202412,70233000,CA,1,2,-1,0.5
202412,70233004,2,0,1,-1,0
202412,70233013,2S2,0,2,-2,0
202412,70235000,2,26,107,-81,0.24
202412,70235000,3,0,1,-1,0
202412,70235000,CA,0,6,-6,0
202412,70235008,3S3,0,34,-34,0
202412,70235211,CA,0,1,-1,0
202412,70265000,2,0,86,-86,0
202412,70265000,2R3,0,1,-1,0
202412,70265000,2S3,0,1,-1,0
202412,70265000,3,1,32,-31,0.03
202412,70265000,3S2,1,0,1,NA
202412,70265000,3S3,0,3,-3,0
202412,70265000,3S4,2,0,2,NA
202412,70265000,CA,0,8,-8,0
202412,70400000,2,1,61,-60,0.02
202412,70400000,2S3,9,1,8,9
202412,70400000,3,1,11,-10,0.09
202412,70400000,3S2,2,13,-11,0.15
202412,70400000,3S3,11,72,-61,0.15
202412,70400000,3S4,3,13,-10,0.23
202412,70400000,4,1,0,1,NA
202412,70400000,CA,0,2,-2,0
202412,70400005,2,1,0,1,NA
202412,70418000,2,0,25,-25,0
202412,70418000,3,0,1,-1,0
202412,70418000,3S3,0,3,-3,0
202412,70418000,CA,11,9,2,1.22
202412,70418002,2,1,0,1,NA
202412,70429000,2,15,88,-73,0.17
202412,70429000,2R3,0,2,-2,0
202412,70429000,3,4,36,-32,0.11
202412,70429000,3S2,1,0,1,NA
202412,70429000,3S3,2,9,-7,0.22
202412,70429000,4,0,3,-3,0
202412,70429000,CA,0,9,-9,0
202412,70429015,2,0,1,-1,0
202412,70473000,2,1,13,-12,0.08
202412,70473000,3,0,1,-1,0
202412,70473000,3S2,0,4,-4,0
202412,70473000,3S3,0,1,-1,0
202412,70473000,4,0,1,-1,0
202412,70473000,CA,0,1,-1,0
202412,70473005,3S2,0,8,-8,0
202412,70473006,2,0,1,-1,0
202412,70508000,2,7,75,-68,0.09
202412,70508000,3,1,2,-1,0.5
202412,70508000,3S2,6,5,1,1.2
202412,70508000,3S3,2,4,-2,0.5
202412,70508000,CA,1,8,-7,0.12
202412,70523000,2,29,23,6,1.26
202412,70523000,3,0,13,-13,0
202412,70523000,3S2,0,10,-10,0
202412,70523000,3S3,0,1,-1,0
202412,70523000,CA,0,1,-1,0
202412,70670000,2,76,158,-82,0.48
202412,70670000,2B2,0,1,-1,0
202412,70670000,2R2,0,1,-1,0
202412,70670000,2S3,3,0,3,NA
202412,70670000,3,0,3,-3,0
202412,70670000,3S2,3,0,3,NA
202412,70670000,3S3,6,9,-3,0.67
202412,70670000,CA,20,40,-20,0.5
202412,70670012,2,1,0,1,NA
202412,70678000,2,5,26,-21,0.19
202412,70678000,3S3,1,0,1,NA
202412,70678000,CA,1,5,-4,0.2
202412,70678010,2,0,1,-1,0
202412,70702000,2,1,30,-29,0.03
202412,70702000,CA,0,5,-5,0
202412,70702004,2,0,2,-2,0
202412,70702004,2B2,0,1,-1,0
202412,70702004,3S3,0,1,-1,0
202412,70708000,2,52,289,-237,0.18
202412,70708000,2B2,0,4,-4,0
202412,70708000,2R2,5,4,1,1.25
202412,70708000,2S1,1,0,1,NA
202412,70708000,2S2,2,7,-5,0.29
202412,70708000,2S3,0,3,-3,0
202412,70708000,3,5,11,-6,0.45
202412,70708000,3S1,5,0,5,NA
202412,70708000,3S2,14,6,8,2.33
202412,70708000,3S3,44,83,-39,0.53
202412,70708000,3S4,4,2,2,2
202412,70708000,CA,13,59,-46,0.22
202412,70708000,V3,1,4,-3,0.25
202412,70708001,2,0,1,-1,0
202412,70708003,2,50,13,37,3.85
202412,70708006,2R2,1,0,1,NA
202412,70708008,2,0,2,-2,0
202412,70713000,2,102,196,-94,0.52
202412,70713000,2R2,1,1,0,1
202412,70713000,2R3,0,4,-4,0
202412,70713000,2S2,3,0,3,NA
202412,70713000,3,0,33,-33,0
202412,70713000,3S2,2,3,-1,0.67
202412,70713000,3S3,1,5,-4,0.2
202412,70713000,3S4,1,0,1,NA
202412,70713000,CA,2,30,-28,0.07
202412,70713007,2,0,1,-1,0
202412,70713007,3S2,0,6,-6,0
202412,70713007,3S3,0,2,-2,0
202412,70713007,CA,0,1,-1,0
202412,70713008,2,3,0,3,NA
202412,70717000,2,13,47,-34,0.28
202412,70717000,2S2,1,2,-1,0.5
202412,70717000,2S3,2,1,1,2
202412,70717000,3,11,5,6,2.2
202412,70717000,3S1,1,0,1,NA
202412,70717000,3S2,11,1,10,11
202412,70717000,3S3,26,23,3,1.13
202412,70717000,CA,2,7,-5,0.29
202412,70717002,2,0,1,-1,0
202412,70742000,2,7,77,-70,0.09
202412,70742000,3S2,1,1,0,1
202412,70742000,CA,1,31,-30,0.03
202412,70771000,2,0,15,-15,0
202412,70771000,2S3,1,0,1,NA
202412,70771000,3,0,4,-4,0
202412,70771000,3S2,0,1,-1,0
202412,70771000,3S3,0,4,-4,0
202412,70771000,CA,0,1,-1,0
202412,70771007,2,0,2,-2,0
202412,70771007,CA,0,1,-1,0
202412,70771013,2,7,13,-6,0.54
202412,70771013,3S2,4,0,4,NA
202412,70771013,CA,1,0,1,NA
202412,70771018,2,0,3,-3,0
202412,70771026,3S3,0,3,-3,0
202412,70820000,2,6,163,-157,0.04
202412,70820000,2S3,2,0,2,NA
202412,70820000,3,0,30,-30,0
202412,70820000,3S2,1,0,1,NA
202412,70820000,3S3,2535,2053,482,1.23
202412,70820000,3S4,1,0,1,NA
202412,70820000,CA,4,41,-37,0.1
202412,70820001,2,0,4,-4,0
202412,70820001,3S3,0,2,-2,0
202412,70820001,CA,0,1,-1,0
202412,70820008,3S2,0,72,-72,0
202412,70820008,3S3,0,390,-390,0
202412,70820012,2,0,1,-1,0
202412,70823000,2,923,78,845,11.83
202412,70823000,2B2,0,14,-14,0
202412,70823000,2S1,1,0,1,NA
202412,70823000,2S2,4,1,3,4
202412,70823000,2S3,7,6,1,1.17
202412,70823000,3,505,19,486,26.58
202412,70823000,3S1,3,0,3,NA
202412,70823000,3S2,317,116,201,2.73
202412,70823000,3S3,634,545,89,1.16
202412,70823000,3S4,0,2,-2,0
202412,70823000,CA,2,29,-27,0.07
202412,70823004,2,1,0,1,NA
202412,73001000,2,4227,7152,-2925,0.59
202412,73001000,2B1,6,1,5,6
202412,73001000,2R2,28,95,-67,0.29
202412,73001000,2R3,0,15,-15,0
202412,73001000,2S1,0,5,-5,0
202412,73001000,2S2,238,556,-318,0.43
202412,73001000,2S3,33,155,-122,0.21
202412,73001000,3,224,252,-28,0.89
202412,73001000,3S2,576,636,-60,0.91
202412,73001000,3S3,3735,2418,1317,1.54
202412,73001000,3S4,1,5,-4,0.2
202412,73001000,4,0,3,-3,0
202412,73001000,CA,1417,1861,-444,0.76
202412,73001000,V2,0,1,-1,0
202412,73001000,V3,528,9,519,58.67
202412,73001000,V4,0,2,-2,0
202412,73001001,2,0,1,-1,0
202412,73001001,3S3,15,0,15,NA
202412,73001005,2,0,1,-1,0
202412,73001009,2,0,1,-1,0
202412,73001009,CA,0,1,-1,0
202412,73001015,2,0,1,-1,0
202412,73001017,2,0,1,-1,0
202412,73001020,2,1,0,1,NA
202412,73001020,3,1,0,1,NA
202412,73001031,2,0,10,-10,0
202412,73001032,2,0,2,-2,0
202412,73001032,3S3,0,7,-7,0
202412,73001032,CA,0,1,-1,0
202412,73001039,2,1,0,1,NA
202412,73024000,2,0,1,-1,0
202412,73024000,CA,18,18,0,1
202412,73024001,CA,0,1,-1,0
202412,73024004,2,0,1,-1,0
202412,73024004,3S3,0,7,-7,0
202412,73024004,CA,1,4,-3,0.25
202412,73026000,2,121,125,-4,0.97
202412,73026000,2S2,0,2,-2,0
202412,73026000,2S3,4,2,2,2
202412,73026000,3,1,1,0,1
202412,73026000,3S2,0,10,-10,0
202412,73026000,3S3,16,14,2,1.14
202412,73026000,CA,9,26,-17,0.35
202412,73026008,2S2,0,3,-3,0
202412,73030000,2,33,38,-5,0.87
202412,73030000,3,0,3,-3,0
202412,73030000,3S2,0,1,-1,0
202412,73030000,3S3,9,8,1,1.12
202412,73030000,CA,4,12,-8,0.33
202412,73043000,2,0,18,-18,0
202412,73043000,CA,0,9,-9,0
202412,73055000,2,26,49,-23,0.53
202412,73055000,2S2,0,1,-1,0
202412,73055000,3S2,10,1,9,10
202412,73055000,3S3,8,5,3,1.6
202412,73055000,4,0,1,-1,0
202412,73055000,CA,3,7,-4,0.43
202412,73055003,2,0,1,-1,0
202412,73055004,2,4,3,1,1.33
202412,73055004,CA,0,1,-1,0
202412,73067000,2,2,3,-1,0.67
202412,73067000,3,0,11,-11,0
202412,73067000,3S2,0,1,-1,0
202412,73067000,3S3,2,4,-2,0.5
202412,73067000,3S4,1,0,1,NA
202412,73067000,CA,26,25,1,1.04
202412,73067000,V3,0,4,-4,0
202412,73067007,2,0,4,-4,0
202412,73067007,3,0,2,-2,0
202412,73067007,CA,0,1,-1,0
202412,73067014,2,0,1,-1,0
202412,73067015,CA,0,6,-6,0
202412,73124000,2,36,89,-53,0.4
202412,73124000,3,2,0,2,NA
202412,73124000,3S2,1,0,1,NA
202412,73124000,3S3,1,1,0,1
202412,73124000,CA,4,43,-39,0.09
202412,73148000,2,5,103,-98,0.05
202412,73148000,2R2,0,3,-3,0
202412,73148000,2S2,2,0,2,NA
202412,73148000,3,3,0,3,NA
202412,73148000,3S2,1,1,0,1
202412,73148000,3S3,1,9,-8,0.11
202412,73148000,CA,0,64,-64,0
202412,73152000,2,0,14,-14,0
202412,73152000,3,1,0,1,NA
202412,73152000,CA,0,4,-4,0
202412,73168000,2,111,345,-234,0.32
202412,73168000,2R2,0,8,-8,0
202412,73168000,2R3,0,1,-1,0
202412,73168000,2S2,0,1,-1,0
202412,73168000,3,232,29,203,8
202412,73168000,3S2,12,3,9,4
202412,73168000,3S3,168,67,101,2.51
202412,73168000,CA,31,137,-106,0.23
202412,73200000,2,139,18,121,7.72
202412,73200000,3,66,93,-27,0.71
202412,73200000,3S2,0,8,-8,0
202412,73200000,3S3,38,50,-12,0.76
202412,73200000,CA,2,10,-8,0.2
202412,73200000,V3,0,505,-505,0
202412,73200001,2,203,2,201,101.5
202412,73200001,2S2,77,0,77,NA
202412,73200001,3,153,0,153,NA
202412,73200001,3S2,4,3,1,1.33
202412,73200001,3S3,41,82,-41,0.5
202412,73200001,CA,2,2,0,1
202412,73217000,2,3,14,-11,0.21
202412,73217000,3,0,19,-19,0
202412,73217000,3S2,0,1,-1,0
202412,73217000,3S3,1,10,-9,0.1
202412,73217000,3S4,0,1,-1,0
202412,73217000,4,0,1,-1,0
202412,73217000,CA,0,7,-7,0
202412,73217001,2,2,1,1,2
202412,73226000,2,16,28,-12,0.57
202412,73226000,3S3,1,0,1,NA
202412,73226000,CA,1,9,-8,0.11
202412,73236000,2,2,33,-31,0.06
202412,73236000,CA,0,12,-12,0
202412,73236004,2,0,1,-1,0
202412,73268000,2,585,811,-226,0.72
202412,73268000,2R2,0,11,-11,0
202412,73268000,2S2,2,20,-18,0.1
202412,73268000,2S3,5,4,1,1.25
202412,73268000,3,55,22,33,2.5
202412,73268000,3S2,24,20,4,1.2
202412,73268000,3S3,894,293,601,3.05
202412,73268000,4,1,0,1,NA
202412,73268000,CA,144,388,-244,0.37
202412,73268000,V3,1,0,1,NA
202412,73268001,2,8,14,-6,0.57
202412,73268001,3,0,1,-1,0
202412,73268001,3S3,18,6,12,3
202412,73268001,CA,4,7,-3,0.57
202412,73270000,2,0,7,-7,0
202412,73270000,CA,0,4,-4,0
202412,73270004,2,0,1,-1,0
202412,73270004,CA,0,3,-3,0
202412,73275000,2,248,298,-50,0.83
202412,73275000,2S2,1,1,0,1
202412,73275000,2S3,0,1,-1,0
202412,73275000,3,35,9,26,3.89
202412,73275000,3S2,3,6,-3,0.5
202412,73275000,3S3,44,120,-76,0.37
202412,73275000,CA,3,98,-95,0.03
202412,73283000,2,37,284,-247,0.13
202412,73283000,3,0,10,-10,0
202412,73283000,3S3,3,67,-64,0.04
202412,73283000,CA,6,55,-49,0.11
202412,73283000,V3,0,2,-2,0
202412,73319000,2,16,124,-108,0.13
202412,73319000,2R2,0,1,-1,0
202412,73319000,3,0,67,-67,0
202412,73319000,3S2,2,5,-3,0.4
202412,73319000,3S3,14,5,9,2.8
202412,73319000,CA,7,31,-24,0.23
202412,73319000,V3,0,1,-1,0
202412,73319002,2S2,2,0,2,NA
202412,73319008,3S3,0,1,-1,0
202412,73347000,2,8,6,2,1.33
202412,73347000,CA,0,8,-8,0
202412,73347001,3S3,9,4,5,2.25
202412,73347003,2,22,10,12,2.2
202412,73347003,3S3,26,5,21,5.2
202412,73347005,2,0,6,-6,0
202412,73347005,3S3,0,1,-1,0
202412,73349000,2,18,281,-263,0.06
202412,73349000,2R2,0,2,-2,0
202412,73349000,2S2,7,5,2,1.4
202412,73349000,2S3,7,27,-20,0.26
202412,73349000,3,0,25,-25,0
202412,73349000,3S2,2,6,-4,0.33
202412,73349000,3S3,141,258,-117,0.55
202412,73349000,3S4,2,0,2,NA
202412,73349000,CA,10,62,-52,0.16
202412,73349000,V3,11,14,-3,0.79
202412,73352000,2,3,25,-22,0.12
202412,73352000,CA,0,20,-20,0
202412,73408000,2,10,114,-104,0.09
202412,73408000,2S2,0,8,-8,0
202412,73408000,2S3,0,2,-2,0
202412,73408000,3,0,5,-5,0
202412,73408000,3S2,0,1,-1,0
202412,73408000,3S3,20,46,-26,0.43
202412,73408000,CA,1,59,-58,0.02
202412,73408000,V3,0,1,-1,0
202412,73408002,2,2,0,2,NA
202412,73411000,2,45,250,-205,0.18
202412,73411000,3,1,30,-29,0.03
202412,73411000,3S2,0,1,-1,0
202412,73411000,3S3,10,18,-8,0.56
202412,73411000,CA,5,102,-97,0.05
202412,73411000,V3,0,1,-1,0
202412,73411000,V4,1,0,1,NA
202412,73411009,2,0,4,-4,0
202412,73411009,3,0,1,-1,0
202412,73443000,2,291,441,-150,0.66
202412,73443000,2S2,2,5,-3,0.4
202412,73443000,2S3,1,2,-1,0.5
202412,73443000,3,58,18,40,3.22
202412,73443000,3S2,13,10,3,1.3
202412,73443000,3S3,411,192,219,2.14
202412,73443000,4,0,2,-2,0
202412,73443000,CA,20,84,-64,0.24
202412,73443003,3S3,1,0,1,NA
202412,73449000,2,44,556,-512,0.08
202412,73449000,2R2,0,6,-6,0
202412,73449000,2S2,0,4,-4,0
202412,73449000,2S3,3,3,0,1
202412,73449000,3,2,20,-18,0.1
202412,73449000,3S2,2,3,-1,0.67
202412,73449000,3S3,4,48,-44,0.08
202412,73449000,CA,16,266,-250,0.06
202412,73449000,V3,0,2,-2,0
202412,73461000,2,3,10,-7,0.3
202412,73461000,CA,0,2,-2,0
202412,73483000,2,27,114,-87,0.24
202412,73483000,2S2,2,0,2,NA
202412,73483000,3,0,49,-49,0
202412,73483000,3S2,1,0,1,NA
202412,73483000,3S3,0,3,-3,0
202412,73483000,CA,2,9,-7,0.22
202412,73483001,2,0,1,-1,0
202412,73483002,2,0,1,-1,0
202412,73504000,2,2,52,-50,0.04
202412,73504000,2R2,0,4,-4,0
202412,73504000,2R3,0,2,-2,0
202412,73504000,2S2,0,1,-1,0
202412,73504000,3,41,7,34,5.86
202412,73504000,3S2,0,1,-1,0
202412,73504000,3S3,37,4,33,9.25
202412,73504000,CA,0,9,-9,0
202412,73520000,2,2,24,-22,0.08
202412,73520000,CA,2,10,-8,0.2
202412,73547000,2,65,19,46,3.42
202412,73547000,3,2,2,0,1
202412,73547000,3S2,3,1,2,3
202412,73547000,3S3,102,14,88,7.29
202412,73547000,CA,2,12,-10,0.17
202412,73547002,2,16,11,5,1.45
202412,73547002,3S2,0,2,-2,0
202412,73547002,3S3,4,7,-3,0.57
202412,73547002,CA,17,1,16,17
202412,73555000,2,26,55,-29,0.47
202412,73555000,3,15,4,11,3.75
202412,73555000,CA,13,24,-11,0.54
202412,73555001,2,1,1,0,1
202412,73555002,2,1,0,1,NA
202412,73555002,3,0,2,-2,0
202412,73555002,CA,0,2,-2,0
202412,73563000,2,7,31,-24,0.23
202412,73563000,2S2,1,4,-3,0.25
202412,73563000,2S3,1,2,-1,0.5
202412,73563000,3,1,12,-11,0.08
202412,73563000,3S3,1,5,-4,0.2
202412,73563000,3S4,1,3,-2,0.33
202412,73563000,CA,4,9,-5,0.44
202412,73563000,V3,0,2,-2,0
202412,73585000,2,16,105,-89,0.15
202412,73585000,2R2,0,6,-6,0
202412,73585000,2S2,1,0,1,NA
202412,73585000,3,30,24,6,1.25
202412,73585000,3S2,3,0,3,NA
202412,73585000,3S3,136,19,117,7.16
202412,73585000,CA,4,24,-20,0.17
202412,73616000,2,0,30,-30,0
202412,73616000,3,1,1,0,1
202412,73616000,3S3,1,0,1,NA
202412,73616000,CA,0,5,-5,0
202412,73616001,2,3,0,3,NA
202412,73622000,2,0,4,-4,0
202412,73622000,CA,24,26,-2,0.92
202412,73622001,2,0,1,-1,0
202412,73624000,2,4,105,-101,0.04
202412,73624000,3,0,1,-1,0
202412,73624000,CA,1,28,-27,0.04
202412,73624005,3,0,1,-1,0
202412,73671000,2,40,127,-87,0.31
202412,73671000,2R2,0,1,-1,0
202412,73671000,2S1,1,0,1,NA
202412,73671000,2S2,0,1,-1,0
202412,73671000,3,1,12,-11,0.08
202412,73671000,3S2,757,0,757,NA
202412,73671000,3S3,592,96,496,6.17
202412,73671000,CA,6,33,-27,0.18
202412,73671000,V2,2,0,2,NA
202412,73671000,V3,6,0,6,NA
202412,73675000,2,0,32,-32,0
202412,73675000,3,0,1,-1,0
202412,73675000,CA,0,1,-1,0
202412,73675004,2,0,1,-1,0
202412,73678000,2,3,56,-53,0.05
202412,73678000,3S2,15,0,15,NA
202412,73678000,3S3,1,0,1,NA
202412,73678000,CA,2,13,-11,0.15
202412,73678004,2,1,4,-3,0.25
202412,73678004,3,0,16,-16,0
202412,73678004,3S2,2,0,2,NA
202412,73678004,3S3,26,3,23,8.67
202412,73678004,CA,1,2,-1,0.5
202412,73686000,2,0,7,-7,0
202412,73686000,CA,0,3,-3,0
202412,73686003,2,0,1,-1,0
202412,73770000,2,1,15,-14,0.07
202412,73770000,2S2,0,1,-1,0
202412,73770000,3,10,1,9,10
202412,73770000,3S2,28,0,28,NA
202412,73770000,3S3,7,1,6,7
202412,73770000,4,5,0,5,NA
202412,73770000,CA,0,5,-5,0
202412,73770000,V2,44,0,44,NA
202412,73770000,V3,394,0,394,NA
202412,73770000,V4,52,0,52,NA
202412,73854000,2,5,2,3,2.5
202412,73854000,CA,1,0,1,NA
202412,73854000,V3,1,0,1,NA
202412,73861000,2,19,74,-55,0.26
202412,73861000,2R2,0,1,-1,0
202412,73861000,3,13,3,10,4.33
202412,73861000,3S2,10,3,7,3.33
202412,73861000,3S3,125,38,87,3.29
202412,73861000,CA,2,12,-10,0.17
202412,73870000,2,0,11,-11,0
202412,73873000,2,6,20,-14,0.3
202412,73873000,CA,24,26,-2,0.92
202412,76001000,2,14737,27262,-12525,0.54
202412,76001000,2B1,0,10,-10,0
202412,76001000,2B2,1,4,-3,0.25
202412,76001000,2R2,1,32,-31,0.03
202412,76001000,2S1,2,19,-17,0.11
202412,76001000,2S2,829,2758,-1929,0.3
202412,76001000,2S3,329,1049,-720,0.31
202412,76001000,3,136,871,-735,0.16
202412,76001000,3S1,9,11,-2,0.82
202412,76001000,3S2,2118,1699,419,1.25
202412,76001000,3S3,2737,5615,-2878,0.49
202412,76001000,3S3S2,1,0,1,NA
202412,76001000,3S4,8,7,1,1.14
202412,76001000,4,8,21,-13,0.38
202412,76001000,CA,4203,9948,-5745,0.42
202412,76001000,V2,107,1,106,107
202412,76001002,2,0,1,-1,0
202412,76001013,2,0,256,-256,0
202412,76001013,CA,0,368,-368,0
202412,76001016,2,0,2,-2,0
202412,76001019,2,0,3,-3,0
202412,76001019,3S2,0,1,-1,0
202412,76001019,3S3,3,18,-15,0.17
202412,76020000,2,66,179,-113,0.37
202412,76020000,3,0,31,-31,0
202412,76020000,3S3,0,7,-7,0
202412,76020000,CA,1,20,-19,0.05
202412,76020003,2,0,8,-8,0
202412,76036000,2,147,130,17,1.13
202412,76036000,2S2,0,2,-2,0
202412,76036000,2S3,1,2,-1,0.5
202412,76036000,3,0,34,-34,0
202412,76036000,3S2,0,12,-12,0
202412,76036000,3S3,5,77,-72,0.06
202412,76036000,CA,1,45,-44,0.02
202412,76036000,V2,1,0,1,NA
202412,76036001,2,0,3,-3,0
202412,76041000,2,65,197,-132,0.33
202412,76041000,3,1,5,-4,0.2
202412,76041000,3S2,2,0,2,NA
202412,76041000,3S3,0,25,-25,0
202412,76041000,CA,0,80,-80,0
202412,76054000,2,33,14,19,2.36
202412,76054000,3,0,3,-3,0
202412,76054000,CA,0,1,-1,0
202412,76054007,3S3,1,0,1,NA
202412,76054007,CA,1,0,1,NA
202412,76100000,2,13,73,-60,0.18
202412,76100000,2S2,0,1,-1,0
202412,76100000,CA,0,13,-13,0
202412,76100001,2,0,1,-1,0
202412,76100004,2,0,3,-3,0
202412,76100007,2,1,0,1,NA
202412,76100007,3,1,0,1,NA
202412,76100009,2,0,1,-1,0
202412,76100010,2,0,1,-1,0
202412,76109000,2,4865,3520,1345,1.38
202412,76109000,2R2,53,0,53,NA
202412,76109000,2S1,13,9,4,1.44
202412,76109000,2S2,11363,5033,6330,2.26
202412,76109000,2S3,3836,1770,2066,2.17
202412,76109000,3,145,63,82,2.3
202412,76109000,3S1,4,1,3,4
202412,76109000,3S2,3821,2464,1357,1.55
202412,76109000,3S3,31885,11086,20799,2.88
202412,76109000,3S4,22,8,14,2.75
202412,76109000,4,31,20,11,1.55
202412,76109000,CA,991,859,132,1.15
202412,76109000,V4,9,0,9,NA
202412,76109006,2,0,13,-13,0
202412,76109006,2S3,0,1,-1,0
202412,76109006,3,2,0,2,NA
202412,76109006,3S3,0,5,-5,0
202412,76109006,CA,0,9,-9,0
202412,76109008,2,27,11,16,2.45
202412,76109008,2S2,1,0,1,NA
202412,76109008,3S3,11,1,10,11
202412,76109008,CA,3,4,-1,0.75
202412,76109009,2,32,1,31,32
202412,76109009,2S3,1,0,1,NA
202412,76109009,3,0,1,-1,0
202412,76109009,3S3,36,0,36,NA
202412,76109009,CA,5,0,5,NA
202412,76109015,2,48,3,45,16
202412,76109015,3S3,7,0,7,NA
202412,76109054,2,1,0,1,NA
202412,76109056,2,0,2,-2,0
202412,76109056,3S2,0,1,-1,0
202412,76109056,3S3,0,8,-8,0
202412,76109060,2S2,1,0,1,NA
202412,76109061,2,0,1,-1,0
202412,76109076,2,2,0,2,NA
202412,76109076,3S3,35,1,34,35
202412,76109076,CA,1,1,0,1
202412,76109078,2,0,5,-5,0
202412,76109078,2S2,0,1,-1,0
202412,76109078,3S3,6,3,3,2
202412,76111000,2,4654,3824,830,1.22
202412,76111000,2R2,6,0,6,NA
202412,76111000,2S2,72,65,7,1.11
202412,76111000,2S3,53,45,8,1.18
202412,76111000,3,784,113,671,6.94
202412,76111000,3S1,0,4,-4,0
202412,76111000,3S2,707,211,496,3.35
202412,76111000,3S3,2515,5026,-2511,0.5
202412,76111000,3S4,0,1,-1,0
202412,76111000,4,1,1,0,1
202412,76111000,CA,720,539,181,1.34
202412,76111000,V2,1,3,-2,0.33
202412,76111000,V2R2,1,1,0,1
202412,76111000,V3,5,1,4,5
202412,76111000,V4,0,6,-6,0
202412,76111002,CA,0,1,-1,0
202412,76111022,2,0,1,-1,0
202412,76111022,3S3,0,1,-1,0
202412,76111022,CA,0,1,-1,0
202412,76113000,2,140,584,-444,0.24
202412,76113000,2S2,15,55,-40,0.27
202412,76113000,2S3,13,23,-10,0.57
202412,76113000,3,16,24,-8,0.67
202412,76113000,3S2,151,132,19,1.14
202412,76113000,3S3,329,279,50,1.18
202412,76113000,4,0,1,-1,0
202412,76113000,CA,27,174,-147,0.16
202412,76113000,V3,1,1,0,1
202412,76113001,2,0,2,-2,0
202412,76113001,3S3,0,2,-2,0
202412,76113004,3S3,0,2,-2,0
202412,76113011,2,0,1,-1,0
202412,76113011,3S2,1,0,1,NA
202412,76113013,2,1,6,-5,0.17
202412,76113016,3,0,1,-1,0
202412,76122000,2,15,286,-271,0.05
202412,76122000,2S2,1,0,1,NA
202412,76122000,2S3,2,0,2,NA
202412,76122000,3,0,3,-3,0
202412,76122000,3S3,2,17,-15,0.12
202412,76122000,CA,1,98,-97,0.01
202412,76122000,V3,1,0,1,NA
202412,76122009,2,2,0,2,NA
202412,76122009,3,0,1,-1,0
202412,76126000,2,7,162,-155,0.04
202412,76126000,3,0,7,-7,0
202412,76126000,3S2,1,1,0,1
202412,76126000,3S3,0,2,-2,0
202412,76126000,CA,3,102,-99,0.03
202412,76126013,2,2,0,2,NA
202412,76126013,3S2,0,1,-1,0
202412,76130000,2,1480,1561,-81,0.95
202412,76130000,2S2,40,30,10,1.33
202412,76130000,2S3,6,17,-11,0.35
202412,76130000,3,67,138,-71,0.49
202412,76130000,3S2,207,136,71,1.52
202412,76130000,3S3,856,1262,-406,0.68
202412,76130000,4,1,1,0,1
202412,76130000,CA,667,419,248,1.59
202412,76130000,V2,0,1,-1,0
202412,76130002,3S3,0,3,-3,0
202412,76130003,2,1,0,1,NA
202412,76130004,2,0,6,-6,0
202412,76130006,2,0,1,-1,0
202412,76130007,2,3,1,2,3
202412,76130007,3S3,0,1,-1,0
202412,76130008,2,487,40,447,12.18
202412,76130008,2B1,0,1,-1,0
202412,76130008,2S3,6,0,6,NA
202412,76130008,3,6,41,-35,0.15
202412,76130008,3S2,29,18,11,1.61
202412,76130008,3S3,35,7,28,5
202412,76130008,4,0,1,-1,0
202412,76130008,CA,592,1,591,592
202412,76130009,2,1,0,1,NA
202412,76130009,3S3,36,0,36,NA
202412,76130016,2,0,2,-2,0
202412,76130016,CA,0,3,-3,0
202412,76147000,2,1583,2165,-582,0.73
202412,76147000,2R2,0,19,-19,0
202412,76147000,2S2,37,70,-33,0.53
202412,76147000,2S3,19,25,-6,0.76
202412,76147000,3,74,144,-70,0.51
202412,76147000,3S2,88,27,61,3.26
202412,76147000,3S3,1235,1838,-603,0.67
202412,76147000,CA,81,652,-571,0.12
202412,76147000,V3,9,0,9,NA
202412,76147010,2,244,185,59,1.32
202412,76147010,3,5,1,4,5
202412,76147010,3S3,22,5,17,4.4
202412,76147010,CA,32,5,27,6.4
202412,76147010,V2,10,0,10,NA
202412,76233000,2,164,259,-95,0.63
202412,76233000,2S2,0,9,-9,0
202412,76233000,2S3,0,3,-3,0
202412,76233000,3,3,1,2,3
202412,76233000,3S2,84,1,83,84
202412,76233000,3S3,144,4,140,36
202412,76233000,3S4,0,1,-1,0
202412,76233000,CA,4,147,-143,0.03
202412,76233000,V2,1,0,1,NA
202412,76233001,CA,0,1,-1,0
202412,76233004,2,0,2,-2,0
202412,76233004,3S3,1,0,1,NA
202412,76233009,2,0,5,-5,0
202412,76233011,2,0,6,-6,0
202412,76233011,CA,0,6,-6,0
202412,76233017,2,18,9,9,2
202412,76233017,2S2,0,9,-9,0
202412,76233017,2S3,0,3,-3,0
202412,76233017,3S2,0,3,-3,0
202412,76233017,3S3,17,22,-5,0.77
202412,76233017,3S4,0,1,-1,0
202412,76233017,4,7,0,7,NA
202412,76233017,CA,2,2,0,1
202412,76233025,3S3,1,1,0,1
202412,76233029,2,0,1,-1,0
202412,76243000,2,4,4,0,1
202412,76243000,CA,0,1,-1,0
202412,76243009,2,2,5,-3,0.4
202412,76243009,3S3,0,1,-1,0
202412,76243010,2S3,1,0,1,NA
202412,76246000,2,0,23,-23,0
202412,76246000,CA,0,27,-27,0
202412,76248000,2,240,536,-296,0.45
202412,76248000,2S2,1,2,-1,0.5
202412,76248000,2S3,3,3,0,1
202412,76248000,3,4,29,-25,0.14
202412,76248000,3S1,0,1,-1,0
202412,76248000,3S2,30,29,1,1.03
202412,76248000,3S3,1105,95,1010,11.63
202412,76248000,4,0,1,-1,0
202412,76248000,CA,49,254,-205,0.19
202412,76248000,V2,16,0,16,NA
202412,76248001,3S2,2,0,2,NA
202412,76248005,3S2,0,21,-21,0
202412,76248005,3S3,28,9,19,3.11
202412,76248005,CA,0,3,-3,0
202412,76248009,2,1,10,-9,0.1
202412,76248009,3,0,6,-6,0
202412,76248009,3S3,0,2,-2,0
202412,76248009,CA,1,4,-3,0.25
202412,76250000,2,63,80,-17,0.79
202412,76250000,3,0,4,-4,0
202412,76250000,3S2,2,1,1,2
202412,76250000,CA,0,10,-10,0
202412,76250013,2,0,1,-1,0
202412,76250013,CA,0,1,-1,0
202412,76275000,2,55,275,-220,0.2
202412,76275000,2B2,0,1,-1,0
202412,76275000,3,0,11,-11,0
202412,76275000,3S2,1,0,1,NA
202412,76275000,3S3,164,3,161,54.67
202412,76275000,4,0,3,-3,0
202412,76275000,CA,2,214,-212,0.01
202412,76275008,2,3,70,-67,0.04
202412,76275008,2S2,1,1,0,1
202412,76275008,2S3,2,1,1,2
202412,76275008,3S3,0,16,-16,0
202412,76275008,CA,0,15,-15,0
202412,76306000,2,955,946,9,1.01
202412,76306000,2S1,1,25,-24,0.04
202412,76306000,2S2,27,4,23,6.75
202412,76306000,2S3,5,7,-2,0.71
202412,76306000,3,3,61,-58,0.05
202412,76306000,3S1,0,17,-17,0
202412,76306000,3S2,5,75,-70,0.07
202412,76306000,3S3,9,70,-61,0.13
202412,76306000,CA,29,129,-100,0.22
202412,76306001,2,0,2,-2,0
202412,76306001,CA,0,2,-2,0
202412,76306004,2,0,4,-4,0
202412,76318000,2,225,296,-71,0.76
202412,76318000,2S2,2,2,0,1
202412,76318000,3,6,19,-13,0.32
202412,76318000,3S2,11,30,-19,0.37
202412,76318000,3S3,421,32,389,13.16
202412,76318000,CA,0,184,-184,0
202412,76318000,V2,0,1,-1,0
202412,76318000,V3,1,0,1,NA
202412,76318008,2,1,2,-1,0.5
202412,76318008,3S3,4,2,2,2
202412,76364000,2,866,2059,-1193,0.42
202412,76364000,2S1,0,9,-9,0
202412,76364000,2S2,4,47,-43,0.09
202412,76364000,2S3,3,12,-9,0.25
202412,76364000,3,48,69,-21,0.7
202412,76364000,3S1,2,4,-2,0.5
202412,76364000,3S2,26,192,-166,0.14
202412,76364000,3S3,86,422,-336,0.2
202412,76364000,CA,165,988,-823,0.17
202412,76364000,V4,1,0,1,NA
202412,76364009,2,0,2,-2,0
202412,76364010,2,0,10,-10,0
202412,76364013,2,0,22,-22,0
202412,76364013,3,2,0,2,NA
202412,76377000,2,7,64,-57,0.11
202412,76377000,2S2,0,1,-1,0
202412,76377000,2S3,0,1,-1,0
202412,76377000,3,2,0,2,NA
202412,76377000,3S2,1,0,1,NA
202412,76377000,CA,0,18,-18,0
202412,76377004,2,0,2,-2,0
202412,76377004,CA,0,1,-1,0
202412,76400000,2,119,341,-222,0.35
202412,76400000,2S2,0,2,-2,0
202412,76400000,3,3,47,-44,0.06
202412,76400000,3S2,23,5,18,4.6
202412,76400000,3S3,26,162,-136,0.16
202412,76400000,4,4,0,4,NA
202412,76400000,CA,0,47,-47,0
202412,76400007,2,36,37,-1,0.97
202412,76400007,3,0,3,-3,0
202412,76400007,3S3,1,22,-21,0.05
202412,76400007,CA,0,1,-1,0
202412,76403000,2,176,118,58,1.49
202412,76403000,2R2,0,4,-4,0
202412,76403000,3,241,17,224,14.18
202412,76403000,3S2,23,1,22,23
202412,76403000,3S3,24,2,22,12
202412,76403000,4,0,1,-1,0
202412,76403000,CA,0,23,-23,0
202412,76403003,2,0,1,-1,0
202412,76403003,3S3,1,1,0,1
202412,76403007,2,0,12,-12,0
202412,76403007,3,0,6,-6,0
202412,76403007,3S2,0,1,-1,0
202412,76403007,3S3,0,7,-7,0
202412,76403007,CA,0,1,-1,0
202412,76403010,CA,0,1,-1,0
202412,76497000,2,135,64,71,2.11
202412,76497000,2S2,0,1,-1,0
202412,76497000,3,1,16,-15,0.06
202412,76497000,3S3,0,7,-7,0
202412,76497000,CA,0,36,-36,0
202412,76520000,2,10509,4994,5515,2.1
202412,76520000,2B1,0,4,-4,0
202412,76520000,2R2,2,8,-6,0.25
202412,76520000,2R3,1,0,1,NA
202412,76520000,2S1,6,11,-5,0.55
202412,76520000,2S2,1362,2254,-892,0.6
202412,76520000,2S3,462,316,146,1.46
202412,76520000,3,230,201,29,1.14
202412,76520000,3S1,0,13,-13,0
202412,76520000,3S2,1127,1894,-767,0.6
202412,76520000,3S3,3540,3502,38,1.01
202412,76520000,3S4,11,5,6,2.2
202412,76520000,4,5,7,-2,0.71
202412,76520000,CA,1417,1538,-121,0.92
202412,76520000,V2,0,128,-128,0
202412,76520001,2,0,4,-4,0
202412,76520001,3S3,0,1,-1,0
202412,76520002,2,5,8,-3,0.62
202412,76520002,2S1,0,1,-1,0
202412,76520002,3,0,18,-18,0
202412,76520002,3S1,0,3,-3,0
202412,76520002,3S2,0,15,-15,0
202412,76520002,3S3,1,5,-4,0.2
202412,76520005,2,1,0,1,NA
202412,76520005,3S2,1,0,1,NA
202412,76520009,CA,0,4,-4,0
202412,76520010,2,6,1,5,6
202412,76520014,2,0,1,-1,0
202412,76520014,3S2,0,1,-1,0
202412,76520014,3S3,0,1,-1,0
202412,76520014,4,0,1,-1,0
202412,76520014,CA,0,1,-1,0
202412,76520016,2,1,0,1,NA
202412,76520022,2,0,1,-1,0
202412,76520022,3S3,0,1,-1,0
202412,76520023,2,0,15,-15,0
202412,76520024,2,256,10,246,25.6
202412,76520024,2S2,521,10,511,52.1
202412,76520024,2S3,6,0,6,NA
202412,76520024,CA,11,2,9,5.5
202412,76520026,2,104,64,40,1.62
202412,76520026,2S2,1,11,-10,0.09
202412,76520026,2S3,0,2,-2,0
202412,76520026,3,5,3,2,1.67
202412,76520026,3S2,12,8,4,1.5
202412,76520026,3S3,3,45,-42,0.07
202412,76520026,CA,9,19,-10,0.47
202412,76520028,2,2,3,-1,0.67
202412,76520029,3S2,18,0,18,NA
202412,76520032,2,0,1,-1,0
202412,76520038,2,58,17,41,3.41
202412,76520038,3,0,2,-2,0
202412,76520038,3S2,2,4,-2,0.5
202412,76520038,3S3,9,26,-17,0.35
202412,76520038,CA,0,2,-2,0
202412,76563000,2,164,342,-178,0.48
202412,76563000,2S2,0,5,-5,0
202412,76563000,2S3,0,3,-3,0
202412,76563000,3,3,8,-5,0.38
202412,76563000,3S2,16,10,6,1.6
202412,76563000,3S3,463,101,362,4.58
202412,76563000,4,1,0,1,NA
202412,76563000,CA,4,189,-185,0.02
202412,76563001,2,2,4,-2,0.5
202412,76563001,CA,0,1,-1,0
202412,76563020,3S3,22,0,22,NA
202412,76606000,2,69,268,-199,0.26
202412,76606000,2S1,5,0,5,NA
202412,76606000,2S2,0,1,-1,0
202412,76606000,2S3,0,2,-2,0
202412,76606000,3,8,57,-49,0.14
202412,76606000,3S2,0,15,-15,0
202412,76606000,3S3,0,7,-7,0
202412,76606000,CA,1,77,-76,0.01
202412,76616000,2,21,96,-75,0.22
202412,76616000,3,1,7,-6,0.14
202412,76616000,3S2,6,0,6,NA
202412,76616000,3S3,260,14,246,18.57
202412,76616000,4,0,2,-2,0
202412,76616000,CA,2,28,-26,0.07
202412,76616000,V2,0,5,-5,0
202412,76616002,2,0,1,-1,0
202412,76616009,2,0,17,-17,0
202412,76622000,2,192,394,-202,0.49
202412,76622000,2S2,1,4,-3,0.25
202412,76622000,2S3,1,2,-1,0.5
202412,76622000,3,5,14,-9,0.36
202412,76622000,3S1,0,1,-1,0
202412,76622000,3S2,5,5,0,1
202412,76622000,3S3,35,48,-13,0.73
202412,76622000,4,3,2,1,1.5
202412,76622000,CA,4,140,-136,0.03
202412,76622000,V3,0,2,-2,0
202412,76622005,2,184,859,-675,0.21
202412,76622005,2B1,0,1,-1,0
202412,76622005,2R2,0,1,-1,0
202412,76622005,2S1,65,0,65,NA
202412,76622005,2S2,2,1,1,2
202412,76622005,3,361,0,361,NA
202412,76622005,3S1,71,1,70,71
202412,76622005,3S2,285,7,278,40.71
202412,76622005,3S3,70,26,44,2.69
202412,76622005,CA,0,9,-9,0
202412,76622021,2,0,1,-1,0
202412,76670000,2,88,145,-57,0.61
202412,76670000,2S2,1,3,-2,0.33
202412,76670000,2S3,1,1,0,1
202412,76670000,3,1,6,-5,0.17
202412,76670000,3S2,2,7,-5,0.29
202412,76670000,3S3,56,133,-77,0.42
202412,76670000,CA,0,20,-20,0
202412,76670007,2,5,3,2,1.67
202412,76670007,3S2,0,9,-9,0
202412,76670007,3S3,0,15,-15,0
202412,76736000,2,161,465,-304,0.35
202412,76736000,3,2,5,-3,0.4
202412,76736000,3S2,6,0,6,NA
202412,76736000,3S3,2,15,-13,0.13
202412,76736000,CA,1,357,-356,0
202412,76736004,2,1,0,1,NA
202412,76736004,2S2,1,1,0,1
202412,76736004,CA,1,0,1,NA
202412,76823000,2,15,124,-109,0.12
202412,76823000,3,1,2,-1,0.5
202412,76823000,3S2,1,1,0,1
202412,76823000,CA,4,73,-69,0.05
202412,76823006,CA,0,1,-1,0
202412,76828000,2,15,136,-121,0.11
202412,76828000,2S2,1,0,1,NA
202412,76828000,3,0,13,-13,0
202412,76828000,CA,0,45,-45,0
202412,76828004,2,0,1,-1,0
202412,76828004,2S2,2,0,2,NA
202412,76828017,2,0,1,-1,0
202412,76828017,CA,0,1,-1,0
202412,76834000,2,926,2950,-2024,0.31
202412,76834000,2B1,0,1,-1,0
202412,76834000,2S1,3,12,-9,0.25
202412,76834000,2S2,15,76,-61,0.2
202412,76834000,2S3,12,40,-28,0.3
202412,76834000,3,40,139,-99,0.29
202412,76834000,3S1,2,17,-15,0.12
202412,76834000,3S2,115,43,72,2.67
202412,76834000,3S3,742,1132,-390,0.66
202412,76834000,4,1,1,0,1
202412,76834000,CA,576,942,-366,0.61
202412,76834000,V2,0,4,-4,0
202412,76834002,3S3,0,1,-1,0
202412,76834010,2,0,6,-6,0
202412,76834010,CA,0,17,-17,0
202412,76845000,2,0,24,-24,0
202412,76845000,CA,0,28,-28,0
202412,76863000,2,39,30,9,1.3
202412,76863000,CA,1,64,-63,0.02
202412,76869000,2,45,84,-39,0.54
202412,76869000,2S2,1,0,1,NA
202412,76869000,2S3,0,1,-1,0
202412,76869000,3,8,0,8,NA
202412,76869000,3S2,0,1,-1,0
202412,76869000,3S3,80,718,-638,0.11
202412,76869000,CA,1,60,-59,0.02
202412,76869000,V2,14,0,14,NA
202412,76869000,V4,0,5,-5,0
202412,76869006,3S3,0,15,-15,0
202412,76890000,2,842,273,569,3.08
202412,76890000,2R2,18,44,-26,0.41
202412,76890000,2S1,0,1,-1,0
202412,76890000,2S2,2144,1043,1101,2.06
202412,76890000,2S3,202,87,115,2.32
202412,76890000,3,58,50,8,1.16
202412,76890000,3S1,0,3,-3,0
202412,76890000,3S2,111,365,-254,0.3
202412,76890000,3S3,531,1228,-697,0.43
202412,76890000,4,16,0,16,NA
202412,76890000,CA,3,57,-54,0.05
202412,76890000,V2,2,0,2,NA
202412,76890000,V3,1,0,1,NA
202412,76890006,2,21,3,18,7
202412,76890006,2S2,17,17,0,1
202412,76890006,2S3,3,2,1,1.5
202412,76890006,3,6,0,6,NA
202412,76890006,3S2,3,2,1,1.5
202412,76890006,3S3,22,5,17,4.4
202412,76890006,CA,0,1,-1,0
202412,76892000,2,38283,7072,31211,5.41
202412,76892000,2B1,0,2,-2,0
202412,76892000,2B2,0,1,-1,0
202412,76892000,2R2,4,3,1,1.33
202412,76892000,2R3,8,12,-4,0.67
202412,76892000,2S1,8,39,-31,0.21
202412,76892000,2S2,1723,2532,-809,0.68
202412,76892000,2S3,654,940,-286,0.7
202412,76892000,3,1508,154,1354,9.79
202412,76892000,3S1,3,7,-4,0.43
202412,76892000,3S2,2850,2447,403,1.16
202412,76892000,3S3,8666,9806,-1140,0.88
202412,76892000,3S4,3,9,-6,0.33
202412,76892000,4,26,10,16,2.6
202412,76892000,CA,11486,1150,10336,9.99
202412,76892000,V2,0,1,-1,0
202412,76892000,V3,1,0,1,NA
202412,76892000,V4,6,0,6,NA
202412,76892002,2,2,27,-25,0.07
202412,76892002,2S3,0,1,-1,0
202412,76892002,3S2,0,4,-4,0
202412,76892002,CA,0,4,-4,0
202412,76892004,2,198,119,79,1.66
202412,76892004,2S2,0,3,-3,0
202412,76892004,2S3,1,4,-3,0.25
202412,76892004,3,0,5,-5,0
202412,76892004,3S2,8,1,7,8
202412,76892004,3S3,25,7,18,3.57
202412,76892004,CA,8,1,7,8
202412,76892005,2,52,1,51,52
202412,76892005,3,5,0,5,NA
202412,76892005,3S2,5,0,5,NA
202412,76892005,3S3,27,39,-12,0.69
202412,76892008,2,105,2,103,52.5
202412,76892008,2S2,1,0,1,NA
202412,76892008,3,8,0,8,NA
202412,76892008,3S2,2,2,0,1
202412,76892008,3S3,48,1,47,48
202412,76892010,3S3,0,2,-2,0
202412,76892012,2,0,12,-12,0
202412,76892017,2,306,3,303,102
202412,76892017,3S2,5,3,2,1.67
202412,76892017,3S3,2,12,-10,0.17
202412,76892017,CA,135,0,135,NA
202412,76895000,2,83,522,-439,0.16
202412,76895000,2R2,0,15,-15,0
202412,76895000,2S2,5,11,-6,0.45
202412,76895000,2S3,6,4,2,1.5
202412,76895000,3,11,21,-10,0.52
202412,76895000,3S2,72,24,48,3
202412,76895000,3S3,580,125,455,4.64
202412,76895000,3S4,2,0,2,NA
202412,76895000,CA,4,206,-202,0.02
202412,76895002,2,163,346,-183,0.47
202412,76895002,2R2,0,1,-1,0
202412,76895002,2S2,40,8,32,5
202412,76895002,2S3,18,7,11,2.57
202412,76895002,3,11,0,11,NA
202412,76895002,3S2,89,77,12,1.16
202412,76895002,3S3,292,115,177,2.54
202412,76895002,3S4,0,4,-4,0
202412,76895002,CA,2,118,-116,0.02
202412,76895002,V2,0,1,-1,0
202412,76895005,2,0,2,-2,0
202412,76895007,3,0,1,-1,0
202412,81001000,2,179,4935,-4756,0.04
202412,81001000,2S2,0,6,-6,0
202412,81001000,2S3,0,1,-1,0
202412,81001000,3,30,39,-9,0.77
202412,81001000,3S1,0,7,-7,0
202412,81001000,3S2,3,9,-6,0.33
202412,81001000,3S3,35,394,-359,0.09
202412,81001000,3S4,0,1,-1,0
202412,81001000,CA,4,74,-70,0.05
202412,81001000,V2,0,2,-2,0
202412,81001000,V3,18,29,-11,0.62
202412,81001001,2,0,1,-1,0
202412,81001003,2,0,2,-2,0
202412,81065000,2,21,338,-317,0.06
202412,81065000,2S2,0,2,-2,0
202412,81065000,3,1,18,-17,0.06
202412,81065000,3S2,1,4,-3,0.25
202412,81065000,3S3,14,20,-6,0.7
202412,81065000,CA,0,3,-3,0
202412,81065000,V2,0,14,-14,0
202412,81065000,V3,3,112,-109,0.03
202412,81065002,2,0,1,-1,0
202412,81065008,2,1,19,-18,0.05
202412,81065008,4,0,1,-1,0
202412,81065009,2,0,2,-2,0
202412,81065017,2,0,25,-25,0
202412,81065017,CA,1,1,0,1
202412,81220000,2,0,30,-30,0
202412,81220000,3,0,1,-1,0
202412,81220000,3S3,0,1,-1,0
202412,81300000,2,8,128,-120,0.06
202412,81300000,3,0,2,-2,0
202412,81300000,3S3,4,6,-2,0.67
202412,81300000,CA,0,1,-1,0
202412,81300002,2,0,1,-1,0
202412,81300002,3S3,0,1,-1,0
202412,81591000,2,0,17,-17,0
202412,81591000,3,0,1,-1,0
202412,81736000,2,155,1665,-1510,0.09
202412,81736000,2S1,1,0,1,NA
202412,81736000,2S2,1,4,-3,0.25
202412,81736000,2S3,2,0,2,NA
202412,81736000,3,138,22,116,6.27
202412,81736000,3S1,6,0,6,NA
202412,81736000,3S2,15,6,9,2.5
202412,81736000,3S3,94,84,10,1.12
202412,81736000,3S4,1,0,1,NA
202412,81736000,4,7,2,5,3.5
202412,81736000,CA,12,19,-7,0.63
202412,81736000,V2,16,0,16,NA
202412,81736000,V3,123,0,123,NA
202412,81736008,2,0,9,-9,0
202412,81794000,2,120,824,-704,0.15
202412,81794000,2S3,2,7,-5,0.29
202412,81794000,3,0,23,-23,0
202412,81794000,3S1,1,4,-3,0.25
202412,81794000,3S2,18,17,1,1.06
202412,81794000,3S3,784,155,629,5.06
202412,81794000,CA,3,44,-41,0.07
202412,81794000,V2,5,0,5,NA
202412,81794000,V3,81,0,81,NA
202412,81794004,2,3,2,1,1.5
202412,81794006,2,0,1,-1,0
202412,81794010,2,0,4,-4,0
202412,85001000,2,1190,5005,-3815,0.24
202412,85001000,2R2,1,4,-3,0.25
202412,85001000,2S1,0,1,-1,0
202412,85001000,2S2,106,234,-128,0.45
202412,85001000,2S3,93,101,-8,0.92
202412,85001000,3,140,254,-114,0.55
202412,85001000,3S1,4,13,-9,0.31
202412,85001000,3S2,488,997,-509,0.49
202412,85001000,3S3,3132,3414,-282,0.92
202412,85001000,3S4,9,19,-10,0.47
202412,85001000,4,1,1,0,1
202412,85001000,4S2,8,4,4,2
202412,85001000,CA,327,631,-304,0.52
202412,85001000,V2,30,17,13,1.76
202412,85001000,V3,364,34,330,10.71
202412,85001000,V4,0,1,-1,0
202412,85001001,2,4,6,-2,0.67
202412,85001001,3,3,0,3,NA
202412,85001001,3S2,5,0,5,NA
202412,85001001,3S3,22,23,-1,0.96
202412,85001001,CA,0,1,-1,0
202412,85001002,2,6,13,-7,0.46
202412,85001002,3,9,0,9,NA
202412,85001002,3S2,3,20,-17,0.15
202412,85001002,3S3,51,248,-197,0.21
202412,85001002,CA,2,3,-1,0.67
202412,85001002,V3,88,0,88,NA
202412,85001003,2,1,3,-2,0.33
202412,85001003,2S2,1,0,1,NA
202412,85001003,2S3,4,3,1,1.33
202412,85001003,3S2,5,8,-3,0.62
202412,85001003,3S3,19,3,16,6.33
202412,85001003,4,0,1,-1,0
202412,85001003,CA,1,2,-1,0.5
202412,85001005,3S2,1,0,1,NA
202412,85001005,3S3,3,0,3,NA
202412,85001006,2,0,1,-1,0
202412,85001006,3S2,0,1,-1,0
202412,85001006,V2,2,0,2,NA
202412,85001006,V3,2,0,2,NA
202412,85001007,2,1,1,0,1
202412,85001007,3S3,7,0,7,NA
202412,85010000,2,106,495,-389,0.21
202412,85010000,2S2,9,9,0,1
202412,85010000,2S3,1,5,-4,0.2
202412,85010000,3,230,101,129,2.28
202412,85010000,3S2,151,1283,-1132,0.12
202412,85010000,3S3,903,1036,-133,0.87
202412,85010000,3S4,2,3,-1,0.67
202412,85010000,4,2,1,1,2
202412,85010000,CA,8,82,-74,0.1
202412,85010000,V2,34,13,21,2.62
202412,85010000,V3,167,548,-381,0.3
202412,85010000,V4,4,8,-4,0.5
202412,85010001,3S2,17,2,15,8.5
202412,85010001,3S3,219,14,205,15.64
202412,85010001,CA,0,1,-1,0
202412,85010002,3S2,2,1,1,2
202412,85010005,2,1,2,-1,0.5
202412,85010005,3S3,0,5,-5,0
202412,85010005,V3,0,8,-8,0
202412,85010010,3S3,18,0,18,NA
202412,85010011,2,1,0,1,NA
202412,85015000,2,0,3,-3,0
202412,85015000,3S2,0,2,-2,0
202412,85015000,V3,0,6,-6,0
202412,85125000,2,1,83,-82,0.01
202412,85125000,2S2,1,0,1,NA
202412,85125000,2S3,0,1,-1,0
202412,85125000,3,1,5,-4,0.2
202412,85125000,3S2,1,8,-7,0.12
202412,85125000,3S3,2,37,-35,0.05
202412,85125000,CA,0,7,-7,0
202412,85125000,V2,0,4,-4,0
202412,85125000,V3,1,71,-70,0.01
202412,85136000,3S2,0,13,-13,0
202412,85139000,2,8,139,-131,0.06
202412,85139000,2S2,0,2,-2,0
202412,85139000,2S3,0,1,-1,0
202412,85139000,3,5,46,-41,0.11
202412,85139000,3S2,71,89,-18,0.8
202412,85139000,3S3,366,434,-68,0.84
202412,85139000,3S4,0,1,-1,0
202412,85139000,4,0,1,-1,0
202412,85139000,CA,0,63,-63,0
202412,85139000,V2,0,41,-41,0
202412,85139000,V3,1,212,-211,0
202412,85139005,3S3,2,3,-1,0.67
202412,85162000,2,17,128,-111,0.13
202412,85162000,2S2,2,5,-3,0.4
202412,85162000,3,6,32,-26,0.19
202412,85162000,3S2,23,449,-426,0.05
202412,85162000,3S3,80,1703,-1623,0.05
202412,85162000,4,0,1,-1,0
202412,85162000,CA,2,22,-20,0.09
202412,85162000,V2,0,2,-2,0
202412,85162000,V3,0,33,-33,0
202412,85162004,3S3,0,56,-56,0
202412,85225000,2,2,14,-12,0.14
202412,85225000,2S2,0,1,-1,0
202412,85225000,2S3,3,0,3,NA
202412,85225000,3,6,0,6,NA
202412,85225000,3S2,2,4,-2,0.5
202412,85225000,3S3,115,46,69,2.5
202412,85225000,V3,10,12,-2,0.83
202412,85225009,2,0,2,-2,0
202412,85230000,2,14,267,-253,0.05
202412,85230000,2S2,5,15,-10,0.33
202412,85230000,2S3,6,15,-9,0.4
202412,85230000,3,0,40,-40,0
202412,85230000,3S1,0,7,-7,0
202412,85230000,3S2,399,15,384,26.6
202412,85230000,3S3,1338,208,1130,6.43
202412,85230000,3S4,1,5,-4,0.2
202412,85230000,4S2,0,1,-1,0
202412,85230000,CA,2,20,-18,0.1
202412,85230000,V2,14,25,-11,0.56
202412,85230000,V3,83,226,-143,0.37
202412,85230003,2,2,3,-1,0.67
202412,85230003,3S2,300,0,300,NA
202412,85230003,3S3,113,2,111,56.5
202412,85230006,3S3,12,0,12,NA
202412,85250000,2,61,814,-753,0.07
202412,85250000,2S2,6,2,4,3
202412,85250000,2S3,4,2,2,2
202412,85250000,3,3,29,-26,0.1
202412,85250000,3S2,124,17,107,7.29
202412,85250000,3S3,312,178,134,1.75
202412,85250000,3S4,6,1,5,6
202412,85250000,CA,6,79,-73,0.08
202412,85250000,V3,39,4,35,9.75
202412,85250001,3S3,4,1,3,4
202412,85250002,2,1,0,1,NA
202412,85250002,3S2,4,0,4,NA
202412,85250002,3S3,1,0,1,NA
202412,85250002,4S2,2,3,-1,0.67
202412,85250003,3S2,3,0,3,NA
202412,85250003,3S3,3,0,3,NA
202412,85250005,2,0,1,-1,0
202412,85250006,2,3,2,1,1.5
202412,85250006,3S3,9,0,9,NA
202412,85250006,CA,0,1,-1,0
202412,85263000,2,26,99,-73,0.26
202412,85263000,2S1,0,1,-1,0
202412,85263000,2S2,0,1,-1,0
202412,85263000,3,3,7,-4,0.43
202412,85263000,3S2,3,23,-20,0.13
202412,85263000,3S3,233,55,178,4.24
202412,85263000,4S2,2,2,0,1
202412,85263000,CA,2,5,-3,0.4
202412,85263000,V2,0,3,-3,0
202412,85263000,V3,18,46,-28,0.39
202412,85279002,2,0,1,-1,0
202412,85300000,2,1,4,-3,0.25
202412,85300000,3,0,3,-3,0
202412,85300000,CA,0,1,-1,0
202412,85300001,3S2,0,2,-2,0
202412,85300001,3S3,0,2,-2,0
202412,85300001,CA,0,26,-26,0
202412,85315000,2,2,6,-4,0.33
202412,85315000,3S2,0,2,-2,0
202412,85325000,2,6,31,-25,0.19
202412,85325000,2S2,5,1,4,5
202412,85325000,2S3,3,1,2,3
202412,85325000,3,0,20,-20,0
202412,85325000,3S1,5,0,5,NA
202412,85325000,3S2,33,3,30,11
202412,85325000,3S3,247,48,199,5.15
202412,85325000,3S4,2,0,2,NA
202412,85325000,4S2,0,2,-2,0
202412,85325000,CA,1,5,-4,0.2
202412,85325000,V3,0,90,-90,0
202412,85400000,2,9,13,-4,0.69
202412,85400000,3S3,0,3,-3,0
202412,85400000,CA,0,6,-6,0
202412,85410000,2,71,195,-124,0.36
202412,85410000,2S1,2,0,2,NA
202412,85410000,2S2,29,10,19,2.9
202412,85410000,2S3,3,11,-8,0.27
202412,85410000,3,44,130,-86,0.34
202412,85410000,3S1,5,0,5,NA
202412,85410000,3S2,307,1430,-1123,0.21
202412,85410000,3S3,1152,3335,-2183,0.35
202412,85410000,3S4,2,1,1,2
202412,85410000,4,0,7,-7,0
202412,85410000,CA,16,68,-52,0.24
202412,85410000,V2,33,1,32,33
202412,85410000,V3,92,3,89,30.67
202412,85410001,3S2,0,1,-1,0
202412,85410001,3S3,0,181,-181,0
202412,85410002,3S2,0,3,-3,0
202412,85410002,3S3,0,3,-3,0
202412,85410003,2S2,1,0,1,NA
202412,85410005,3S2,0,1,-1,0
202412,85410005,3S3,0,30,-30,0
202412,85430000,2,14,110,-96,0.13
202412,85430000,2S2,1,4,-3,0.25
202412,85430000,2S3,2,0,2,NA
202412,85430000,3,2,11,-9,0.18
202412,85430000,3S2,1,5,-4,0.2
202412,85430000,3S3,18,27,-9,0.67
202412,85430000,CA,2,13,-11,0.15
202412,85430000,V3,0,66,-66,0
202412,85430001,V3,0,4,-4,0
202412,85430006,3S3,0,2,-2,0
202412,85440000,2,81,744,-663,0.11
202412,85440000,2B2,0,3,-3,0
202412,85440000,2S1,0,1,-1,0
202412,85440000,2S2,19,41,-22,0.46
202412,85440000,2S3,23,38,-15,0.61
202412,85440000,3,36,88,-52,0.41
202412,85440000,3S1,1,2,-1,0.5
202412,85440000,3S2,416,35,381,11.89
202412,85440000,3S3,418,391,27,1.07
202412,85440000,3S4,1,3,-2,0.33
202412,85440000,4,1,1,0,1
202412,85440000,CA,12,88,-76,0.14
202412,85440000,V2,26,11,15,2.36
202412,85440000,V3,277,16,261,17.31
202412,85440001,2,8,3,5,2.67
202412,85440001,2S2,0,3,-3,0
202412,85440001,2S3,1,1,0,1
202412,85440001,3,1,2,-1,0.5
202412,85440001,3S2,0,1,-1,0
202412,85440001,3S3,0,8,-8,0
202412,85440002,2,1,1,0,1
202412,85440002,2S2,0,1,-1,0
202412,85440002,2S3,1,1,0,1
202412,86001000,2,187,386,-199,0.48
202412,86001000,2R2,0,8,-8,0
202412,86001000,2S2,1,38,-37,0.03
202412,86001000,2S3,0,1,-1,0
202412,86001000,3,64,14,50,4.57
202412,86001000,3S2,1,5,-4,0.2
202412,86001000,3S3,22,135,-113,0.16
202412,86001000,3S4,1,0,1,NA
202412,86001000,CA,87,98,-11,0.89
202412,86001000,V2,2,2,0,1
202412,86001004,3,32,1,31,32
202412,86219000,2,1,2,-1,0.5
202412,86219000,4,1,0,1,NA
202412,86320000,2,44,142,-98,0.31
202412,86320000,2R2,0,8,-8,0
202412,86320000,2S3,0,1,-1,0
202412,86320000,3,186,4,182,46.5
202412,86320000,3S1,0,1,-1,0
202412,86320000,3S2,15,83,-68,0.18
202412,86320000,3S3,101,169,-68,0.6
202412,86320000,CA,4,30,-26,0.13
202412,86320010,2,0,2,-2,0
202412,86568000,2,136,675,-539,0.2
202412,86568000,2R2,0,7,-7,0
202412,86568000,2S2,2,14,-12,0.14
202412,86568000,2S3,4,7,-3,0.57
202412,86568000,3,12,174,-162,0.07
202412,86568000,3S1,2,0,2,NA
202412,86568000,3S2,124,89,35,1.39
202412,86568000,3S3,339,679,-340,0.5
202412,86568000,3S4,0,1,-1,0
202412,86568000,CA,20,81,-61,0.25
202412,86568000,V3,0,8,-8,0
202412,86568012,2,1,3,-2,0.33
202412,86568013,2,3,50,-47,0.06
202412,86568013,3,0,2,-2,0
202412,86568013,3S3,22,8,14,2.75
202412,86568013,CA,0,9,-9,0
202412,86568014,2,0,2,-2,0
202412,86568016,2,0,9,-9,0
202412,86568016,3S2,1,0,1,NA
202412,86568016,3S3,2,0,2,NA
202412,86568017,3S2,8,0,8,NA
202412,86568017,3S3,16,0,16,NA
202412,86568019,2,0,3,-3,0
202412,86568021,3S3,1,0,1,NA
202412,86568026,2,2,1,1,2
202412,86568026,3S2,3,0,3,NA
202412,86568026,3S3,2,0,2,NA
202412,86569000,2,5,43,-38,0.12
202412,86569000,3,70,19,51,3.68
202412,86569000,3S2,4,3,1,1.33
202412,86569000,3S3,0,10,-10,0
202412,86569000,CA,0,41,-41,0
202412,86569000,V3,8,0,8,NA
202412,86571000,2,6,36,-30,0.17
202412,86571000,2S2,0,1,-1,0
202412,86571000,3,2,0,2,NA
202412,86571000,3S2,1,0,1,NA
202412,86571000,3S3,0,11,-11,0
202412,86573000,2,0,8,-8,0
202412,86573007,2,0,2,-2,0
202412,86749000,2,10,61,-51,0.16
202412,86749000,2S2,0,9,-9,0
202412,86749000,3S3,0,12,-12,0
202412,86749000,4,0,3,-3,0
202412,86749000,CA,6,23,-17,0.26
202412,86749006,2,0,1,-1,0
202412,86755000,2,4,24,-20,0.17
202412,86755000,3S2,1,0,1,NA
202412,86755000,3S3,1,2,-1,0.5
202412,86755000,CA,2,18,-16,0.11
202412,86757000,2,3,62,-59,0.05
202412,86757000,2S3,1,0,1,NA
202412,86757000,3,0,172,-172,0
202412,86757000,3S2,0,67,-67,0
202412,86757000,3S3,2,695,-693,0
202412,86757000,3S4,0,3,-3,0
202412,86757000,CA,1,17,-16,0.06
202412,86757001,2,0,5,-5,0
202412,86757001,CA,0,1,-1,0
202412,86760000,2,0,1,-1,0
202412,86760000,3S3,0,2,-2,0
202412,86760000,CA,3,14,-11,0.21
202412,86865000,2,38,607,-569,0.06
202412,86865000,2S2,0,1,-1,0
202412,86865000,2S3,0,2,-2,0
202412,86865000,3,11,8,3,1.38
202412,86865000,3S1,1,0,1,NA
202412,86865000,3S2,3,3,0,1
202412,86865000,3S3,0,57,-57,0
202412,86865000,3S4,1,0,1,NA
202412,86865000,CA,2,29,-27,0.07
202412,86865017,2,0,4,-4,0
202412,86865017,CA,0,18,-18,0
202412,86885000,2,22,126,-104,0.17
202412,86885000,2R3,0,1,-1,0
202412,86885000,2S3,0,5,-5,0
202412,86885000,3,20,118,-98,0.17
202412,86885000,3S2,113,4,109,28.25
202412,86885000,3S3,686,68,618,10.09
202412,86885000,CA,17,24,-7,0.71
202412,86885001,2,0,1,-1,0
202412,86885001,3,63,4,59,15.75
202412,86885001,3S2,12,1,11,12
202412,86885001,3S3,32,0,32,NA
202412,86885009,2,0,1,-1,0
202412,86885010,2,0,1,-1,0
202412,86885010,3,0,1,-1,0
202412,88001000,2,0,2,-2,0
202412,91001000,2,0,36,-36,0
202412,91001000,3S3,0,12,-12,0
202412,91001000,4,0,1,-1,0
202412,91001000,CA,3,0,3,NA
202412,91530000,2,0,1,-1,0
202412,91669000,2,0,1,-1,0
202412,94001000,2,0,18,-18,0
202412,94001000,3,0,3,-3,0
202412,94001000,3S3,0,5,-5,0
202412,94001000,CA,0,3,-3,0
202412,94884000,2,0,1,-1,0
202412,94884000,2S2,0,1,-1,0
202412,94884000,2S3,0,5,-5,0
202412,94884000,3S2,0,2,-2,0
202412,94884000,3S3,0,3,-3,0
202412,95001000,2,115,2181,-2066,0.05
202412,95001000,2S2,0,8,-8,0
202412,95001000,2S3,1,5,-4,0.2
202412,95001000,3,6,45,-39,0.13
202412,95001000,3S2,1,9,-8,0.11
202412,95001000,3S3,4,379,-375,0.01
202412,95001000,CA,19,205,-186,0.09
202412,95001000,V3,0,6,-6,0
202412,95001016,2,1,0,1,NA
202412,95015000,2,0,25,-25,0
202412,95015000,2S2,0,1,-1,0
202412,95015000,3,0,2,-2,0
202412,95015000,3S3,0,20,-20,0
202412,95015000,CA,0,2,-2,0
202412,95025000,2,0,27,-27,0
202412,95025000,3,0,1,-1,0
202412,95025000,3S3,0,4,-4,0
202412,95025000,CA,0,6,-6,0
202412,95025001,2,0,2,-2,0
202412,95025003,2,0,1,-1,0
202412,97001000,2,0,41,-41,0
202412,97001000,3,0,3,-3,0
202412,97001000,3S3,0,4,-4,0
202412,97001000,CA,0,7,-7,0
202412,97161000,3,0,1,-1,0
202412,99001000,2,19,52,-33,0.37
202412,99001000,3,2,27,-25,0.07
202412,99001000,3S2,0,7,-7,0
202412,99001000,3S3,0,47,-47,0
202412,99001000,4,0,3,-3,0
202412,99001000,CA,0,8,-8,0
202412,99524000,2,5,242,-237,0.02
202412,99524000,3,0,12,-12,0
202412,99524000,3S2,5,0,5,NA
202412,99524000,3S3,12,2,10,6
202412,99524000,CA,0,10,-10,0
202412,99524000,V2,0,1,-1,0
202412,99524001,2,0,1,-1,0
202412,99624000,2,2,34,-32,0.06
202412,99624000,3,2,7,-5,0.29
202412,99624000,3R3,1,0,1,NA
202412,99624000,3S2,4,0,4,NA
202412,99624000,3S3,19,1,18,19
202412,99624000,CA,0,5,-5,0
202412,99624000,V2,0,1,-1,0
202412,99624000,V3,0,1,-1,0
202412,99773000,2,5,14,-9,0.36
202412,99773000,3,2,14,-12,0.14
202412,99773000,3S3,40,8,32,5
202412,99773000,CA,0,5,-5,0
202412,99773000,V3R3,1,0,1,NA
202412,99773001,2,0,4,-4,0
202412,99773001,CA,0,1,-1,0
202412,99773002,2,1,1,0,1
202412,99773002,3S3,19,5,14,3.8
202412,99773002,CA,0,1,-1,0
202412,99773004,3S2,0,2,-2,0
202412,99773015,2,0,1,-1,0
202501,5001000,2,26741,33177,-6436,0.81
202501,5001000,2B1,0,6,-6,0
202501,5001000,2B2,1,11,-10,0.09
202501,5001000,2R2,5,21,-16,0.24
202501,5001000,2R3,1,47,-46,0.02
202501,5001000,2S1,0,14,-14,0
202501,5001000,2S2,1038,3022,-1984,0.34
202501,5001000,2S3,355,1449,-1094,0.24
202501,5001000,3,1268,813,455,1.56
202501,5001000,3S1,3,0,3,NA
202501,5001000,3S2,2395,2698,-303,0.89
202501,5001000,3S3,4113,7353,-3240,0.56
202501,5001000,3S4,0,9,-9,0
202501,5001000,4,9,83,-74,0.11
202501,5001000,CA,8688,14695,-6007,0.59
202501,5001000,V2,48,0,48,NA
202501,5001000,V3,49,347,-298,0.14
202501,5001001,2,2,27,-25,0.07
202501,5001001,2R2,0,2,-2,0
202501,5001001,CA,0,28,-28,0
202501,5001002,2,10,24,-14,0.42
202501,5001002,2S2,2,0,2,NA
202501,5001002,3,0,5,-5,0
202501,5001002,CA,0,5,-5,0
202501,5001003,2,6,7,-1,0.86
202501,5001003,3,1,3,-2,0.33
202501,5001003,3S2,1,0,1,NA
202501,5001003,3S3,6,6,0,1
202501,5001003,CA,0,3,-3,0
202501,5001004,2,4,8,-4,0.5
202501,5001004,2S2,1,0,1,NA
202501,5001004,3,1,0,1,NA
202501,5001004,CA,1,1,0,1
202501,5001009,CA,0,1,-1,0
202501,5001010,2,0,5,-5,0
202501,5002000,2,163,58,105,2.81
202501,5002000,2S2,1,13,-12,0.08
202501,5002000,3,2,19,-17,0.11
202501,5002000,CA,0,16,-16,0
202501,5002000,V2,168,1,167,168
202501,5002000,V3,0,2,-2,0
202501,5002010,2,0,69,-69,0
202501,5002010,3,0,17,-17,0
202501,5004000,2,0,9,-9,0
202501,5004000,3S3,22,0,22,NA
202501,5021000,2,5,13,-8,0.38
202501,5021000,3,0,5,-5,0
202501,5021000,3S2,0,6,-6,0
202501,5021000,3S3,15,0,15,NA
202501,5021000,CA,0,14,-14,0
202501,5030000,2,94,527,-433,0.18
202501,5030000,2S2,0,3,-3,0
202501,5030000,2S3,3,3,0,1
202501,5030000,3,13,80,-67,0.16
202501,5030000,3S2,21,16,5,1.31
202501,5030000,3S3,708,105,603,6.74
202501,5030000,CA,8,97,-89,0.08
202501,5030000,V3,210,0,210,NA
202501,5030011,3S3,37,0,37,NA
202501,5031000,2,10,72,-62,0.14
202501,5031000,2S2,0,13,-13,0
202501,5031000,3,2,8,-6,0.25
202501,5031000,3S2,0,9,-9,0
202501,5031000,3S3,4,5,-1,0.8
202501,5031000,CA,1,49,-48,0.02
202501,5031000,V3,8,4,4,2
202501,5031000,V4,9,0,9,NA
202501,5034000,2,57,179,-122,0.32
202501,5034000,3,1,17,-16,0.06
202501,5034000,3S2,1,0,1,NA
202501,5034000,3S3,48,95,-47,0.51
202501,5034000,4,1,2,-1,0.5
202501,5034000,CA,2,58,-56,0.03
202501,5034001,2,1,0,1,NA
202501,5034005,2,0,1,-1,0
202501,5034006,2,20,3,17,6.67
202501,5034007,2,10,0,10,NA
202501,5034007,3S3,0,4,-4,0
202501,5034007,4,0,1,-1,0
202501,5036000,2,15,8,7,1.88
202501,5036000,3,0,4,-4,0
202501,5036000,CA,1,4,-3,0.25
202501,5036000,V2,4,7,-3,0.57
202501,5036000,V3,106,0,106,NA
202501,5038000,2,13,38,-25,0.34
202501,5038000,3,2,26,-24,0.08
202501,5038000,3S3,1,4,-3,0.25
202501,5038000,4,2,1,1,2
202501,5038000,CA,0,12,-12,0
202501,5038008,2,6,9,-3,0.67
202501,5038008,3S3,2,10,-8,0.2
202501,5040000,2,2,57,-55,0.04
202501,5040000,3,0,1,-1,0
202501,5040000,3S2,3,6,-3,0.5
202501,5040000,3S3,0,3,-3,0
202501,5040000,CA,0,10,-10,0
202501,5040004,2,0,7,-7,0
202501,5040004,3S3,0,2,-2,0
202501,5040004,CA,0,5,-5,0
202501,5042000,2,56,285,-229,0.2
202501,5042000,2S2,1,1,0,1
202501,5042000,2S3,0,1,-1,0
202501,5042000,3,10,32,-22,0.31
202501,5042000,3S2,1,3,-2,0.33
202501,5042000,3S3,10,108,-98,0.09
202501,5042000,3S4,1,0,1,NA
202501,5042000,4,2,2,0,1
202501,5042000,CA,9,89,-80,0.1
202501,5042000,V2,0,3,-3,0
202501,5042001,2,0,2,-2,0
202501,5042001,CA,0,6,-6,0
202501,5044000,2,1,11,-10,0.09
202501,5044000,3,5,3,2,1.67
202501,5044000,3S3,9,0,9,NA
202501,5044000,CA,0,6,-6,0
202501,5044000,V2,0,1,-1,0
202501,5044001,3,8,2,6,4
202501,5045000,2,444,1539,-1095,0.29
202501,5045000,2B1,0,1,-1,0
202501,5045000,2B2,1,12,-11,0.08
202501,5045000,2R2,0,7,-7,0
202501,5045000,2S2,8,35,-27,0.23
202501,5045000,2S3,10,28,-18,0.36
202501,5045000,3,40,130,-90,0.31
202501,5045000,3S1,0,1,-1,0
202501,5045000,3S2,115,102,13,1.13
202501,5045000,3S3,152,772,-620,0.2
202501,5045000,3S4,1,1,0,1
202501,5045000,4,0,3,-3,0
202501,5045000,CA,181,344,-163,0.53
202501,5045009,2,0,1,-1,0
202501,5051000,2,20,113,-93,0.18
202501,5051000,2B2,0,2,-2,0
202501,5051000,3,1,6,-5,0.17
202501,5051000,3S2,1,1,0,1
202501,5051000,3S3,3,18,-15,0.17
202501,5051000,CA,2,26,-24,0.08
202501,5055000,2,2,20,-18,0.1
202501,5055000,3,0,5,-5,0
202501,5059000,2,20,119,-99,0.17
202501,5059000,2R3,0,1,-1,0
202501,5059000,2S2,1,7,-6,0.14
202501,5059000,2S3,0,4,-4,0
202501,5059000,3,1,1,0,1
202501,5059000,3S2,0,1,-1,0
202501,5059000,3S3,0,7,-7,0
202501,5059000,CA,1,41,-40,0.02
202501,5059002,2,0,1,-1,0
202501,5079000,2,1918,993,925,1.93
202501,5079000,2B1,10,0,10,NA
202501,5079000,2R2,3,0,3,NA
202501,5079000,2S2,419,49,370,8.55
202501,5079000,2S3,17,22,-5,0.77
202501,5079000,3,276,140,136,1.97
202501,5079000,3S1,4,1,3,4
202501,5079000,3S2,157,148,9,1.06
202501,5079000,3S3,1125,813,312,1.38
202501,5079000,4,11,5,6,2.2
202501,5079000,CA,108,615,-507,0.18
202501,5079000,V3,0,4,-4,0
202501,5079001,2,22,6,16,3.67
202501,5079001,2S2,8,0,8,NA
202501,5079001,2S3,2,0,2,NA
202501,5079001,3S3,6,9,-3,0.67
202501,5079001,CA,19,6,13,3.17
202501,5086000,2,18,28,-10,0.64
202501,5086000,2S2,0,4,-4,0
202501,5086000,3,0,23,-23,0
202501,5086000,3S2,0,1,-1,0
202501,5086000,3S3,0,1,-1,0
202501,5086000,CA,0,9,-9,0
202501,5086000,V3,0,6,-6,0
202501,5088000,2,2260,3540,-1280,0.64
202501,5088000,2R2,0,1,-1,0
202501,5088000,2R3,0,5,-5,0
202501,5088000,2S2,117,143,-26,0.82
202501,5088000,2S3,54,73,-19,0.74
202501,5088000,3,179,209,-30,0.86
202501,5088000,3S1,2,0,2,NA
202501,5088000,3S2,56,128,-72,0.44
202501,5088000,3S3,1716,2594,-878,0.66
202501,5088000,4,52,21,31,2.48
202501,5088000,CA,2159,1260,899,1.71
202501,5088000,V2,0,1,-1,0
202501,5088000,V3,262,78,184,3.36
202501,5088012,2,0,6,-6,0
202501,5088012,2S3,0,2,-2,0
202501,5088012,3S3,2,0,2,NA
202501,5088013,2,4,6,-2,0.67
202501,5088013,3S3,0,1,-1,0
202501,5088013,4,5,0,5,NA
202501,5091000,2,18,20,-2,0.9
202501,5091000,2S2,1,0,1,NA
202501,5091000,3,0,9,-9,0
202501,5091000,3S2,0,1,-1,0
202501,5091000,3S3,2,11,-9,0.18
202501,5091000,CA,0,6,-6,0
202501,5093000,2,3,22,-19,0.14
202501,5093000,3,0,3,-3,0
202501,5093000,3S3,43,24,19,1.79
202501,5093000,CA,0,4,-4,0
202501,5093000,V3,0,1,-1,0
202501,5093001,2,1,2,-1,0.5
202501,5093001,3,13,0,13,NA
202501,5101000,2,139,164,-25,0.85
202501,5101000,2S3,0,1,-1,0
202501,5101000,3,0,3,-3,0
202501,5101000,3S3,27,66,-39,0.41
202501,5101000,4,1,0,1,NA
202501,5101000,CA,87,53,34,1.64
202501,5107000,2,6,18,-12,0.33
202501,5107000,2S3,1,0,1,NA
202501,5107000,3S2,0,1,-1,0
202501,5107000,3S3,1,0,1,NA
202501,5107000,CA,0,7,-7,0
202501,5113000,2,16,88,-72,0.18
202501,5113000,3,2,34,-32,0.06
202501,5113000,3S2,2,80,-78,0.03
202501,5113000,3S3,92,34,58,2.71
202501,5113000,3S4,0,1,-1,0
202501,5113000,CA,0,13,-13,0
202501,5120000,2,6,2,4,3
202501,5120000,2S2,2,0,2,NA
202501,5120000,3,1,2,-1,0.5
202501,5120000,3S2,3,8,-5,0.38
202501,5120000,3S3,1,5,-4,0.2
202501,5120000,CA,0,9,-9,0
202501,5120002,2,1,1,0,1
202501,5120002,3,0,1,-1,0
202501,5120002,3S2,2,2,0,1
202501,5120002,3S3,0,1,-1,0
202501,5120003,3S3,1,0,1,NA
202501,5120004,2,1,30,-29,0.03
202501,5120004,2S2,0,1,-1,0
202501,5120004,3,0,1,-1,0
202501,5120004,3S3,4,2,2,2
202501,5120004,CA,1,71,-70,0.01
202501,5120006,2,0,8,-8,0
202501,5120006,2S3,0,1,-1,0
202501,5120006,3,1,0,1,NA
202501,5120010,2,0,2,-2,0
202501,5120010,3S3,0,1,-1,0
202501,5125000,2,0,16,-16,0
202501,5125000,3,77,7,70,11
202501,5125000,CA,0,17,-17,0
202501,5129000,2,2658,2167,491,1.23
202501,5129000,2R3,0,2,-2,0
202501,5129000,2S1,0,4,-4,0
202501,5129000,2S2,169,225,-56,0.75
202501,5129000,2S3,89,95,-6,0.94
202501,5129000,3,96,110,-14,0.87
202501,5129000,3S1,4,0,4,NA
202501,5129000,3S2,126,101,25,1.25
202501,5129000,3S3,830,350,480,2.37
202501,5129000,3S4,1,0,1,NA
202501,5129000,4,2,2,0,1
202501,5129000,CA,1642,458,1184,3.59
202501,5129000,V2,53,0,53,NA
202501,5129000,V3,28,39,-11,0.72
202501,5129005,2S2,1,4,-3,0.25
202501,5129005,3S2,10,10,0,1
202501,5129005,3S3,1,1,0,1
202501,5134000,2,3,41,-38,0.07
202501,5134000,3S2,1,0,1,NA
202501,5138000,2,21,87,-66,0.24
202501,5138000,2S2,5,0,5,NA
202501,5138000,3,6,17,-11,0.35
202501,5138000,3S2,2,3,-1,0.67
202501,5138000,3S3,9,9,0,1
202501,5138000,4,1,3,-2,0.33
202501,5138000,CA,1,9,-8,0.11
202501,5138000,V2,0,1,-1,0
202501,5138006,2,0,2,-2,0
202501,5142000,2,4,18,-14,0.22
202501,5142000,3,2,2,0,1
202501,5142000,3S3,1,1,0,1
202501,5142000,CA,0,8,-8,0
202501,5142003,2,0,3,-3,0
202501,5142003,3S3,0,1,-1,0
202501,5142003,CA,0,1,-1,0
202501,5142006,2,3,89,-86,0.03
202501,5142006,3S3,0,13,-13,0
202501,5145000,2,9,23,-14,0.39
202501,5145000,3,1,6,-5,0.17
202501,5145000,3S3,0,1,-1,0
202501,5145000,CA,0,11,-11,0
202501,5147000,2,84,271,-187,0.31
202501,5147000,2B2,0,3,-3,0
202501,5147000,2R2,5,0,5,NA
202501,5147000,2S2,8,2,6,4
202501,5147000,2S3,10,2,8,5
202501,5147000,3,7,31,-24,0.23
202501,5147000,3S2,16,14,2,1.14
202501,5147000,3S3,119,168,-49,0.71
202501,5147000,CA,53,75,-22,0.71
202501,5147004,2S3,11,0,11,NA
202501,5147004,3,1,0,1,NA
202501,5147004,3S2,2,0,2,NA
202501,5147004,3S3,35,0,35,NA
202501,5148000,2,1005,841,164,1.2
202501,5148000,2R2,0,1,-1,0
202501,5148000,2R3,0,1,-1,0
202501,5148000,2S2,91,49,42,1.86
202501,5148000,2S3,37,29,8,1.28
202501,5148000,3,10,30,-20,0.33
202501,5148000,3S2,31,34,-3,0.91
202501,5148000,3S3,32,137,-105,0.23
202501,5148000,CA,7,306,-299,0.02
202501,5148003,2S2,3,2,1,1.5
202501,5148005,2,0,1,-1,0
202501,5148005,2S3,0,4,-4,0
202501,5148010,2,0,1,-1,0
202501,5150000,2,28,30,-2,0.93
202501,5150000,3,1,5,-4,0.2
202501,5150000,3S2,1,0,1,NA
202501,5150000,V3,0,8,-8,0
202501,5154000,2,121,944,-823,0.13
202501,5154000,2B1,0,1,-1,0
202501,5154000,2B2,0,10,-10,0
202501,5154000,2R2,0,1,-1,0
202501,5154000,2S2,1,18,-17,0.06
202501,5154000,2S3,2,18,-16,0.11
202501,5154000,3,16,89,-73,0.18
202501,5154000,3S2,15,45,-30,0.33
202501,5154000,3S2S3,0,1,-1,0
202501,5154000,3S3,115,646,-531,0.18
202501,5154000,3S4,0,1,-1,0
202501,5154000,4,0,1,-1,0
202501,5154000,CA,26,225,-199,0.12
202501,5154007,2,0,3,-3,0
202501,5154010,2,0,1,-1,0
202501,5154015,3S3,21,16,5,1.31
202501,5154023,2,1,2,-1,0.5
202501,5154023,2S2,0,1,-1,0
202501,5154023,3S2,3,1,2,3
202501,5154023,3S3,2,1,1,2
202501,5172000,2,147,282,-135,0.52
202501,5172000,2B2,0,13,-13,0
202501,5172000,2R2,0,1,-1,0
202501,5172000,2S2,0,4,-4,0
202501,5172000,2S3,4,4,0,1
202501,5172000,3,6,51,-45,0.12
202501,5172000,3S2,3,9,-6,0.33
202501,5172000,3S3,97,162,-65,0.6
202501,5172000,CA,6,78,-72,0.08
202501,5172003,2,0,1,-1,0
202501,5190000,2,7,49,-42,0.14
202501,5190000,3,1,0,1,NA
202501,5190000,3S2,0,3,-3,0
202501,5190000,3S3,3,18,-15,0.17
202501,5190000,CA,2,40,-38,0.05
202501,5197000,2,8,24,-16,0.33
202501,5197000,2S2,0,1,-1,0
202501,5197000,2S3,0,1,-1,0
202501,5197000,3,0,2,-2,0
202501,5197000,3S3,0,6,-6,0
202501,5197000,CA,0,22,-22,0
202501,5197005,3S2,1,0,1,NA
202501,5206000,2,60,56,4,1.07
202501,5206000,3,0,6,-6,0
202501,5206000,CA,0,2,-2,0
202501,5209000,2,6,32,-26,0.19
202501,5209000,2S3,0,1,-1,0
202501,5209000,3,9,4,5,2.25
202501,5209000,3S2,1,1,0,1
202501,5209000,3S3,33,51,-18,0.65
202501,5209000,CA,0,19,-19,0
202501,5209004,3S3,29,6,23,4.83
202501,5212000,2,1403,1304,99,1.08
202501,5212000,2R3,0,6,-6,0
202501,5212000,2S2,545,265,280,2.06
202501,5212000,2S3,88,108,-20,0.81
202501,5212000,3,9,88,-79,0.1
202501,5212000,3S1,2,0,2,NA
202501,5212000,3S2,161,164,-3,0.98
202501,5212000,3S3,384,326,58,1.18
202501,5212000,4,1,15,-14,0.07
202501,5212000,CA,420,788,-368,0.53
202501,5234000,2,3,46,-43,0.07
202501,5234000,3,0,20,-20,0
202501,5234000,3S2,1,1,0,1
202501,5234000,3S3,4,39,-35,0.1
202501,5234000,CA,2,15,-13,0.13
202501,5234000,V3,0,5,-5,0
202501,5234009,2,0,20,-20,0
202501,5234009,CA,0,9,-9,0
202501,5237000,2,149,345,-196,0.43
202501,5237000,2S2,0,3,-3,0
202501,5237000,2S3,0,1,-1,0
202501,5237000,3,3,59,-56,0.05
202501,5237000,3S2,0,1,-1,0
202501,5237000,3S3,0,127,-127,0
202501,5237000,CA,1,32,-31,0.03
202501,5237000,V3,0,91,-91,0
202501,5237001,2,3,1,2,3
202501,5240000,2,2,8,-6,0.25
202501,5240000,3,0,4,-4,0
202501,5240000,4,1,2,-1,0.5
202501,5240000,CA,0,9,-9,0
202501,5240000,V3,0,1,-1,0
202501,5240003,2,0,10,-10,0
202501,5240007,3S3,1,1,0,1
202501,5240007,CA,0,2,-2,0
202501,5250000,2,17,184,-167,0.09
202501,5250000,2S2,0,3,-3,0
202501,5250000,2S3,0,1,-1,0
202501,5250000,3,1,21,-20,0.05
202501,5250000,3S2,7,14,-7,0.5
202501,5250000,3S3,7,115,-108,0.06
202501,5250000,4,0,2,-2,0
202501,5250000,CA,2,43,-41,0.05
202501,5250000,V3,0,3,-3,0
202501,5250002,3S2,1,3,-2,0.33
202501,5264000,2,234,331,-97,0.71
202501,5264000,2R3,0,1,-1,0
202501,5264000,2S2,5,17,-12,0.29
202501,5264000,2S3,1,1,0,1
202501,5264000,3,8,15,-7,0.53
202501,5264000,3S2,39,16,23,2.44
202501,5264000,3S3,24,150,-126,0.16
202501,5264000,CA,4,68,-64,0.06
202501,5264000,V2,0,6,-6,0
202501,5264000,V3,0,5,-5,0
202501,5266000,2,8221,3535,4686,2.33
202501,5266000,2R3,0,6,-6,0
202501,5266000,2S1,0,1,-1,0
202501,5266000,2S2,1250,467,783,2.68
202501,5266000,2S3,668,174,494,3.84
202501,5266000,3,65,115,-50,0.57
202501,5266000,3S2,182,215,-33,0.85
202501,5266000,3S3,458,1279,-821,0.36
202501,5266000,4,0,3,-3,0
202501,5266000,CA,1465,1332,133,1.1
202501,5266001,2,24,82,-58,0.29
202501,5266001,3,1,1,0,1
202501,5266001,3S2,2,1,1,2
202501,5266001,3S3,0,1,-1,0
202501,5266001,CA,0,19,-19,0
202501,5282000,2,58,138,-80,0.42
202501,5282000,2S2,0,14,-14,0
202501,5282000,3,13,2,11,6.5
202501,5282000,3S3,1,4,-3,0.25
202501,5282000,4,5,0,5,NA
202501,5282000,CA,0,32,-32,0
202501,5282000,V2,0,5,-5,0
202501,5282004,2,0,3,-3,0
202501,5282004,3S2,13,1,12,13
202501,5282005,CA,0,1,-1,0
202501,5284000,2,11,223,-212,0.05
202501,5284000,2S2,0,1,-1,0
202501,5284000,3,1,16,-15,0.06
202501,5284000,3S3,8,25,-17,0.32
202501,5284000,CA,3,48,-45,0.06
202501,5284000,V3,0,3,-3,0
202501,5284006,2,0,2,-2,0
202501,5306000,2,8,32,-24,0.25
202501,5306000,3,2,2,0,1
202501,5306000,3S3,2,8,-6,0.25
202501,5306000,4,0,1,-1,0
202501,5306000,CA,0,2,-2,0
202501,5306000,V2,0,1,-1,0
202501,5306000,V3,0,1,-1,0
202501,5308000,2,7802,2685,5117,2.91
202501,5308000,2R2,5,6,-1,0.83
202501,5308000,2R3,0,2,-2,0
202501,5308000,2S1,4,0,4,NA
202501,5308000,2S2,201,600,-399,0.34
202501,5308000,2S3,109,124,-15,0.88
202501,5308000,3,616,141,475,4.37
202501,5308000,3S2,291,440,-149,0.66
202501,5308000,3S3,2342,3354,-1012,0.7
202501,5308000,3S3S2,3,0,3,NA
202501,5308000,3S4,1,0,1,NA
202501,5308000,4,54,7,47,7.71
202501,5308000,CA,2740,535,2205,5.12
202501,5308000,V2,0,3,-3,0
202501,5308000,V3,187,258,-71,0.72
202501,5308000,V4,6,56,-50,0.11
202501,5308002,3S3,5,0,5,NA
202501,5308012,2,0,1,-1,0
202501,5310000,2,83,24,59,3.46
202501,5310000,3,0,7,-7,0
202501,5310000,3S2,0,1,-1,0
202501,5310000,3S3,0,9,-9,0
202501,5310000,CA,22,26,-4,0.85
202501,5310000,V3,0,2,-2,0
202501,5310003,2,1186,332,854,3.57
202501,5310003,2R3,0,8,-8,0
202501,5310003,2S2,26,53,-27,0.49
202501,5310003,2S3,35,68,-33,0.51
202501,5310003,3,3,3,0,1
202501,5310003,3S2,2,7,-5,0.29
202501,5310003,3S3,13,82,-69,0.16
202501,5310003,CA,247,20,227,12.35
202501,5313000,2,4,30,-26,0.13
202501,5313000,2S2,0,23,-23,0
202501,5313000,3,1,1,0,1
202501,5313000,3S2,1,0,1,NA
202501,5313000,3S3,3,0,3,NA
202501,5313000,CA,2,35,-33,0.06
202501,5315000,2,14,10,4,1.4
202501,5315000,3,3,2,1,1.5
202501,5315000,3S2,2,0,2,NA
202501,5315000,3S3,1,0,1,NA
202501,5315000,CA,0,4,-4,0
202501,5318000,2,6083,2320,3763,2.62
202501,5318000,2R2,1,9,-8,0.11
202501,5318000,2R3,0,3,-3,0
202501,5318000,2S1,10,1,9,10
202501,5318000,2S2,215,272,-57,0.79
202501,5318000,2S3,67,83,-16,0.81
202501,5318000,3,263,97,166,2.71
202501,5318000,3S2,205,181,24,1.13
202501,5318000,3S3,1373,861,512,1.59
202501,5318000,4,3,1,2,3
202501,5318000,CA,728,588,140,1.24
202501,5318000,V2,0,193,-193,0
202501,5318000,V3,0,2,-2,0
202501,5318003,2,292,2,290,146
202501,5318003,2R2,1,0,1,NA
202501,5318003,2S1,6,0,6,NA
202501,5318003,2S2,127,0,127,NA
202501,5318003,3S2,19,0,19,NA
202501,5318003,3S3,215,0,215,NA
202501,5321000,2,4,129,-125,0.03
202501,5321000,2S2,0,25,-25,0
202501,5321000,3,1,3,-2,0.33
202501,5321000,3S2,2,0,2,NA
202501,5321000,3S3,0,2,-2,0
202501,5321000,CA,3,54,-51,0.06
202501,5321002,CA,0,1,-1,0
202501,5347000,2,5,11,-6,0.45
202501,5347000,3,1,13,-12,0.08
202501,5347000,CA,0,7,-7,0
202501,5347008,CA,0,1,-1,0
202501,5353000,2,2,55,-53,0.04
202501,5353000,3S2,0,5,-5,0
202501,5353000,3S3,1,9,-8,0.11
202501,5353000,CA,0,6,-6,0
202501,5353000,V2,0,1,-1,0
202501,5360000,2,12835,6492,6343,1.98
202501,5360000,2B1,0,4,-4,0
202501,5360000,2R2,7,2,5,3.5
202501,5360000,2R3,0,25,-25,0
202501,5360000,2S1,44,5,39,8.8
202501,5360000,2S2,376,368,8,1.02
202501,5360000,2S3,109,262,-153,0.42
202501,5360000,3,342,283,59,1.21
202501,5360000,3S1,0,4,-4,0
202501,5360000,3S2,155,333,-178,0.47
202501,5360000,3S3,2017,4846,-2829,0.42
202501,5360000,4,2,27,-25,0.07
202501,5360000,CA,4120,1449,2671,2.84
202501,5360001,2,0,1,-1,0
202501,5360001,2S2,1,3,-2,0.33
202501,5360001,2S3,2,5,-3,0.4
202501,5360001,3S3,0,1,-1,0
202501,5360001,CA,1,3,-2,0.33
202501,5360003,2,0,7,-7,0
202501,5360006,2,0,72,-72,0
202501,5360006,CA,0,1,-1,0
202501,5360010,2,0,1,-1,0
202501,5361000,2,21,75,-54,0.28
202501,5361000,2S2,3,6,-3,0.5
202501,5361000,2S3,0,1,-1,0
202501,5361000,3,2,12,-10,0.17
202501,5361000,3S2,0,12,-12,0
202501,5361000,3S3,4,22,-18,0.18
202501,5361000,3S4,0,1,-1,0
202501,5361000,CA,1,28,-27,0.04
202501,5361000,V3,5,0,5,NA
202501,5364000,2,19,274,-255,0.07
202501,5364000,2S2,0,3,-3,0
202501,5364000,2S3,1,1,0,1
202501,5364000,3,5,27,-22,0.19
202501,5364000,3S2,20,1,19,20
202501,5364000,3S3,152,45,107,3.38
202501,5364000,4,0,1,-1,0
202501,5364000,CA,1,89,-88,0.01
202501,5368000,2,49,43,6,1.14
202501,5368000,2S2,0,24,-24,0
202501,5368000,3,0,6,-6,0
202501,5368000,3S2,1,0,1,NA
202501,5368000,3S3,22,2,20,11
202501,5368000,CA,1,27,-26,0.04
202501,5368007,3S3,0,3,-3,0
202501,5376000,2,1587,1575,12,1.01
202501,5376000,2R3,0,1,-1,0
202501,5376000,2S2,8,7,1,1.14
202501,5376000,2S3,8,7,1,1.14
202501,5376000,3,41,39,2,1.05
202501,5376000,3S1,0,1,-1,0
202501,5376000,3S2,16,4,12,4
202501,5376000,3S3,81,222,-141,0.36
202501,5376000,CA,58,442,-384,0.13
202501,5380000,2,10617,2747,7870,3.86
202501,5380000,2R2,49,2,47,24.5
202501,5380000,2S2,466,438,28,1.06
202501,5380000,2S3,54,86,-32,0.63
202501,5380000,3,49,104,-55,0.47
202501,5380000,3S2,265,337,-72,0.79
202501,5380000,3S3,446,963,-517,0.46
202501,5380000,4,1,1,0,1
202501,5380000,CA,4740,1042,3698,4.55
202501,5380000,V3,4,20,-16,0.2
202501,5380001,2,9,16,-7,0.56
202501,5380001,2S2,0,1,-1,0
202501,5380001,2S3,1,0,1,NA
202501,5380001,3,0,1,-1,0
202501,5380001,3S2,2,0,2,NA
202501,5380001,CA,5,8,-3,0.62
202501,5380005,2,77,32,45,2.41
202501,5380005,2S2,10,13,-3,0.77
202501,5380005,2S3,1,8,-7,0.12
202501,5380005,3,13,0,13,NA
202501,5380005,3S2,3,5,-2,0.6
202501,5380005,3S3,23,26,-3,0.88
202501,5380005,4,4,0,4,NA
202501,5380005,CA,2,2,0,1
202501,5380010,3S3,0,3,-3,0
202501,5390000,2,62,66,-4,0.94
202501,5390000,3,1,10,-9,0.1
202501,5390000,3S2,3,4,-1,0.75
202501,5390000,3S3,7,15,-8,0.47
202501,5390000,CA,2,23,-21,0.09
202501,5400000,2,180,349,-169,0.52
202501,5400000,2S2,2,2,0,1
202501,5400000,2S3,1,3,-2,0.33
202501,5400000,3,32,22,10,1.45
202501,5400000,3S2,4,8,-4,0.5
202501,5400000,3S3,171,99,72,1.73
202501,5400000,4,4,0,4,NA
202501,5400000,CA,6,246,-240,0.02
202501,5400000,V3,260,11,249,23.64
202501,5400000,V4,24,0,24,NA
202501,5400001,2,1,4,-3,0.25
202501,5400001,3,0,1,-1,0
202501,5400001,3S3,0,1,-1,0
202501,5400001,CA,1,0,1,NA
202501,5411000,2,10,21,-11,0.48
202501,5411000,3,1,4,-3,0.25
202501,5411000,CA,0,7,-7,0
202501,5411001,2,0,4,-4,0
202501,5411007,2,1,0,1,NA
202501,5411008,2,0,2,-2,0
202501,5411008,3S3,2,0,2,NA
202501,5425000,2,70,59,11,1.19
202501,5425000,3,4,44,-40,0.09
202501,5425000,3S2,0,9,-9,0
202501,5425000,3S3,13,3,10,4.33
202501,5425000,4,0,14,-14,0
202501,5425000,CA,2,8,-6,0.25
202501,5425000,V3,0,20,-20,0
202501,5425005,2,4,4,0,1
202501,5425005,3,1,1,0,1
202501,5425005,3S2,1,1,0,1
202501,5425005,3S3,49,1,48,49
202501,5425005,CA,0,1,-1,0
202501,5440000,2,1778,1015,763,1.75
202501,5440000,2R2,0,10,-10,0
202501,5440000,2R3,0,1,-1,0
202501,5440000,2S2,2,6,-4,0.33
202501,5440000,2S3,4,10,-6,0.4
202501,5440000,3,66,33,33,2
202501,5440000,3S2,32,22,10,1.45
202501,5440000,3S3,82,470,-388,0.17
202501,5440000,3S4,1,0,1,NA
202501,5440000,4,1,0,1,NA
202501,5440000,CA,113,395,-282,0.29
202501,5440000,V3,2,28,-26,0.07
202501,5440001,2,0,3,-3,0
202501,5440001,CA,0,1,-1,0
202501,5467000,2,17,6,11,2.83
202501,5467000,2S2,0,6,-6,0
202501,5467000,3,3,1,2,3
202501,5467000,3S3,1,0,1,NA
202501,5467000,CA,1,15,-14,0.07
202501,5480000,2,7,69,-62,0.1
202501,5480000,2S3,1,0,1,NA
202501,5480000,3,0,3,-3,0
202501,5480000,3S2,0,1,-1,0
202501,5480000,3S3,1,44,-43,0.02
202501,5480000,CA,1,15,-14,0.07
202501,5480004,2,0,2,-2,0
202501,5480004,3S2,2,0,2,NA
202501,5480004,3S3,2,0,2,NA
202501,5480006,2,1,0,1,NA
202501,5483000,2,3,21,-18,0.14
202501,5483000,3,0,9,-9,0
202501,5483000,3S2,0,1,-1,0
202501,5483000,3S3,0,2,-2,0
202501,5483000,CA,0,5,-5,0
202501,5490000,2,33,257,-224,0.13
202501,5490000,2R2,1,0,1,NA
202501,5490000,2S3,0,1,-1,0
202501,5490000,3,6,8,-2,0.75
202501,5490000,3S2,0,2,-2,0
202501,5490000,3S3,6,16,-10,0.38
202501,5490000,CA,0,48,-48,0
202501,5490001,2,0,1,-1,0
202501,5490005,2,0,1,-1,0
202501,5495000,2,6,75,-69,0.08
202501,5495000,3,0,8,-8,0
202501,5495000,3S2,4,8,-4,0.5
202501,5495000,3S3,4,15,-11,0.27
202501,5495000,CA,0,8,-8,0
202501,5495002,3,0,1,-1,0
202501,5501000,2,1,2,-1,0.5
202501,5501000,3S3,0,3,-3,0
202501,5541000,2,4,47,-43,0.09
202501,5541000,2S2,0,26,-26,0
202501,5541000,3,0,3,-3,0
202501,5541000,3S2,0,3,-3,0
202501,5541000,CA,3,31,-28,0.1
202501,5541001,2,6,22,-16,0.27
202501,5541001,3,0,6,-6,0
202501,5541001,3S3,0,1,-1,0
202501,5541001,CA,0,15,-15,0
202501,5543000,2,6,12,-6,0.5
202501,5543000,3,3,1,2,3
202501,5543000,CA,1,0,1,NA
202501,5576000,2,21,5,16,4.2
202501,5576000,3,0,2,-2,0
202501,5576000,3S3,11,4,7,2.75
202501,5576000,CA,1,13,-12,0.08
202501,5579000,2,76,286,-210,0.27
202501,5579000,2S2,2,0,2,NA
202501,5579000,3,16,104,-88,0.15
202501,5579000,3S2,5,1,4,5
202501,5579000,3S3,224,119,105,1.88
202501,5579000,CA,114,98,16,1.16
202501,5579000,V3,0,6,-6,0
202501,5579005,2,0,4,-4,0
202501,5585000,2,2,63,-61,0.03
202501,5585000,3,4,6,-2,0.67
202501,5585000,3S2,3,0,3,NA
202501,5585000,3S3,208,33,175,6.3
202501,5585000,4,0,1,-1,0
202501,5585000,CA,4,31,-27,0.13
202501,5585000,V3,1,7,-6,0.14
202501,5585003,2,1,3,-2,0.33
202501,5585003,3S3,0,6,-6,0
202501,5585003,CA,1,16,-15,0.06
202501,5585004,2,67,18,49,3.72
202501,5585004,2S2,1,0,1,NA
202501,5585004,3,1,1,0,1
202501,5585004,3S2,2,0,2,NA
202501,5585004,CA,4,9,-5,0.44
202501,5591000,2,25,120,-95,0.21
202501,5591000,2S2,1,1,0,1
202501,5591000,3,30,41,-11,0.73
202501,5591000,3S2,4,3,1,1.33
202501,5591000,3S3,805,282,523,2.85
202501,5591000,CA,7,44,-37,0.16
202501,5591000,V3,0,19,-19,0
202501,5591000,V4,0,6,-6,0
202501,5591002,2,0,2,-2,0
202501,5591002,CA,2,0,2,NA
202501,5591004,2,47,47,0,1
202501,5591004,2S3,1,0,1,NA
202501,5591004,3,2,3,-1,0.67
202501,5591004,3S2,8,0,8,NA
202501,5591004,3S3,414,16,398,25.88
202501,5591004,4,1,0,1,NA
202501,5591004,CA,8,48,-40,0.17
202501,5591004,V3,2,3,-1,0.67
202501,5604000,2,6,93,-87,0.06
202501,5604000,2S2,1,0,1,NA
202501,5604000,2S3,1,1,0,1
202501,5604000,3,0,60,-60,0
202501,5604000,3S2,3,11,-8,0.27
202501,5604000,3S3,3,51,-48,0.06
202501,5604000,CA,2,19,-17,0.11
202501,5604000,V3,0,9,-9,0
202501,5604001,3S2,1,0,1,NA
202501,5604003,3S3,0,1,-1,0
202501,5604003,CA,0,1,-1,0
202501,5604005,3S2,0,10,-10,0
202501,5607000,2,264,455,-191,0.58
202501,5607000,2R2,0,15,-15,0
202501,5607000,2S2,3,0,3,NA
202501,5607000,3,8,23,-15,0.35
202501,5607000,3S2,14,3,11,4.67
202501,5607000,3S3,57,69,-12,0.83
202501,5607000,CA,3,232,-229,0.01
202501,5607004,2,4,0,4,NA
202501,5607008,2,0,1,-1,0
202501,5607008,CA,0,6,-6,0
202501,5615000,2,6396,7118,-722,0.9
202501,5615000,2B1,3,1,2,3
202501,5615000,2R2,8,9,-1,0.89
202501,5615000,2R3,0,8,-8,0
202501,5615000,2S1,30,0,30,NA
202501,5615000,2S2,594,554,40,1.07
202501,5615000,2S3,183,259,-76,0.71
202501,5615000,3,158,193,-35,0.82
202501,5615000,3S2,558,628,-70,0.89
202501,5615000,3S3,980,2763,-1783,0.35
202501,5615000,3S4,2,1,1,2
202501,5615000,4,1,1,0,1
202501,5615000,CA,2274,2290,-16,0.99
202501,5615000,V3,0,8,-8,0
202501,5615010,2,2,6,-4,0.33
202501,5615010,CA,2,7,-5,0.29
202501,5615011,2,0,1,-1,0
202501,5615012,2,0,1,-1,0
202501,5615013,2,0,2,-2,0
202501,5628000,2,3,25,-22,0.12
202501,5628000,3,2,4,-2,0.5
202501,5628000,3S2,0,1,-1,0
202501,5628000,3S3,0,1,-1,0
202501,5628000,CA,0,17,-17,0
202501,5628000,V2,0,2,-2,0
202501,5628001,2,4,2,2,2
202501,5628001,3,1,1,0,1
202501,5628001,3S3,1,0,1,NA
202501,5628002,2,0,1,-1,0
202501,5631000,2,4325,2266,2059,1.91
202501,5631000,2R3,0,10,-10,0
202501,5631000,2S2,49,100,-51,0.49
202501,5631000,2S3,43,99,-56,0.43
202501,5631000,3,378,198,180,1.91
202501,5631000,3S2,169,369,-200,0.46
202501,5631000,3S3,514,790,-276,0.65
202501,5631000,4,0,8,-8,0
202501,5631000,CA,2727,857,1870,3.18
202501,5631000,V2,0,27,-27,0
202501,5631000,V3,16,190,-174,0.08
202501,5631000,V4,0,18,-18,0
202501,5631002,2,0,3,-3,0
202501,5631009,CA,0,1,-1,0
202501,5642000,2,5,34,-29,0.15
202501,5642000,2S2,0,1,-1,0
202501,5642000,3,1,28,-27,0.04
202501,5642000,3S2,2,7,-5,0.29
202501,5642000,3S3,99,42,57,2.36
202501,5642000,CA,0,14,-14,0
202501,5642010,2,0,1,-1,0
202501,5647000,2,5,13,-8,0.38
202501,5647000,3,2,11,-9,0.18
202501,5647000,3S2,0,4,-4,0
202501,5647000,3S3,1,12,-11,0.08
202501,5647000,4,1,0,1,NA
202501,5647000,CA,0,2,-2,0
202501,5647000,V3,0,1,-1,0
202501,5649000,2,8,82,-74,0.1
202501,5649000,2S2,0,14,-14,0
202501,5649000,3,0,11,-11,0
202501,5649000,3S2,0,1,-1,0
202501,5649000,3S3,0,1,-1,0
202501,5649000,CA,0,82,-82,0
202501,5649000,V3,0,3,-3,0
202501,5649001,CA,0,15,-15,0
202501,5649005,CA,0,1,-1,0
202501,5649012,2,0,3,-3,0
202501,5649012,2S2,0,1,-1,0
202501,5649012,CA,0,2,-2,0
202501,5652000,2,1,3,-2,0.33
202501,5652000,3,0,7,-7,0
202501,5652000,3S2,0,4,-4,0
202501,5652000,3S3,487,269,218,1.81
202501,5652000,CA,0,1,-1,0
202501,5652000,V3,0,2,-2,0
202501,5652000,V4,0,2,-2,0
202501,5652010,2,3,0,3,NA
202501,5652010,3,39,0,39,NA
202501,5652010,3S2,10,0,10,NA
202501,5652010,3S3,279,47,232,5.94
202501,5652010,V3,18,0,18,NA
202501,5656000,2,10,109,-99,0.09
202501,5656000,3,3,7,-4,0.43
202501,5656000,3S3,1,3,-2,0.33
202501,5656000,CA,1,48,-47,0.02
202501,5656000,V2,0,4,-4,0
202501,5656000,V3,0,2,-2,0
202501,5658000,2,1,14,-13,0.07
202501,5658000,3,1,0,1,NA
202501,5658000,3S2,0,1,-1,0
202501,5658000,3S3,0,18,-18,0
202501,5658000,CA,0,1,-1,0
202501,5658000,V3,0,1,-1,0
202501,5659000,2,9,44,-35,0.2
202501,5659000,2S2,1,1,0,1
202501,5659000,3,0,5,-5,0
202501,5659000,3S2,106,7,99,15.14
202501,5659000,3S3,13,12,1,1.08
202501,5659000,CA,0,6,-6,0
202501,5659001,3S2,2,0,2,NA
202501,5660000,2,8,42,-34,0.19
202501,5660000,2S2,0,12,-12,0
202501,5660000,3,2,3,-1,0.67
202501,5660000,3S2,1,1,0,1
202501,5660000,3S3,3,4,-1,0.75
202501,5660000,CA,3,63,-60,0.05
202501,5660000,V3,0,1,-1,0
202501,5660012,2,0,3,-3,0
202501,5660012,2S2,5,3,2,1.67
202501,5660012,2S3,1,0,1,NA
202501,5660012,3S3,14,0,14,NA
202501,5660012,CA,0,1,-1,0
202501,5660013,2,0,3,-3,0
202501,5660013,CA,0,4,-4,0
202501,5664000,2,198,735,-537,0.27
202501,5664000,2R2,0,1,-1,0
202501,5664000,2S2,0,2,-2,0
202501,5664000,2S3,0,6,-6,0
202501,5664000,3,54,40,14,1.35
202501,5664000,3S2,156,73,83,2.14
202501,5664000,3S3,433,508,-75,0.85
202501,5664000,4,34,0,34,NA
202501,5664000,CA,1,120,-119,0.01
202501,5664000,V2,0,1,-1,0
202501,5664005,2,0,12,-12,0
202501,5664005,3S3,0,11,-11,0
202501,5665000,2,21,97,-76,0.22
202501,5665000,3,0,34,-34,0
202501,5665000,3S2,0,1,-1,0
202501,5665000,3S3,0,5,-5,0
202501,5665000,4,0,1,-1,0
202501,5665000,CA,2,18,-16,0.11
202501,5667000,2,4,67,-63,0.06
202501,5667000,2S2,0,12,-12,0
202501,5667000,3,0,4,-4,0
202501,5667000,3S2,0,1,-1,0
202501,5667000,CA,0,22,-22,0
202501,5667000,V3,0,2,-2,0
202501,5670000,2,12,35,-23,0.34
202501,5670000,2S2,0,1,-1,0
202501,5670000,3,1,1,0,1
202501,5670000,3S2,1,0,1,NA
202501,5670000,3S3,4,0,4,NA
202501,5670000,CA,0,11,-11,0
202501,5670003,2,72,2,70,36
202501,5670003,3S3,3,0,3,NA
202501,5674000,2,14,94,-80,0.15
202501,5674000,3,9,7,2,1.29
202501,5674000,3S2,1,0,1,NA
202501,5674000,3S3,0,4,-4,0
202501,5674000,CA,0,49,-49,0
202501,5674001,2,0,1,-1,0
202501,5679000,2,9,35,-26,0.26
202501,5679000,3S2,10,0,10,NA
202501,5679000,3S3,1,1,0,1
202501,5679000,CA,1,37,-36,0.03
202501,5679000,V2,0,4,-4,0
202501,5679002,2,1,0,1,NA
202501,5679004,2,0,2,-2,0
202501,5679009,3S3,0,1,-1,0
202501,5686000,2,543,709,-166,0.77
202501,5686000,2S2,0,1,-1,0
202501,5686000,2S3,0,3,-3,0
202501,5686000,3,22,116,-94,0.19
202501,5686000,3S2,90,20,70,4.5
202501,5686000,3S3,355,610,-255,0.58
202501,5686000,CA,9,101,-92,0.09
202501,5686000,V3,0,58,-58,0
202501,5686001,2,0,8,-8,0
202501,5686001,3,0,5,-5,0
202501,5686004,2,5,1,4,5
202501,5686006,2,2,1,1,2
202501,5686011,2,0,3,-3,0
202501,5686011,2R2,0,1,-1,0
202501,5686011,3,0,1,-1,0
202501,5686011,3S3,14,4,10,3.5
202501,5690000,2,109,76,33,1.43
202501,5690000,2S2,0,1,-1,0
202501,5690000,3,10,25,-15,0.4
202501,5690000,3S3,29,8,21,3.62
202501,5690000,CA,2,6,-4,0.33
202501,5690001,2,145,13,132,11.15
202501,5690001,CA,0,1,-1,0
202501,5690003,2,0,1,-1,0
202501,5690004,2,0,21,-21,0
202501,5690004,2S2,0,1,-1,0
202501,5690004,3S3,0,2,-2,0
202501,5690004,CA,0,2,-2,0
202501,5690010,2,3,1,2,3
202501,5690010,3,1,2,-1,0.5
202501,5690010,3S2,1,0,1,NA
202501,5697000,2,86,445,-359,0.19
202501,5697000,2R3,0,1,-1,0
202501,5697000,2S2,0,7,-7,0
202501,5697000,2S3,1,6,-5,0.17
202501,5697000,3,7,34,-27,0.21
202501,5697000,3S2,4,0,4,NA
202501,5697000,3S3,62,144,-82,0.43
202501,5697000,CA,2,221,-219,0.01
202501,5736000,2,17,378,-361,0.04
202501,5736000,2S2,3,0,3,NA
202501,5736000,2S3,1,0,1,NA
202501,5736000,3,4,89,-85,0.04
202501,5736000,3S2,10,6,4,1.67
202501,5736000,3S3,1,13,-12,0.08
202501,5736000,4,0,2,-2,0
202501,5736000,CA,1,98,-97,0.01
202501,5736000,V3,5,8,-3,0.62
202501,5736001,3,0,1,-1,0
202501,5736002,3S2,0,4,-4,0
202501,5736002,3S3,0,1,-1,0
202501,5756000,2,273,296,-23,0.92
202501,5756000,3,197,23,174,8.57
202501,5756000,3S2,553,5,548,110.6
202501,5756000,3S3,2293,633,1660,3.62
202501,5756000,4,2,0,2,NA
202501,5756000,CA,4,84,-80,0.05
202501,5756000,V3,62,8,54,7.75
202501,5756005,CA,1,4,-3,0.25
202501,5756030,2,5,1,4,5
202501,5756030,3,1,1,0,1
202501,5756030,3S3,19,2,17,9.5
202501,5756030,CA,0,5,-5,0
202501,5756033,3,40,0,40,NA
202501,5756033,3S2,13,0,13,NA
202501,5756033,3S3,551,107,444,5.15
202501,5756033,V3,32,0,32,NA
202501,5761000,2,8,66,-58,0.12
202501,5761000,3,9,4,5,2.25
202501,5761000,3S3,6,3,3,2
202501,5761000,4,1,0,1,NA
202501,5761000,CA,0,34,-34,0
202501,5761000,V2,0,3,-3,0
202501,5761002,2,1,0,1,NA
202501,5761002,2S2,2,0,2,NA
202501,5761002,2S3,3,1,2,3
202501,5761004,2,0,1,-1,0
202501,5789000,2,219,107,112,2.05
202501,5789000,2S2,0,22,-22,0
202501,5789000,3,0,10,-10,0
202501,5789000,3S3,2,3,-1,0.67
202501,5789000,CA,2,35,-33,0.06
202501,5789002,2,1,2,-1,0.5
202501,5789005,CA,0,1,-1,0
202501,5790000,2,5,80,-75,0.06
202501,5790000,2B2,0,11,-11,0
202501,5790000,2S3,0,1,-1,0
202501,5790000,3,4,4,0,1
202501,5790000,3S2,3,6,-3,0.5
202501,5790000,3S2S2,0,1,-1,0
202501,5790000,3S3,4,11,-7,0.36
202501,5790000,CA,3,20,-17,0.15
202501,5790002,2,0,2,-2,0
202501,5790003,3S3,0,2,-2,0
202501,5790004,3S2,0,2,-2,0
202501,5792000,2,1,10,-9,0.1
202501,5792000,2S2,0,5,-5,0
202501,5792000,3S3,0,13,-13,0
202501,5792000,CA,0,19,-19,0
202501,5809000,2,20,48,-28,0.42
202501,5809000,2S2,0,8,-8,0
202501,5809000,3,2,44,-42,0.05
202501,5809000,3S3,175,0,175,NA
202501,5809000,CA,0,28,-28,0
202501,5809000,V2,0,2,-2,0
202501,5819000,2,6,17,-11,0.35
202501,5819000,2S3,0,1,-1,0
202501,5819000,3,7,12,-5,0.58
202501,5819000,3S2,0,124,-124,0
202501,5819000,3S3,0,79,-79,0
202501,5819000,CA,0,5,-5,0
202501,5819000,V3,0,3,-3,0
202501,5837000,2,68,694,-626,0.1
202501,5837000,2B2,0,6,-6,0
202501,5837000,2S2,1,20,-19,0.05
202501,5837000,2S3,3,10,-7,0.3
202501,5837000,3,8,81,-73,0.1
202501,5837000,3S2,52,18,34,2.89
202501,5837000,3S3,51,350,-299,0.15
202501,5837000,3S4,1,1,0,1
202501,5837000,4,0,2,-2,0
202501,5837000,CA,6,153,-147,0.04
202501,5837001,2,3,13,-10,0.23
202501,5837001,3,0,7,-7,0
202501,5837001,3S2,1,1,0,1
202501,5837001,CA,0,1,-1,0
202501,5837002,2,5,5,0,1
202501,5837002,3S2,0,114,-114,0
202501,5837002,3S3,7,59,-52,0.12
202501,5837003,3,0,1,-1,0
202501,5837003,3S2,0,1,-1,0
202501,5837008,3S3,0,1,-1,0
202501,5842000,2,0,36,-36,0
202501,5842000,3,3,1,2,3
202501,5842000,3S3,0,3,-3,0
202501,5842000,CA,0,14,-14,0
202501,5842000,V2,0,1,-1,0
202501,5847000,2,139,140,-1,0.99
202501,5847000,3,13,25,-12,0.52
202501,5847000,3S2,2,2,0,1
202501,5847000,3S3,23,30,-7,0.77
202501,5847000,CA,0,81,-81,0
202501,5847000,V3,0,1,-1,0
202501,5854000,2,3,12,-9,0.25
202501,5854000,3,0,1,-1,0
202501,5854000,3S3,0,7,-7,0
202501,5854000,CA,0,2,-2,0
202501,5854002,2,0,6,-6,0
202501,5854002,3,0,1,-1,0
202501,5854002,3S3,0,3,-3,0
202501,5854002,CA,0,1,-1,0
202501,5856000,2,31,19,12,1.63
202501,5856000,2S2,0,4,-4,0
202501,5856000,3,14,15,-1,0.93
202501,5856000,3S2,0,2,-2,0
202501,5856000,3S3,0,3,-3,0
202501,5856000,CA,1,9,-8,0.11
202501,5856000,V2,0,2,-2,0
202501,5856000,V3,64,0,64,NA
202501,5856000,V4,19,0,19,NA
202501,5858000,2,16,73,-57,0.22
202501,5858000,3,1,24,-23,0.04
202501,5858000,3S2,12,22,-10,0.55
202501,5858000,3S3,18,42,-24,0.43
202501,5858000,CA,2,31,-29,0.06
202501,5858000,V3,0,3,-3,0
202501,5861000,2,3,55,-52,0.05
202501,5861000,2S2,0,7,-7,0
202501,5861000,3,0,6,-6,0
202501,5861000,3S3,0,3,-3,0
202501,5861000,3S4,0,1,-1,0
202501,5861000,CA,1,42,-41,0.02
202501,5861000,V3,0,1,-1,0
202501,5861002,2,8,13,-5,0.62
202501,5861002,3,1,1,0,1
202501,5861002,3S2,0,6,-6,0
202501,5861002,3S3,13,33,-20,0.39
202501,5861002,4,23,4,19,5.75
202501,5861002,CA,1,2,-1,0.5
202501,5873000,CA,1,0,1,NA
202501,5885000,2,5,22,-17,0.23
202501,5885000,3,4,6,-2,0.67
202501,5885000,3S3,16,0,16,NA
202501,5885000,CA,0,1,-1,0
202501,5885000,V3,0,4,-4,0
202501,5887000,2,134,536,-402,0.25
202501,5887000,2R3,0,1,-1,0
202501,5887000,2S2,0,3,-3,0
202501,5887000,2S3,1,5,-4,0.2
202501,5887000,3,106,11,95,9.64
202501,5887000,3S2,79,18,61,4.39
202501,5887000,3S3,381,409,-28,0.93
202501,5887000,4,1,0,1,NA
202501,5887000,CA,2,117,-115,0.02
202501,5887004,2,0,1,-1,0
202501,5887004,CA,0,1,-1,0
202501,5887007,2,34,19,15,1.79
202501,5887007,2S3,0,1,-1,0
202501,5887007,3,1,1,0,1
202501,5887007,3S2,0,1,-1,0
202501,5887007,3S3,19,19,0,1
202501,5887007,4,3,0,3,NA
202501,5887007,CA,0,1,-1,0
202501,5890000,2,99,112,-13,0.88
202501,5890000,3,2,36,-34,0.06
202501,5890000,3S3,1,38,-37,0.03
202501,5890000,CA,0,38,-38,0
202501,5890000,V3,0,6,-6,0
202501,5893000,2,15,64,-49,0.23
202501,5893000,2S2,4,2,2,2
202501,5893000,2S3,1,10,-9,0.1
202501,5893000,3,7,5,2,1.4
202501,5893000,3S2,2,3,-1,0.67
202501,5893000,3S3,33,88,-55,0.38
202501,5893000,3S4,0,1,-1,0
202501,5893000,4,5,0,5,NA
202501,5893000,CA,29,58,-29,0.5
202501,5893000,V3,0,1,-1,0
202501,5893001,3S3,0,3,-3,0
202501,5893001,V3,0,4,-4,0
202501,5893002,CA,0,1,-1,0
202501,5893003,2,10,0,10,NA
202501,5893003,CA,0,4,-4,0
202501,5893005,3S3,26,71,-45,0.37
202501,5895000,2,5,125,-120,0.04
202501,5895000,2B2,0,12,-12,0
202501,5895000,3,1,12,-11,0.08
202501,5895000,3S2,2,6,-4,0.33
202501,5895000,3S3,2,80,-78,0.03
202501,5895000,CA,1,46,-45,0.02
202501,8001000,2,20997,20123,874,1.04
202501,8001000,2B1,15,22,-7,0.68
202501,8001000,2B2,9,4,5,2.25
202501,8001000,2R2,81,41,40,1.98
202501,8001000,2R3,1,1,0,1
202501,8001000,2S1,32,6,26,5.33
202501,8001000,2S2,989,2301,-1312,0.43
202501,8001000,2S3,658,1428,-770,0.46
202501,8001000,3,614,740,-126,0.83
202501,8001000,3S1,12,7,5,1.71
202501,8001000,3S2,1929,2382,-453,0.81
202501,8001000,3S2S3,1,2,-1,0.5
202501,8001000,3S3,16390,16266,124,1.01
202501,8001000,3S4,10,18,-8,0.56
202501,8001000,4,35,5,30,7
202501,8001000,CA,5169,4791,378,1.08
202501,8001000,V2,46,57,-11,0.81
202501,8001000,V3,158,79,79,2
202501,8001000,V4,16,10,6,1.6
202501,8001001,2,345,27,318,12.78
202501,8001001,2S2,8,6,2,1.33
202501,8001001,2S3,55,49,6,1.12
202501,8001001,3,5,1,4,5
202501,8001001,3S2,38,51,-13,0.75
202501,8001001,3S3,136,163,-27,0.83
202501,8001001,CA,0,4,-4,0
202501,8001002,2,0,1,-1,0
202501,8001002,CA,0,6,-6,0
202501,8001004,2,0,7,-7,0
202501,8001004,3S3,0,8,-8,0
202501,8078000,2,1136,448,688,2.54
202501,8078000,2R2,0,2,-2,0
202501,8078000,2S2,439,2,437,219.5
202501,8078000,2S3,113,8,105,14.12
202501,8078000,3,453,10,443,45.3
202501,8078000,3S1,0,1,-1,0
202501,8078000,3S2,10,17,-7,0.59
202501,8078000,3S3,1160,498,662,2.33
202501,8078000,CA,6,133,-127,0.05
202501,8078000,V2,15,18,-3,0.83
202501,8078001,2,12,131,-119,0.09
202501,8078001,3,0,9,-9,0
202501,8078001,CA,0,3,-3,0
202501,8078003,2,0,16,-16,0
202501,8137000,2,1,51,-50,0.02
202501,8137000,CA,0,28,-28,0
202501,8141000,2,5,77,-72,0.06
202501,8141000,2S2,5,75,-70,0.07
202501,8141000,2S3,0,3,-3,0
202501,8141000,3,5,1,4,5
202501,8141000,3S2,1,3,-2,0.33
202501,8141000,3S3,2,11,-9,0.18
202501,8141000,CA,0,17,-17,0
202501,8141001,CA,0,8,-8,0
202501,8296000,2,8943,2045,6898,4.37
202501,8296000,2B1,0,3,-3,0
202501,8296000,2R2,214,20,194,10.7
202501,8296000,2S2,184,514,-330,0.36
202501,8296000,2S3,191,253,-62,0.75
202501,8296000,3,272,129,143,2.11
202501,8296000,3S1,2,0,2,NA
202501,8296000,3S2,371,328,43,1.13
202501,8296000,3S3,2011,2407,-396,0.84
202501,8296000,3S4,0,1,-1,0
202501,8296000,4,3,0,3,NA
202501,8296000,CA,2324,438,1886,5.31
202501,8296000,V2,1,1,0,1
202501,8296000,V3,0,114,-114,0
202501,8296000,V4,0,16,-16,0
202501,8296001,2,3,80,-77,0.04
202501,8372000,2,2,146,-144,0.01
202501,8372000,2R2,1,1,0,1
202501,8372000,2S2,0,1,-1,0
202501,8372000,3S2,0,2,-2,0
202501,8372000,3S3,2,25,-23,0.08
202501,8372000,3S4,0,31,-31,0
202501,8372000,CA,1,60,-59,0.02
202501,8372004,2,2,6,-4,0.33
202501,8372004,CA,0,21,-21,0
202501,8421000,2,47,171,-124,0.27
202501,8421000,2S2,0,1,-1,0
202501,8421000,2S3,28,0,28,NA
202501,8421000,3,0,3,-3,0
202501,8421000,3S2,6,9,-3,0.67
202501,8421000,3S3,412,14,398,29.43
202501,8421000,CA,2,77,-75,0.03
202501,8421000,V3,2,0,2,NA
202501,8421000,V3R3,2,0,2,NA
202501,8421000,V4,12,0,12,NA
202501,8421001,2,30,7,23,4.29
202501,8421001,3S3,3,2,1,1.5
202501,8421001,3S4,1,0,1,NA
202501,8421001,V3,2,0,2,NA
202501,8421003,2S3,2,0,2,NA
202501,8421005,3S3,1,0,1,NA
202501,8433000,2,12903,2035,10868,6.34
202501,8433000,2B1,2,1,1,2
202501,8433000,2B2,1,0,1,NA
202501,8433000,2R2,3,9,-6,0.33
202501,8433000,2S1,1,0,1,NA
202501,8433000,2S2,128,339,-211,0.38
202501,8433000,2S3,91,208,-117,0.44
202501,8433000,3,142,131,11,1.08
202501,8433000,3S1,0,4,-4,0
202501,8433000,3S2,299,395,-96,0.76
202501,8433000,3S3,2872,2407,465,1.19
202501,8433000,3S4,2,3,-1,0.67
202501,8433000,CA,1967,560,1407,3.51
202501,8433000,V2,0,2,-2,0
202501,8433000,V3,19,50,-31,0.38
202501,8433001,2,42,177,-135,0.24
202501,8433001,3,1,20,-19,0.05
202501,8433001,3S3,4,7,-3,0.57
202501,8433001,CA,0,4,-4,0
202501,8433004,3S3,0,1,-1,0
202501,8436000,2,4,78,-74,0.05
202501,8436000,3S2,0,1,-1,0
202501,8436000,CA,0,59,-59,0
202501,8436000,V3,0,1,-1,0
202501,8520000,2,29,226,-197,0.13
202501,8520000,2S2,21,118,-97,0.18
202501,8520000,2S3,44,53,-9,0.83
202501,8520000,3,4,4,0,1
202501,8520000,3S2,11,36,-25,0.31
202501,8520000,3S3,1171,1132,39,1.03
202501,8520000,CA,7,91,-84,0.08
202501,8520000,V2,3,0,3,NA
202501,8520000,V3,7,0,7,NA
202501,8549000,2,0,24,-24,0
202501,8549000,3,0,19,-19,0
202501,8549000,CA,0,30,-30,0
202501,8549002,2,0,2,-2,0
202501,8549002,2S2,1,1,0,1
202501,8549003,2S2,2,0,2,NA
202501,8549003,2S3,4,0,4,NA
202501,8549003,3S3,1,0,1,NA
202501,8558000,2,94,261,-167,0.36
202501,8558000,3,0,37,-37,0
202501,8558000,3S2,3,1,2,3
202501,8558000,3S3,3,2,1,1.5
202501,8558000,CA,5,26,-21,0.19
202501,8558001,2,0,11,-11,0
202501,8558001,3,0,6,-6,0
202501,8558001,3S3,0,1,-1,0
202501,8558001,CA,0,1,-1,0
202501,8560000,2,95,119,-24,0.8
202501,8560000,2S2,1,0,1,NA
202501,8560000,2S3,7,13,-6,0.54
202501,8560000,3,3,40,-37,0.07
202501,8560000,3S2,4,10,-6,0.4
202501,8560000,3S2S3,0,1,-1,0
202501,8560000,3S3,44,103,-59,0.43
202501,8560000,3S4,0,1,-1,0
202501,8560000,CA,2,55,-53,0.04
202501,8560002,2,0,2,-2,0
202501,8560002,V2,3,0,3,NA
202501,8560003,2,1,5,-4,0.2
202501,8560003,2S2,1,0,1,NA
202501,8560003,3S2,3,0,3,NA
202501,8560003,3S3,0,5,-5,0
202501,8560003,CA,1,4,-3,0.25
202501,8560004,3S2,0,1,-1,0
202501,8573000,2,104,1078,-974,0.1
202501,8573000,2S2,3,104,-101,0.03
202501,8573000,2S3,0,8,-8,0
202501,8573000,3,3,72,-69,0.04
202501,8573000,3S2,2,85,-83,0.02
202501,8573000,3S3,16,89,-73,0.18
202501,8573000,CA,128,661,-533,0.19
202501,8573000,V2,1,0,1,NA
202501,8573002,2,2,3,-1,0.67
202501,8573002,CA,0,1,-1,0
202501,8573003,2,0,1,-1,0
202501,8573003,2S2,0,1,-1,0
202501,8606000,2,3,55,-52,0.05
202501,8606000,2S2,1,0,1,NA
202501,8606000,2S3,2,0,2,NA
202501,8606000,3,1,0,1,NA
202501,8606000,3S2,1,1,0,1
202501,8606000,3S3,5,14,-9,0.36
202501,8606000,CA,2,34,-32,0.06
202501,8606004,2,0,2,-2,0
202501,8606005,2,0,1,-1,0
202501,8606005,3S3,0,1,-1,0
202501,8606006,3S2,1,0,1,NA
202501,8634000,2,450,435,15,1.03
202501,8634000,2S2,0,4,-4,0
202501,8634000,2S3,13,3,10,4.33
202501,8634000,3,142,14,128,10.14
202501,8634000,3S2,23,16,7,1.44
202501,8634000,3S3,231,413,-182,0.56
202501,8634000,CA,3,106,-103,0.03
202501,8634000,V2,2,0,2,NA
202501,8634000,V3,42,16,26,2.62
202501,8634000,V3R3,0,2,-2,0
202501,8634000,V4,0,1,-1,0
202501,8638000,2,81,739,-658,0.11
202501,8638000,2S2,3,20,-17,0.15
202501,8638000,2S3,2,1,1,2
202501,8638000,3,1,22,-21,0.05
202501,8638000,3S2,1,46,-45,0.02
202501,8638000,3S3,15,120,-105,0.12
202501,8638000,CA,7,182,-175,0.04
202501,8638000,V2,18,2,16,9
202501,8638000,V3,0,2,-2,0
202501,8638001,2,0,6,-6,0
202501,8638002,2,15,9,6,1.67
202501,8638002,3,0,1,-1,0
202501,8638002,3S2,2,0,2,NA
202501,8638002,3S3,1,0,1,NA
202501,8638002,CA,0,3,-3,0
202501,8638004,2,0,1,-1,0
202501,8638004,3S3,0,3,-3,0
202501,8638004,CA,0,8,-8,0
202501,8638005,2,0,1,-1,0
202501,8638006,2,0,5,-5,0
202501,8638006,2S2,0,2,-2,0
202501,8638006,2S3,0,4,-4,0
202501,8675000,2,2,33,-31,0.06
202501,8675000,CA,0,8,-8,0
202501,8685000,2,43,141,-98,0.3
202501,8685000,3,0,21,-21,0
202501,8685000,3S2,0,3,-3,0
202501,8685000,3S3,83,32,51,2.59
202501,8685000,CA,1,60,-59,0.02
202501,8685000,V2,5,0,5,NA
202501,8685000,V3,1,0,1,NA
202501,8758000,2,4358,3419,939,1.27
202501,8758000,2R2,4,3,1,1.33
202501,8758000,2S1,0,23,-23,0
202501,8758000,2S2,49,148,-99,0.33
202501,8758000,2S3,117,147,-30,0.8
202501,8758000,3,126,50,76,2.52
202501,8758000,3S1,1,4,-3,0.25
202501,8758000,3S2,109,314,-205,0.35
202501,8758000,3S3,644,1393,-749,0.46
202501,8758000,CA,2653,879,1774,3.02
202501,8758000,V2,0,45,-45,0
202501,8758000,V3,0,185,-185,0
202501,8758000,V4,0,59,-59,0
202501,8770000,2,5,55,-50,0.09
202501,8770000,2S2,0,1,-1,0
202501,8770000,2S3,0,1,-1,0
202501,8770000,3S2,0,1,-1,0
202501,8770000,3S3,0,2,-2,0
202501,8770000,CA,0,18,-18,0
202501,8832000,2,7,202,-195,0.03
202501,8832000,2S2,5,7,-2,0.71
202501,8832000,2S3,24,29,-5,0.83
202501,8832000,3,0,1,-1,0
202501,8832000,3S2,4,8,-4,0.5
202501,8832000,3S3,40,80,-40,0.5
202501,8832000,3S4,2,1,1,2
202501,8832000,CA,2,64,-62,0.03
202501,8832000,V2,0,1,-1,0
202501,8832000,V3,0,23,-23,0
202501,8832002,2,0,1,-1,0
202501,8832004,2,0,3,-3,0
202501,8832010,2,0,4,-4,0
202501,8849000,2,2,21,-19,0.1
202501,8849000,CA,0,43,-43,0
202501,11001000,2,63426,70409,-6983,0.9
202501,11001000,2B1,13,0,13,NA
202501,11001000,2B2,4,5,-1,0.8
202501,11001000,2R2,94,85,9,1.11
202501,11001000,2R3,206,76,130,2.71
202501,11001000,2S1,59,46,13,1.28
202501,11001000,2S2,6363,8090,-1727,0.79
202501,11001000,2S3,2769,2417,352,1.15
202501,11001000,3,1119,2644,-1525,0.42
202501,11001000,3S1,18,19,-1,0.95
202501,11001000,3S2,4303,6811,-2508,0.63
202501,11001000,3S2S3,4,0,4,NA
202501,11001000,3S3,10563,19503,-8940,0.54
202501,11001000,3S4,25,48,-23,0.52
202501,11001000,4,18,68,-50,0.26
202501,11001000,CA,19686,37397,-17711,0.53
202501,11001000,V2,113,92,21,1.23
202501,11001000,V3,341,522,-181,0.65
202501,11001000,V4,0,39,-39,0
202501,11001001,2,117,66,51,1.77
202501,11001001,2S2,0,3,-3,0
202501,11001001,3S3,8,53,-45,0.15
202501,11001005,2,0,2,-2,0
202501,11001005,CA,1,0,1,NA
202501,11001006,2,12,10,2,1.2
202501,11001006,2S2,3,4,-1,0.75
202501,11001006,2S3,2,0,2,NA
202501,11001006,3S3,0,2,-2,0
202501,11001006,CA,1,0,1,NA
202501,11001008,2S3,0,1,-1,0
202501,13001000,2,11511,13913,-2402,0.83
202501,13001000,2B1,12,4,8,3
202501,13001000,2B2,32,7,25,4.57
202501,13001000,2R2,79,41,38,1.93
202501,13001000,2R3,1,0,1,NA
202501,13001000,2S1,29,15,14,1.93
202501,13001000,2S2,7109,3921,3188,1.81
202501,13001000,2S3,2553,2025,528,1.26
202501,13001000,3,1250,227,1023,5.51
202501,13001000,3S1,42,24,18,1.75
202501,13001000,3S2,4508,2402,2106,1.88
202501,13001000,3S2S3,1,0,1,NA
202501,13001000,3S3,18638,14046,4592,1.33
202501,13001000,3S4,59,11,48,5.36
202501,13001000,4,21,12,9,1.75
202501,13001000,CA,2124,3216,-1092,0.66
202501,13001000,V2,0,60,-60,0
202501,13001000,V3,97,1,96,97
202501,13001001,2,1,4,-3,0.25
202501,13001001,2S3,2,0,2,NA
202501,13001001,3S2,0,1,-1,0
202501,13001001,3S3,0,4,-4,0
202501,13001001,CA,0,1,-1,0
202501,13001002,2,0,1,-1,0
202501,13001002,3S2,0,2,-2,0
202501,13001002,3S3,0,2,-2,0
202501,13001002,3S4,1,1,0,1
202501,13001003,2,5,40,-35,0.12
202501,13001003,2S2,0,5,-5,0
202501,13001003,3,1,6,-5,0.17
202501,13001003,3S2,1,3,-2,0.33
202501,13001003,3S3,2,1,1,2
202501,13001003,3S4,0,1,-1,0
202501,13001003,CA,11,11,0,1
202501,13001004,2,57,58,-1,0.98
202501,13001004,2S2,0,2,-2,0
202501,13001004,2S3,0,2,-2,0
202501,13001004,3,1,4,-3,0.25
202501,13001004,3S2,2,4,-2,0.5
202501,13001004,3S3,5,15,-10,0.33
202501,13001004,3S4,1,0,1,NA
202501,13001004,CA,2,12,-10,0.17
202501,13001004,V2,7,0,7,NA
202501,13001005,2,0,1,-1,0
202501,13001008,2,2,4,-2,0.5
202501,13001008,2S2,0,1,-1,0
202501,13001008,3S3,0,1,-1,0
202501,13001009,2,84,19,65,4.42
202501,13001009,2B1,1,0,1,NA
202501,13001009,2S1,1,0,1,NA
202501,13001009,2S2,97,3,94,32.33
202501,13001009,2S3,11,0,11,NA
202501,13001009,3,5,0,5,NA
202501,13001009,3S2,15,1,14,15
202501,13001009,3S3,183,28,155,6.54
202501,13001009,CA,1,31,-30,0.03
202501,13001010,2,15,33,-18,0.45
202501,13001010,2S2,0,1,-1,0
202501,13001010,3,1,0,1,NA
202501,13001010,3S2,0,2,-2,0
202501,13001010,3S3,5,7,-2,0.71
202501,13001010,CA,1,15,-14,0.07
202501,13001012,2,2,5,-3,0.4
202501,13001013,2,1,2,-1,0.5
202501,13001015,2,0,10,-10,0
202501,13001015,3S3,10,1,9,10
202501,13001019,2,14,10,4,1.4
202501,13001019,3,0,1,-1,0
202501,13001019,3S2,0,1,-1,0
202501,13001019,3S4,1,0,1,NA
202501,13001020,2,2,5,-3,0.4
202501,13001020,3S4,1,0,1,NA
202501,13001020,CA,0,6,-6,0
202501,13001025,3S2,2,1,1,2
202501,13001025,3S3,3,2,1,1.5
202501,13001029,2,13,61,-48,0.21
202501,13001029,3,0,12,-12,0
202501,13001029,3S2,0,8,-8,0
202501,13001029,3S3,8,5,3,1.6
202501,13001029,3S4,1,0,1,NA
202501,13001029,CA,0,1,-1,0
202501,13006000,2,1,6,-5,0.17
202501,13006000,3,0,3,-3,0
202501,13006000,3S2,0,1,-1,0
202501,13006000,3S3,0,6,-6,0
202501,13006000,CA,0,1,-1,0
202501,13006005,2,0,1,-1,0
202501,13006008,2,0,4,-4,0
202501,13006035,2,0,1,-1,0
202501,13030000,3,0,1,-1,0
202501,13042000,2,3,8,-5,0.38
202501,13042000,3S3,2,6,-4,0.33
202501,13042000,CA,0,2,-2,0
202501,13042000,V3,0,1,-1,0
202501,13052000,2,542,568,-26,0.95
202501,13052000,2R2,0,1,-1,0
202501,13052000,2S2,0,21,-21,0
202501,13052000,2S3,11,115,-104,0.1
202501,13052000,3,272,84,188,3.24
202501,13052000,3S2,148,25,123,5.92
202501,13052000,3S3,141,423,-282,0.33
202501,13052000,3S4,1,0,1,NA
202501,13052000,CA,571,161,410,3.55
202501,13052000,V2,8,0,8,NA
202501,13052001,2,0,1,-1,0
202501,13052001,3S3,0,1,-1,0
202501,13052002,2,41,40,1,1.02
202501,13052002,2S2,1,0,1,NA
202501,13052002,2S3,5,0,5,NA
202501,13052002,3,1,8,-7,0.12
202501,13052002,3S2,4,0,4,NA
202501,13052002,3S3,11,3,8,3.67
202501,13052002,CA,1,10,-9,0.1
202501,13052003,2,1,0,1,NA
202501,13052004,2,37,1,36,37
202501,13052004,2S2,6,0,6,NA
202501,13052004,2S3,29,0,29,NA
202501,13052004,3,0,114,-114,0
202501,13062000,2,128,19,109,6.74
202501,13062000,2S3,6,0,6,NA
202501,13062000,3,0,2,-2,0
202501,13062000,CA,0,30,-30,0
202501,13074000,2,4,9,-5,0.44
202501,13074000,3,0,16,-16,0
202501,13074000,CA,0,5,-5,0
202501,13140000,2,7,134,-127,0.05
202501,13140000,3,0,10,-10,0
202501,13140000,3S2,1,0,1,NA
202501,13140000,3S3,2,2,0,1
202501,13140000,CA,1,120,-119,0.01
202501,13140002,2,1,0,1,NA
202501,13140004,3S3,0,2,-2,0
202501,13160000,2,1,45,-44,0.02
202501,13160000,2S2,1,1,0,1
202501,13160000,2S3,0,1,-1,0
202501,13160000,3,1,6,-5,0.17
202501,13160000,3S2,4,4,0,1
202501,13160000,3S3,33,7,26,4.71
202501,13160000,3S4,1,0,1,NA
202501,13160000,CA,3,13,-10,0.23
202501,13160000,V3,0,3,-3,0
202501,13188000,2,1,3,-2,0.33
202501,13188000,2S2,3,0,3,NA
202501,13188000,3,0,10,-10,0
202501,13188000,3S1,4,0,4,NA
202501,13188000,3S2,4,2,2,2
202501,13188000,3S3,13,2,11,6.5
202501,13188000,CA,0,1,-1,0
202501,13212000,2,1,11,-10,0.09
202501,13212000,3,0,2,-2,0
202501,13212000,3S2,0,1,-1,0
202501,13212000,3S3,1,3,-2,0.33
202501,13212000,CA,0,1,-1,0
202501,13212005,2,0,1,-1,0
202501,13212005,2S2,0,1,-1,0
202501,13212005,3S3,0,1,-1,0
202501,13212006,CA,0,1,-1,0
202501,13212009,2,1,4,-3,0.25
202501,13212009,3,0,1,-1,0
202501,13222000,2,5,15,-10,0.33
202501,13222000,2S2,4,8,-4,0.5
202501,13222000,2S3,1,2,-1,0.5
202501,13222000,3,3,3,0,1
202501,13222000,3S2,1,1,0,1
202501,13222000,3S3,73,85,-12,0.86
202501,13222000,CA,0,28,-28,0
202501,13222000,V2,3,0,3,NA
202501,13244000,2,53,287,-234,0.18
202501,13244000,2S2,1,0,1,NA
202501,13244000,2S3,0,5,-5,0
202501,13244000,3,1,25,-24,0.04
202501,13244000,3S2,1,1,0,1
202501,13244000,3S3,54,63,-9,0.86
202501,13244000,CA,27,100,-73,0.27
202501,13244005,2,2,0,2,NA
202501,13244007,2,0,1,-1,0
202501,13244013,3,0,1,-1,0
202501,13244014,2S3,0,1,-1,0
202501,13248000,2,0,7,-7,0
202501,13268000,2,0,1,-1,0
202501,13268019,2,0,6,-6,0
202501,13300000,2,1,4,-3,0.25
202501,13300000,3,0,10,-10,0
202501,13300000,3S3,0,19,-19,0
202501,13430000,2,221,788,-567,0.28
202501,13430000,2B2,0,16,-16,0
202501,13430000,2R2,0,3,-3,0
202501,13430000,2R3,0,1,-1,0
202501,13430000,2S2,2,9,-7,0.22
202501,13430000,2S3,2,10,-8,0.2
202501,13430000,3,91,73,18,1.25
202501,13430000,3S2,5,18,-13,0.28
202501,13430000,3S3,127,307,-180,0.41
202501,13430000,CA,7,152,-145,0.05
202501,13430013,2,1,1,0,1
202501,13430017,2,0,2,-2,0
202501,13430017,3S3,0,14,-14,0
202501,13430017,CA,0,5,-5,0
202501,13430032,2S2,0,1,-1,0
202501,13430032,CA,0,1,-1,0
202501,13433000,2,72,56,16,1.29
202501,13433000,3,0,11,-11,0
202501,13433000,3S2,1,0,1,NA
202501,13433000,3S3,0,17,-17,0
202501,13433000,CA,1,8,-7,0.12
202501,13433000,V2,4,0,4,NA
202501,13433003,2,15,9,6,1.67
202501,13433003,CA,5,2,3,2.5
202501,13433004,2,0,3,-3,0
202501,13440000,3,0,7,-7,0
202501,13440000,3S3,0,1,-1,0
202501,13442000,2,79,167,-88,0.47
202501,13442000,2B2,0,1,-1,0
202501,13442000,2R2,0,1,-1,0
202501,13442000,2S2,14,4,10,3.5
202501,13442000,2S3,78,0,78,NA
202501,13442000,3,0,1,-1,0
202501,13442000,3S3,78,72,6,1.08
202501,13442000,CA,0,59,-59,0
202501,13442000,V2,2,0,2,NA
202501,13458000,3,0,12,-12,0
202501,13458000,3S2,1,0,1,NA
202501,13468000,2,30,283,-253,0.11
202501,13468000,2B2,0,2,-2,0
202501,13468000,2R2,0,7,-7,0
202501,13468000,2S2,0,1,-1,0
202501,13468000,3,4,18,-14,0.22
202501,13468000,3S3,0,22,-22,0
202501,13468000,CA,0,57,-57,0
202501,13468023,CA,0,4,-4,0
202501,13468024,2,0,1,-1,0
202501,13468028,2,0,31,-31,0
202501,13468040,2,0,3,-3,0
202501,13468040,CA,0,1,-1,0
202501,13473000,2,12,8,4,1.5
202501,13473000,3,0,1,-1,0
202501,13473000,3S3,1,4,-3,0.25
202501,13473000,3S4,0,1,-1,0
202501,13490000,2,0,5,-5,0
202501,13490000,3,1,0,1,NA
202501,13490000,3S2,0,2,-2,0
202501,13490000,3S3,0,6,-6,0
202501,13549000,3S2,0,2,-2,0
202501,13549015,2,0,3,-3,0
202501,13549015,2S3,1,1,0,1
202501,13580000,2,2,3,-1,0.67
202501,13580000,3,0,2,-2,0
202501,13580000,3S2,1,0,1,NA
202501,13580000,3S3,34,12,22,2.83
202501,13580000,CA,1,0,1,NA
202501,13580000,V3R3,4,0,4,NA
202501,13580005,CA,0,2,-2,0
202501,13600000,2,0,13,-13,0
202501,13600000,3S3,0,8,-8,0
202501,13600000,CA,0,4,-4,0
202501,13600001,2,0,3,-3,0
202501,13600001,2S3,1,0,1,NA
202501,13600001,3,0,2,-2,0
202501,13600001,3S2,0,1,-1,0
202501,13600001,3S3,1,0,1,NA
202501,13620000,2,0,2,-2,0
202501,13620000,3S2,1,1,0,1
202501,13620000,CA,0,5,-5,0
202501,13647000,2,9,15,-6,0.6
202501,13647000,3,0,1,-1,0
202501,13647000,CA,0,2,-2,0
202501,13650000,2,0,2,-2,0
202501,13650000,3,0,2,-2,0
202501,13650000,3S2,0,1,-1,0
202501,13650000,CA,0,3,-3,0
202501,13650005,2S3,1,0,1,NA
202501,13654000,2,13,50,-37,0.26
202501,13654000,3S2,0,1,-1,0
202501,13654000,3S3,2,7,-5,0.29
202501,13654000,CA,0,4,-4,0
202501,13655000,2,2,3,-1,0.67
202501,13655000,3,0,5,-5,0
202501,13655000,3S2,0,1,-1,0
202501,13655003,2S3,0,4,-4,0
202501,13657000,2,109,91,18,1.2
202501,13657000,2S3,10,0,10,NA
202501,13657000,3,0,8,-8,0
202501,13657000,3S2,1,0,1,NA
202501,13657000,3S3,0,50,-50,0
202501,13657000,CA,2,15,-13,0.13
202501,13657005,2,0,1,-1,0
202501,13667000,2,4,26,-22,0.15
202501,13667000,3,0,22,-22,0
202501,13667000,CA,0,1,-1,0
202501,13670000,2,5,119,-114,0.04
202501,13670000,2R3,0,2,-2,0
202501,13670000,2S3,0,1,-1,0
202501,13670000,3,5,28,-23,0.18
202501,13670000,3S2,1,1,0,1
202501,13670000,3S3,68,39,29,1.74
202501,13670000,CA,1,21,-20,0.05
202501,13670000,V3,0,2,-2,0
202501,13670004,2,0,2,-2,0
202501,13673000,2,47,114,-67,0.41
202501,13673000,2S2,4,5,-1,0.8
202501,13673000,2S3,5,1,4,5
202501,13673000,3,0,2,-2,0
202501,13673000,3S2,0,1,-1,0
202501,13673000,3S3,5,3,2,1.67
202501,13673000,CA,3,19,-16,0.16
202501,13673003,3S3,5,1,4,5
202501,13673003,CA,17,17,0,1
202501,13673005,2,1,2,-1,0.5
202501,13673005,3,0,1,-1,0
202501,13673005,3S2,0,3,-3,0
202501,13673005,CA,0,1,-1,0
202501,13673005,V2,0,1,-1,0
202501,13683000,2,113,198,-85,0.57
202501,13683000,2S3,4,1,3,4
202501,13683000,3S2,0,1,-1,0
202501,13683000,3S3,3,8,-5,0.38
202501,13683000,CA,1,17,-16,0.06
202501,13683000,V2,4,1,3,4
202501,13683000,V3,0,1,-1,0
202501,13688000,2,5,209,-204,0.02
202501,13688000,3,1,21,-20,0.05
202501,13688000,3S2,0,1,-1,0
202501,13688000,3S3,0,64,-64,0
202501,13688000,CA,25,58,-33,0.43
202501,13688000,V2,0,1,-1,0
202501,13688000,V3,0,12,-12,0
202501,13744000,2,2,9,-7,0.22
202501,13744000,2S3,0,1,-1,0
202501,13744000,3,0,10,-10,0
202501,13744000,3S2,0,2,-2,0
202501,13744000,3S3,0,12,-12,0
202501,13744000,CA,0,1,-1,0
202501,13760000,2,3,8,-5,0.38
202501,13760000,CA,18,26,-8,0.69
202501,13780000,2,1,2,-1,0.5
202501,13780000,3,0,1,-1,0
202501,13780000,3S2,0,1,-1,0
202501,13780000,3S3,0,3,-3,0
202501,13780023,CA,1,0,1,NA
202501,13810000,2,0,3,-3,0
202501,13810000,3,0,12,-12,0
202501,13810000,3S3,0,1,-1,0
202501,13810011,3,0,1,-1,0
202501,13836000,2,665,1012,-347,0.66
202501,13836000,2S2,98,26,72,3.77
202501,13836000,2S3,53,140,-87,0.38
202501,13836000,3,11,64,-53,0.17
202501,13836000,3S2,235,189,46,1.24
202501,13836000,3S3,433,362,71,1.2
202501,13836000,3S4,0,1,-1,0
202501,13836000,4,0,1,-1,0
202501,13836000,CA,15,316,-301,0.05
202501,13836000,V2,30,0,30,NA
202501,13836003,2S3,0,1,-1,0
202501,13836003,3,0,1,-1,0
202501,13836003,3S3,0,3,-3,0
202501,13838000,2,100,107,-7,0.93
202501,13838000,2R2,0,8,-8,0
202501,13838000,2S2,120,9,111,13.33
202501,13838000,2S3,18,14,4,1.29
202501,13838000,3,1,6,-5,0.17
202501,13838000,3S2,355,287,68,1.24
202501,13838000,3S3,151,74,77,2.04
202501,13838000,3S4,2,1,1,2
202501,13838000,CA,5,20,-15,0.25
202501,13838001,2,6,7,-1,0.86
202501,13873000,2,3,57,-54,0.05
202501,13873000,2S3,1,0,1,NA
202501,13873000,3S2,0,1,-1,0
202501,13873000,3S3,0,11,-11,0
202501,13873000,CA,0,35,-35,0
202501,13873000,V2,1,0,1,NA
202501,13873001,2,1,0,1,NA
202501,13873002,2,0,1,-1,0
202501,13894000,2,67,43,24,1.56
202501,13894000,3S2,0,1,-1,0
202501,13894000,3S3,43,18,25,2.39
202501,13894000,CA,1,8,-7,0.12
202501,15001000,2,1596,2991,-1395,0.53
202501,15001000,2R2,0,9,-9,0
202501,15001000,2R3,0,17,-17,0
202501,15001000,2S2,8,178,-170,0.04
202501,15001000,2S3,9,43,-34,0.21
202501,15001000,3,20,142,-122,0.14
202501,15001000,3S2,88,183,-95,0.48
202501,15001000,3S3,383,864,-481,0.44
202501,15001000,3S4,0,1,-1,0
202501,15001000,4,0,3,-3,0
202501,15001000,CA,1064,1177,-113,0.9
202501,15001000,V2,1,0,1,NA
202501,15001000,V3,0,203,-203,0
202501,15001007,2,0,6,-6,0
202501,15001007,2S2,0,7,-7,0
202501,15001007,3S3,0,1,-1,0
202501,15022000,2,0,2,-2,0
202501,15047000,2,2,26,-24,0.08
202501,15047000,3S2,0,1,-1,0
202501,15047000,CA,25,52,-27,0.48
202501,15047000,V3,0,1,-1,0
202501,15047004,2,0,2,-2,0
202501,15047007,2,0,1,-1,0
202501,15047007,3S2,0,1,-1,0
202501,15047010,2,0,21,-21,0
202501,15051000,2,1,19,-18,0.05
202501,15051000,3S2,0,1,-1,0
202501,15051000,3S3,8,4,4,2
202501,15051000,4,16,0,16,NA
202501,15051000,CA,0,6,-6,0
202501,15051000,V3,89,0,89,NA
202501,15051000,V4,147,0,147,NA
202501,15087000,2,3,99,-96,0.03
202501,15087000,3,0,2,-2,0
202501,15087000,3S2,9,1,8,9
202501,15087000,3S3,1,10,-9,0.1
202501,15087000,CA,1,9,-8,0.11
202501,15090000,2,0,1,-1,0
202501,15092000,2,0,1,-1,0
202501,15092000,CA,0,1,-1,0
202501,15097000,2,0,15,-15,0
202501,15097000,CA,0,3,-3,0
202501,15104000,2,3,23,-20,0.13
202501,15104000,3S2,0,2,-2,0
202501,15104000,3S3,32,2,30,16
202501,15104000,CA,0,14,-14,0
202501,15106000,2,1,5,-4,0.2
202501,15106000,3S3,12,0,12,NA
202501,15106000,CA,0,1,-1,0
202501,15109000,2,1,4,-3,0.25
202501,15109000,CA,0,4,-4,0
202501,15109001,CA,0,4,-4,0
202501,15109002,CA,0,2,-2,0
202501,15114000,2,3,1,2,3
202501,15131000,2,0,1,-1,0
202501,15131000,2S2,0,1,-1,0
202501,15131000,3S2,1,0,1,NA
202501,15131000,3S3,1,0,1,NA
202501,15135000,2,0,3,-3,0
202501,15135000,CA,0,2,-2,0
202501,15162000,2,5,9,-4,0.56
202501,15162000,CA,0,2,-2,0
202501,15172000,2,0,10,-10,0
202501,15172000,CA,0,2,-2,0
202501,15176000,2,50,668,-618,0.07
202501,15176000,2R3,0,1,-1,0
202501,15176000,3,0,7,-7,0
202501,15176000,3S2,2,6,-4,0.33
202501,15176000,3S3,169,335,-166,0.5
202501,15176000,CA,15,296,-281,0.05
202501,15176000,V2,0,2,-2,0
202501,15176000,V3,0,2,-2,0
202501,15180000,2,0,10,-10,0
202501,15180000,3,0,1,-1,0
202501,15180000,CA,2,2,0,1
202501,15183000,2,0,14,-14,0
202501,15183000,CA,0,26,-26,0
202501,15185000,2,0,19,-19,0
202501,15185000,2S3,1,1,0,1
202501,15185000,3S3,2,1,1,2
202501,15185000,CA,0,1,-1,0
202501,15187000,2,0,1,-1,0
202501,15187000,CA,0,2,-2,0
202501,15189000,2,12,3,9,4
202501,15189000,3S3,0,1,-1,0
202501,15189000,CA,0,1,-1,0
202501,15204000,2,0,35,-35,0
202501,15204000,3S3,0,2,-2,0
202501,15204000,CA,2,11,-9,0.18
202501,15212000,2,0,2,-2,0
202501,15215000,2,7,10,-3,0.7
202501,15215000,3S2,3,0,3,NA
202501,15215000,3S3,315,0,315,NA
202501,15215000,CA,1,2,-1,0.5
202501,15218000,2,0,5,-5,0
202501,15218000,3S3,3,0,3,NA
202501,15223000,2,0,15,-15,0
202501,15223000,3S3,1,3,-2,0.33
202501,15224000,2,0,4,-4,0
202501,15224000,3S3,1,0,1,NA
202501,15224000,CA,0,1,-1,0
202501,15232000,CA,0,1,-1,0
202501,15232001,2,0,1,-1,0
202501,15236000,2,0,3,-3,0
202501,15236000,CA,0,1,-1,0
202501,15238000,2,1295,1636,-341,0.79
202501,15238000,2R2,0,2,-2,0
202501,15238000,2R3,0,9,-9,0
202501,15238000,2S2,4,40,-36,0.1
202501,15238000,2S3,2,36,-34,0.06
202501,15238000,3,102,82,20,1.24
202501,15238000,3S1,0,1,-1,0
202501,15238000,3S2,15,91,-76,0.16
202501,15238000,3S3,654,701,-47,0.93
202501,15238000,3S4,0,1,-1,0
202501,15238000,4,0,2,-2,0
202501,15238000,CA,552,592,-40,0.93
202501,15238000,V2,9,0,9,NA
202501,15238000,V3,0,3,-3,0
202501,15238002,2,0,2,-2,0
202501,15238011,2,0,19,-19,0
202501,15238012,3S3,3,0,3,NA
202501,15244000,2,0,15,-15,0
202501,15244000,CA,0,1,-1,0
202501,15248000,2,0,5,-5,0
202501,15248000,CA,16,18,-2,0.89
202501,15248004,2,0,1,-1,0
202501,15272000,2,0,18,-18,0
202501,15272000,3S3,0,2,-2,0
202501,15272000,CA,0,3,-3,0
202501,15276000,2,1,8,-7,0.12
202501,15276000,CA,0,1,-1,0
202501,15293000,2,1,9,-8,0.11
202501,15293000,CA,0,2,-2,0
202501,15296000,2,0,6,-6,0
202501,15296000,CA,0,3,-3,0
202501,15299000,2,37,187,-150,0.2
202501,15299000,2R3,0,1,-1,0
202501,15299000,3,0,22,-22,0
202501,15299000,3S3,0,1,-1,0
202501,15299000,CA,25,57,-32,0.44
202501,15317000,2,0,3,-3,0
202501,15322000,2,9,174,-165,0.05
202501,15322000,2R3,0,3,-3,0
202501,15322000,3,2,5,-3,0.4
202501,15322000,CA,1,13,-12,0.08
202501,15322008,2,0,7,-7,0
202501,15322008,3,1,3,-2,0.33
202501,15322008,CA,0,13,-13,0
202501,15325000,2,0,10,-10,0
202501,15325000,CA,0,1,-1,0
202501,15332000,2,1,4,-3,0.25
202501,15332005,2,0,14,-14,0
202501,15332005,3S3,0,2,-2,0
202501,15362000,2,0,6,-6,0
202501,15362000,CA,0,4,-4,0
202501,15367000,2,0,3,-3,0
202501,15367000,3S2,0,2,-2,0
202501,15367000,3S3,0,2,-2,0
202501,15367000,CA,0,1,-1,0
202501,15368000,2,1,2,-1,0.5
202501,15377000,2,0,2,-2,0
202501,15377000,3S2,0,1,-1,0
202501,15377000,3S3,0,2,-2,0
202501,15380000,2,0,53,-53,0
202501,15380000,CA,0,3,-3,0
202501,15401000,2,0,4,-4,0
202501,15401000,CA,0,1,-1,0
202501,15403000,2,0,11,-11,0
202501,15407000,2,13,209,-196,0.06
202501,15407000,2S3,1,0,1,NA
202501,15407000,3,3,25,-22,0.12
202501,15407000,3S2S3,0,1,-1,0
202501,15407000,3S3,0,17,-17,0
202501,15407000,3S4,1,0,1,NA
202501,15407000,4,0,1,-1,0
202501,15407000,CA,3,98,-95,0.03
202501,15425000,2,1,2,-1,0.5
202501,15442000,2,0,1,-1,0
202501,15442001,2,3,0,3,NA
202501,15455000,2,3,31,-28,0.1
202501,15455000,3,0,1,-1,0
202501,15455000,3S3,2,2,0,1
202501,15455000,CA,22,55,-33,0.4
202501,15464000,2,0,5,-5,0
202501,15464000,CA,0,3,-3,0
202501,15466000,2,2,9,-7,0.22
202501,15466000,2S2,0,1,-1,0
202501,15466000,CA,0,11,-11,0
202501,15469000,2,7,180,-173,0.04
202501,15469000,2R3,0,1,-1,0
202501,15469000,3,2,1,1,2
202501,15469000,3S2,2,4,-2,0.5
202501,15469000,3S3,0,14,-14,0
202501,15469000,CA,4,53,-49,0.08
202501,15476000,2,0,9,-9,0
202501,15476000,CA,0,1,-1,0
202501,15480000,2,1,23,-22,0.04
202501,15480000,CA,0,4,-4,0
202501,15491000,2,615,192,423,3.2
202501,15491000,2S2,1,1,0,1
202501,15491000,2S3,0,2,-2,0
202501,15491000,3,146,5,141,29.2
202501,15491000,3S2,79,53,26,1.49
202501,15491000,3S3,3474,938,2536,3.7
202501,15491000,CA,0,19,-19,0
202501,15491000,V2,0,8,-8,0
202501,15491000,V3,11,35,-24,0.31
202501,15491000,V4,21,0,21,NA
202501,15491000,V4R2,2,0,2,NA
202501,15491001,2,170,110,60,1.55
202501,15491001,2S2,0,2,-2,0
202501,15491001,3,0,1,-1,0
202501,15491001,3S3,300,474,-174,0.63
202501,15491001,4,1,0,1,NA
202501,15491001,CA,0,13,-13,0
202501,15491004,2,1,1,0,1
202501,15491006,2,0,23,-23,0
202501,15491007,3S3,0,8,-8,0
202501,15494000,2,1,12,-11,0.08
202501,15494000,CA,0,4,-4,0
202501,15500000,2,30,5,25,6
202501,15500000,3,12,0,12,NA
202501,15500000,3S2,0,3,-3,0
202501,15500000,3S3,5,129,-124,0.04
202501,15500000,CA,0,2,-2,0
202501,15507000,2,0,22,-22,0
202501,15507000,3,0,2,-2,0
202501,15507000,3S2,1,0,1,NA
202501,15507000,3S3,1,1,0,1
202501,15507000,CA,0,10,-10,0
202501,15507000,V2,2,0,2,NA
202501,15507000,V3,15,0,15,NA
202501,15514000,2,2,21,-19,0.1
202501,15514000,3,1,0,1,NA
202501,15514000,3S2,0,1,-1,0
202501,15514000,3S3,2,6,-4,0.33
202501,15514000,CA,9,9,0,1
202501,15516000,2,33,258,-225,0.13
202501,15516000,2R3,0,1,-1,0
202501,15516000,2S2,0,3,-3,0
202501,15516000,2S3,0,1,-1,0
202501,15516000,3,4,13,-9,0.31
202501,15516000,3S2,28,4,24,7
202501,15516000,3S3,151,36,115,4.19
202501,15516000,CA,30,161,-131,0.19
202501,15516000,V2,0,2,-2,0
202501,15516000,V3,0,4,-4,0
202501,15516000,V4R2,0,4,-4,0
202501,15516001,2,0,2,-2,0
202501,15516002,2,0,2,-2,0
202501,15518000,2,0,5,-5,0
202501,15518000,3,1,1,0,1
202501,15518000,3S2,0,1,-1,0
202501,15518000,3S3,0,7,-7,0
202501,15518000,CA,0,2,-2,0
202501,15518000,V2,0,1,-1,0
202501,15518000,V3,0,5,-5,0
202501,15518001,2,0,1,-1,0
202501,15522000,2,0,5,-5,0
202501,15531000,2,0,13,-13,0
202501,15531000,CA,0,2,-2,0
202501,15537000,2,6,46,-40,0.13
202501,15537000,2S2,1,0,1,NA
202501,15537000,3,0,3,-3,0
202501,15537000,3S2,2,3,-1,0.67
202501,15537000,3S3,738,6,732,123
202501,15537000,CA,0,7,-7,0
202501,15537000,V2,4,0,4,NA
202501,15537000,V3,35,0,35,NA
202501,15537000,V4,44,0,44,NA
202501,15537001,2,0,2,-2,0
202501,15542000,2,5,27,-22,0.19
202501,15542000,3S2,2,0,2,NA
202501,15542000,3S3,17,11,6,1.55
202501,15542000,CA,1,10,-9,0.1
202501,15550000,2,0,3,-3,0
202501,15572000,2,54,726,-672,0.07
202501,15572000,2R2,0,5,-5,0
202501,15572000,2S2,0,1,-1,0
202501,15572000,2S3,7,2,5,3.5
202501,15572000,3,7,44,-37,0.16
202501,15572000,3S1,1,0,1,NA
202501,15572000,3S2,9,224,-215,0.04
202501,15572000,3S3,62,955,-893,0.06
202501,15572000,CA,24,186,-162,0.13
202501,15572000,V2,10,0,10,NA
202501,15572000,V3,71,4,67,17.75
202501,15572007,2,0,5,-5,0
202501,15572007,3S3,0,4,-4,0
202501,15572007,CA,1,0,1,NA
202501,15572014,2,1,0,1,NA
202501,15572014,3S2,0,94,-94,0
202501,15572014,3S3,0,171,-171,0
202501,15572014,V3,2,1,1,2
202501,15580000,2,0,6,-6,0
202501,15580000,CA,0,4,-4,0
202501,15599000,2,1,27,-26,0.04
202501,15599000,3S3,0,8,-8,0
202501,15599000,CA,0,10,-10,0
202501,15600000,2,0,15,-15,0
202501,15600000,3S3,55,3,52,18.33
202501,15600000,CA,26,38,-12,0.68
202501,15600000,V3,44,0,44,NA
202501,15600000,V4,105,0,105,NA
202501,15621000,2,0,3,-3,0
202501,15632000,2,0,11,-11,0
202501,15632000,CA,0,6,-6,0
202501,15638000,2,0,14,-14,0
202501,15638000,3,0,1,-1,0
202501,15638000,3S3,0,2,-2,0
202501,15638000,CA,0,4,-4,0
202501,15646000,2,6,103,-97,0.06
202501,15646000,2S2,0,1,-1,0
202501,15646000,2S3,0,3,-3,0
202501,15646000,3,5,4,1,1.25
202501,15646000,3S2,20,17,3,1.18
202501,15646000,3S3,2922,482,2440,6.06
202501,15646000,4,3,12,-9,0.25
202501,15646000,CA,3,31,-28,0.1
202501,15646000,V2,1,70,-69,0.01
202501,15646000,V3,267,560,-293,0.48
202501,15646000,V3R2,0,6,-6,0
202501,15646000,V4,64,228,-164,0.28
202501,15646000,V4R2,6,31,-25,0.19
202501,15646001,CA,0,1,-1,0
202501,15660000,CA,0,22,-22,0
202501,15664000,2,1,22,-21,0.05
202501,15664000,3,1,0,1,NA
202501,15664000,3S3,0,1,-1,0
202501,15664000,CA,0,4,-4,0
202501,15667000,2,1,8,-7,0.12
202501,15667000,3,1,0,1,NA
202501,15667000,CA,25,30,-5,0.83
202501,15673000,2,0,8,-8,0
202501,15676000,2,0,20,-20,0
202501,15681000,2,0,3,-3,0
202501,15681000,CA,1,1,0,1
202501,15686000,2,25,95,-70,0.26
202501,15686000,3,0,13,-13,0
202501,15686000,3S3,0,17,-17,0
202501,15686000,CA,2,4,-2,0.5
202501,15690000,2,4,31,-27,0.13
202501,15690000,3,0,6,-6,0
202501,15690000,CA,0,2,-2,0
202501,15693000,2,0,43,-43,0
202501,15693000,2S2,0,1,-1,0
202501,15693000,2S3,0,1,-1,0
202501,15693000,3,1,4,-3,0.25
202501,15693000,3S3,0,3,-3,0
202501,15693000,CA,0,2,-2,0
202501,15696000,2,2,19,-17,0.11
202501,15696000,CA,0,7,-7,0
202501,15720000,2,0,8,-8,0
202501,15723000,2,0,5,-5,0
202501,15740000,2,0,7,-7,0
202501,15740000,3S3,0,6,-6,0
202501,15740000,CA,0,6,-6,0
202501,15753000,2,5,73,-68,0.07
202501,15753000,2S2,0,1,-1,0
202501,15753000,3S2,0,1,-1,0
202501,15753000,3S3,1,13,-12,0.08
202501,15753000,CA,46,77,-31,0.6
202501,15755000,2,0,9,-9,0
202501,15755000,3S3,12,1,11,12
202501,15755000,CA,0,2,-2,0
202501,15755000,V3R2,26,0,26,NA
202501,15757000,2,26,57,-31,0.46
202501,15757000,3S2,19,0,19,NA
202501,15757000,3S3,1504,8,1496,188
202501,15757000,CA,0,20,-20,0
202501,15757000,V2,7,16,-9,0.44
202501,15757000,V3,51,110,-59,0.46
202501,15757000,V3R2,6,26,-20,0.23
202501,15757000,V4,79,35,44,2.26
202501,15757000,V4R2,23,0,23,NA
202501,15757003,3S3,10,0,10,NA
202501,15759000,2,487,2248,-1761,0.22
202501,15759000,2R2,0,11,-11,0
202501,15759000,2R3,0,2,-2,0
202501,15759000,2S2,25,20,5,1.25
202501,15759000,2S3,1,0,1,NA
202501,15759000,3,108,96,12,1.12
202501,15759000,3S2,248,64,184,3.88
202501,15759000,3S3,1877,791,1086,2.37
202501,15759000,4,0,2,-2,0
202501,15759000,CA,44,845,-801,0.05
202501,15759000,V2,15,2,13,7.5
202501,15759000,V3,7,62,-55,0.11
202501,15759000,V4,8,11,-3,0.73
202501,15759001,2,0,2,-2,0
202501,15761000,2,0,29,-29,0
202501,15761000,CA,0,1,-1,0
202501,15762000,2,0,2,-2,0
202501,15762000,3S2,0,1,-1,0
202501,15762000,CA,0,1,-1,0
202501,15763000,2,14,16,-2,0.88
202501,15763000,2R3,0,1,-1,0
202501,15763000,2S3,1,4,-3,0.25
202501,15763000,3,0,14,-14,0
202501,15763000,3S2,1,20,-19,0.05
202501,15763000,3S3,2,9,-7,0.22
202501,15763000,CA,2,27,-25,0.07
202501,15764000,2,6,41,-35,0.15
202501,15764000,2R3,0,1,-1,0
202501,15764000,2S3,0,3,-3,0
202501,15764000,3S2,1,2,-1,0.5
202501,15764000,3S3,2,12,-10,0.17
202501,15764000,CA,2,26,-24,0.08
202501,15774000,2,0,3,-3,0
202501,15774000,CA,0,2,-2,0
202501,15776000,2,0,36,-36,0
202501,15776000,3S3,0,3,-3,0
202501,15776000,CA,0,11,-11,0
202501,15778000,2,0,7,-7,0
202501,15790000,2,0,7,-7,0
202501,15790000,3,0,2,-2,0
202501,15790000,3S3,267,2,265,133.5
202501,15790000,CA,0,10,-10,0
202501,15790000,V2,16,6,10,2.67
202501,15790000,V3,110,14,96,7.86
202501,15790000,V4,43,0,43,NA
202501,15798000,2,0,9,-9,0
202501,15798000,CA,0,2,-2,0
202501,15804000,2,0,18,-18,0
202501,15804000,3,0,4,-4,0
202501,15804000,3S3,0,4,-4,0
202501,15804000,CA,0,12,-12,0
202501,15806000,2,19,288,-269,0.07
202501,15806000,2S2,23,215,-192,0.11
202501,15806000,2S3,52,112,-60,0.46
202501,15806000,3,0,5,-5,0
202501,15806000,3S1,0,3,-3,0
202501,15806000,3S2,1,5,-4,0.2
202501,15806000,3S3,2138,1347,791,1.59
202501,15806000,CA,11,47,-36,0.23
202501,15808000,2,0,6,-6,0
202501,15808000,3S3,0,1,-1,0
202501,15808000,CA,0,23,-23,0
202501,15810000,2,0,6,-6,0
202501,15810000,CA,0,1,-1,0
202501,15814000,2,16,52,-36,0.31
202501,15814000,3S3,0,13,-13,0
202501,15814000,CA,6,14,-8,0.43
202501,15816000,2,1,3,-2,0.33
202501,15816000,3S3,0,1,-1,0
202501,15820000,2,1,5,-4,0.2
202501,15820000,3,1,0,1,NA
202501,15820000,3S2,19,0,19,NA
202501,15820000,3S3,252,0,252,NA
202501,15820000,CA,0,2,-2,0
202501,15820000,V3,56,0,56,NA
202501,15822000,2,0,13,-13,0
202501,15822000,CA,0,2,-2,0
202501,15835000,2,0,8,-8,0
202501,15835000,3,0,1,-1,0
202501,15835000,3S3,0,3,-3,0
202501,15835000,CA,0,3,-3,0
202501,15837000,2,286,405,-119,0.71
202501,15837000,2S2,0,1,-1,0
202501,15837000,3,39,68,-29,0.57
202501,15837000,3S2,15,28,-13,0.54
202501,15837000,3S3,767,1015,-248,0.76
202501,15837000,CA,3,26,-23,0.12
202501,15837000,V2,0,19,-19,0
202501,15837000,V3,202,0,202,NA
202501,15837006,3S3,2,0,2,NA
202501,15837008,2,6,0,6,NA
202501,15839000,2,0,4,-4,0
202501,15842000,2,0,4,-4,0
202501,15842000,3S3,0,5,-5,0
202501,15842000,CA,0,9,-9,0
202501,15861000,2,19,55,-36,0.35
202501,15861000,2R3,0,1,-1,0
202501,15861000,3,0,1,-1,0
202501,15861000,3S3,0,15,-15,0
202501,15861000,CA,3,17,-14,0.18
202501,15861000,V3,0,1,-1,0
202501,15861005,2,0,2,-2,0
202501,15861007,3S3,0,3,-3,0
202501,15879000,2,0,2,-2,0
202501,15897000,2,0,6,-6,0
202501,15897000,3S2,1,1,0,1
202501,15897000,3S3,1,0,1,NA
202501,15897000,CA,0,1,-1,0
202501,17001000,2,4129,6180,-2051,0.67
202501,17001000,2R2,0,1,-1,0
202501,17001000,2R3,0,8,-8,0
202501,17001000,2S2,502,612,-110,0.82
202501,17001000,2S3,126,162,-36,0.78
202501,17001000,3,160,148,12,1.08
202501,17001000,3S1,0,6,-6,0
202501,17001000,3S2,464,362,102,1.28
202501,17001000,3S3,1824,2213,-389,0.82
202501,17001000,4,3,1,2,3
202501,17001000,CA,774,2046,-1272,0.38
202501,17001000,V2,1,0,1,NA
202501,17001000,V3,0,1,-1,0
202501,17001000,V4,1,0,1,NA
202501,17001004,2,1,0,1,NA
202501,17001009,2,0,1,-1,0
202501,17001013,CA,0,1,-1,0
202501,17001022,2,0,1,-1,0
202501,17001027,2,0,1,-1,0
202501,17001027,3S2,0,2,-2,0
202501,17001027,3S3,0,82,-82,0
202501,17001029,2,0,6,-6,0
202501,17013000,2,128,214,-86,0.6
202501,17013000,3,0,15,-15,0
202501,17013000,3S3,0,4,-4,0
202501,17013000,CA,3,76,-73,0.04
202501,17013000,V2,1,0,1,NA
202501,17013000,V3,0,3,-3,0
202501,17013001,2,0,1,-1,0
202501,17013017,V3,0,1,-1,0
202501,17042000,2,24,174,-150,0.14
202501,17042000,2R2,0,1,-1,0
202501,17042000,2S2,0,2,-2,0
202501,17042000,3,1,3,-2,0.33
202501,17042000,3S2,9,10,-1,0.9
202501,17042000,3S3,56,51,5,1.1
202501,17042000,CA,0,55,-55,0
202501,17050000,2,147,65,82,2.26
202501,17050000,2R2,0,1,-1,0
202501,17050000,2S2,0,2,-2,0
202501,17050000,3,0,2,-2,0
202501,17050000,3S3,0,30,-30,0
202501,17050000,CA,0,33,-33,0
202501,17088000,2,5,76,-71,0.07
202501,17088000,3,1,0,1,NA
202501,17088000,CA,0,10,-10,0
202501,17174000,2,373,591,-218,0.63
202501,17174000,2R2,0,22,-22,0
202501,17174000,2R3,0,1,-1,0
202501,17174000,2S2,28,41,-13,0.68
202501,17174000,2S3,49,70,-21,0.7
202501,17174000,3,18,9,9,2
202501,17174000,3S2,65,34,31,1.91
202501,17174000,3S3,393,423,-30,0.93
202501,17174000,4,15,0,15,NA
202501,17174000,CA,12,226,-214,0.05
202501,17174011,2,0,1,-1,0
202501,17174011,CA,3,0,3,NA
202501,17272000,2,1,20,-19,0.05
202501,17272000,3S3,0,2,-2,0
202501,17272000,CA,0,20,-20,0
202501,17272005,2,0,2,-2,0
202501,17380000,2,744,954,-210,0.78
202501,17380000,2S2,1,13,-12,0.08
202501,17380000,2S3,0,2,-2,0
202501,17380000,3,41,23,18,1.78
202501,17380000,3S2,22,6,16,3.67
202501,17380000,3S3,70,187,-117,0.37
202501,17380000,3S4,4,3,1,1.33
202501,17380000,CA,343,221,122,1.55
202501,17380000,V2,0,1,-1,0
202501,17380000,V3,0,2,-2,0
202501,17380001,2S2,0,1,-1,0
202501,17380002,2,2,0,2,NA
202501,17380002,3S2,0,1,-1,0
202501,17380002,3S3,5,7,-2,0.71
202501,17380003,2,1,1,0,1
202501,17388000,2,0,15,-15,0
202501,17388000,CA,0,12,-12,0
202501,17388002,2,1,0,1,NA
202501,17388002,3S3,0,12,-12,0
202501,17388008,2,0,4,-4,0
202501,17388008,CA,0,1,-1,0
202501,17433000,2,43,92,-49,0.47
202501,17433000,2S2,0,1,-1,0
202501,17433000,3,6,0,6,NA
202501,17433000,3S3,10,7,3,1.43
202501,17433000,CA,0,52,-52,0
202501,17442000,2,10,85,-75,0.12
202501,17442000,2S2,0,1,-1,0
202501,17442000,3,1,31,-30,0.03
202501,17442000,3S2,1,1,0,1
202501,17442000,3S3,0,1,-1,0
202501,17442000,CA,1,27,-26,0.04
202501,17444000,2,30,84,-54,0.36
202501,17444000,2S2,0,2,-2,0
202501,17444000,3,0,8,-8,0
202501,17444000,3S3,1,1,0,1
202501,17444000,CA,0,3,-3,0
202501,17444001,2,0,1,-1,0
202501,17446000,2,0,1,-1,0
202501,17446000,2S2,0,1,-1,0
202501,17446000,CA,0,12,-12,0
202501,17486000,2,11,144,-133,0.08
202501,17486000,2S2,1,9,-8,0.11
202501,17486000,3,2,5,-3,0.4
202501,17486000,3S3,1,12,-11,0.08
202501,17486000,CA,1,72,-71,0.01
202501,17486008,3S3,0,1,-1,0
202501,17486009,2,0,3,-3,0
202501,17486012,2,0,1,-1,0
202501,17486012,3,0,1,-1,0
202501,17486012,CA,0,5,-5,0
202501,17495000,2,6,24,-18,0.25
202501,17495000,2S2,0,2,-2,0
202501,17495000,3,0,13,-13,0
202501,17495000,3S2,1,0,1,NA
202501,17495000,3S3,0,1,-1,0
202501,17495000,CA,0,9,-9,0
202501,17495000,V3,0,1,-1,0
202501,17513000,2,4,57,-53,0.07
202501,17513000,2S2,0,2,-2,0
202501,17513000,3,0,12,-12,0
202501,17513000,CA,0,14,-14,0
202501,17513000,V2,1,1,0,1
202501,17513000,V3,0,1,-1,0
202501,17513001,2,2,0,2,NA
202501,17524000,2,4,82,-78,0.05
202501,17524000,2S2,0,2,-2,0
202501,17524000,3,2,0,2,NA
202501,17524000,3S3,0,3,-3,0
202501,17524000,CA,0,54,-54,0
202501,17524001,2,10,53,-43,0.19
202501,17524001,3,2,0,2,NA
202501,17524001,3S2,0,2,-2,0
202501,17524001,3S3,1,176,-175,0.01
202501,17524001,CA,2,27,-25,0.07
202501,17524003,2,0,12,-12,0
202501,17524005,2,1,1,0,1
202501,17524005,3S3,1,0,1,NA
202501,17524006,2,1,0,1,NA
202501,17541000,2,30,127,-97,0.24
202501,17541000,2S2,0,4,-4,0
202501,17541000,3,0,5,-5,0
202501,17541000,3S3,7,12,-5,0.58
202501,17541000,CA,2,86,-84,0.02
202501,17541000,V3,0,1,-1,0
202501,17541002,2,5,11,-6,0.45
202501,17614000,2,12,314,-302,0.04
202501,17614000,2R2,0,12,-12,0
202501,17614000,2S2,2,5,-3,0.4
202501,17614000,3,2,9,-7,0.22
202501,17614000,3S2,1,0,1,NA
202501,17614000,3S3,14,46,-32,0.3
202501,17614000,CA,4,121,-117,0.03
202501,17614004,2,0,13,-13,0
202501,17616000,2,3,51,-48,0.06
202501,17616000,2S2,0,4,-4,0
202501,17616000,3S2,2,2,0,1
202501,17616000,3S3,2,2,0,1
202501,17616000,4,0,2,-2,0
202501,17616000,CA,0,30,-30,0
202501,17616001,3S3,0,7,-7,0
202501,17653000,2,9,116,-107,0.08
202501,17653000,2S2,0,4,-4,0
202501,17653000,3,0,4,-4,0
202501,17653000,3S3,0,1,-1,0
202501,17653000,CA,1,42,-41,0.02
202501,17653007,2,0,1,-1,0
202501,17662000,2,23,63,-40,0.37
202501,17662000,2S2,0,4,-4,0
202501,17662000,3,0,9,-9,0
202501,17662000,3S3,0,1,-1,0
202501,17662000,CA,1,4,-3,0.25
202501,17662000,V3,0,5,-5,0
202501,17662003,2,4,9,-5,0.44
202501,17662003,CA,0,1,-1,0
202501,17662007,2,0,1,-1,0
202501,17662007,2S2,0,2,-2,0
202501,17665000,2,3,9,-6,0.33
202501,17665000,CA,0,1,-1,0
202501,17777000,2,7,396,-389,0.02
202501,17777000,2R2,0,8,-8,0
202501,17777000,2S2,0,4,-4,0
202501,17777000,3,1,0,1,NA
202501,17777000,3S2,3,0,3,NA
202501,17777000,3S3,2,14,-12,0.14
202501,17777000,CA,1,172,-171,0.01
202501,17777000,V2,0,1,-1,0
202501,17867000,2,2,32,-30,0.06
202501,17867000,2S2,0,3,-3,0
202501,17867000,3S3,0,6,-6,0
202501,17867000,CA,0,5,-5,0
202501,17873000,2,3,352,-349,0.01
202501,17873000,2S2,4,7,-3,0.57
202501,17873000,2S3,0,1,-1,0
202501,17873000,3,0,6,-6,0
202501,17873000,3S2,0,2,-2,0
202501,17873000,3S3,0,40,-40,0
202501,17873000,CA,1,142,-141,0.01
202501,17873004,2,0,3,-3,0
202501,17873004,3,0,1,-1,0
202501,17873004,3S3,5,0,5,NA
202501,17873004,CA,1,4,-3,0.25
202501,17873006,2,0,1,-1,0
202501,17877000,2,53,168,-115,0.32
202501,17877000,2S2,0,2,-2,0
202501,17877000,3,5,11,-6,0.45
202501,17877000,3S2,5,2,3,2.5
202501,17877000,3S3,1,22,-21,0.05
202501,17877000,CA,0,68,-68,0
202501,18001000,2,445,1704,-1259,0.26
202501,18001000,2R2,0,3,-3,0
202501,18001000,2S2,1,48,-47,0.02
202501,18001000,2S3,1,0,1,NA
202501,18001000,3,31,135,-104,0.23
202501,18001000,3S2,2,38,-36,0.05
202501,18001000,3S3,91,594,-503,0.15
202501,18001000,CA,68,259,-191,0.26
202501,18001002,2,0,1,-1,0
202501,18001013,2,0,2,-2,0
202501,18001013,3,0,1,-1,0
202501,18001013,3S3,4,3,1,1.33
202501,18029000,2,0,4,-4,0
202501,18029000,3S2,1,0,1,NA
202501,18029000,3S3,0,2,-2,0
202501,18094000,2,1,1,0,1
202501,18094000,3S3,0,2,-2,0
202501,18094000,CA,1,0,1,NA
202501,18150000,2,3,94,-91,0.03
202501,18150000,3,0,15,-15,0
202501,18150000,3S2,0,1,-1,0
202501,18150000,3S3,3,32,-29,0.09
202501,18150000,CA,1,22,-21,0.05
202501,18150000,V2,0,1,-1,0
202501,18205000,2,1,12,-11,0.08
202501,18205000,3,1,2,-1,0.5
202501,18205000,3S3,1,2,-1,0.5
202501,18205000,CA,0,12,-12,0
202501,18247000,2,2,46,-44,0.04
202501,18247000,3,0,5,-5,0
202501,18247000,3S3,1,6,-5,0.17
202501,18247000,CA,1,17,-16,0.06
202501,18247000,V3,0,2,-2,0
202501,18256000,2,0,20,-20,0
202501,18256000,3S3,0,3,-3,0
202501,18410000,2,2,3,-1,0.67
202501,18410000,2S2,1,0,1,NA
202501,18410000,3S2,0,1,-1,0
202501,18410000,3S3,0,1,-1,0
202501,18410000,CA,1,1,0,1
202501,18410002,2,0,1,-1,0
202501,18460000,2,0,4,-4,0
202501,18460000,CA,0,1,-1,0
202501,18460000,V2,1,0,1,NA
202501,18460001,2,0,1,-1,0
202501,18479000,2,1,2,-1,0.5
202501,18479000,2S2,0,1,-1,0
202501,18479000,2S3,0,1,-1,0
202501,18479000,3S2,0,1,-1,0
202501,18479000,3S3,2,7,-5,0.29
202501,18592000,2,1,32,-31,0.03
202501,18592000,3,0,3,-3,0
202501,18592000,3S3,0,8,-8,0
202501,18592000,CA,2,5,-3,0.4
202501,18610000,2,0,18,-18,0
202501,18610000,3S2,1,0,1,NA
202501,18610000,3S3,0,1,-1,0
202501,18610001,2,0,7,-7,0
202501,18610001,CA,1,0,1,NA
202501,18610002,2,0,1,-1,0
202501,18610002,3S2,6,0,6,NA
202501,18610002,3S3,30,0,30,NA
202501,18610003,2,0,1,-1,0
202501,18753000,2,12,367,-355,0.03
202501,18753000,3,1,18,-17,0.06
202501,18753000,3S2,0,3,-3,0
202501,18753000,3S3,7,41,-34,0.17
202501,18753000,CA,1,26,-25,0.04
202501,18753003,2,0,10,-10,0
202501,18753004,2,0,1,-1,0
202501,18753006,2,0,3,-3,0
202501,18756000,CA,0,1,-1,0
202501,18756008,2,0,5,-5,0
202501,18785000,2,0,9,-9,0
202501,18785000,3,0,28,-28,0
202501,18785000,3S3,0,6,-6,0
202501,18785000,CA,0,2,-2,0
202501,18860000,2,2,2,0,1
202501,18860000,3S3,0,3,-3,0
202501,18860000,CA,1,0,1,NA
202501,19001000,2,826,3322,-2496,0.25
202501,19001000,2S2,7,81,-74,0.09
202501,19001000,2S3,0,35,-35,0
202501,19001000,3,11,150,-139,0.07
202501,19001000,3S2,33,98,-65,0.34
202501,19001000,3S3,312,919,-607,0.34
202501,19001000,3S4,1,1,0,1
202501,19001000,CA,360,796,-436,0.45
202501,19001000,V2,1,0,1,NA
202501,19001008,2,4,0,4,NA
202501,19022000,2,1,26,-25,0.04
202501,19022000,CA,0,1,-1,0
202501,19050000,2,3,97,-94,0.03
202501,19050000,3,0,3,-3,0
202501,19050000,CA,0,16,-16,0
202501,19050000,V3,0,4,-4,0
202501,19050001,2,0,14,-14,0
202501,19050001,3,0,3,-3,0
202501,19050006,2,0,24,-24,0
202501,19050006,CA,0,2,-2,0
202501,19050007,2,0,2,-2,0
202501,19050008,2,0,3,-3,0
202501,19050016,2,0,1,-1,0
202501,19075000,2,2,53,-51,0.04
202501,19075000,2S2,0,2,-2,0
202501,19075000,2S3,0,1,-1,0
202501,19075000,3,0,2,-2,0
202501,19075000,3S3,0,8,-8,0
202501,19075000,CA,0,11,-11,0
202501,19075000,V2,0,1,-1,0
202501,19075002,2,1,2,-1,0.5
202501,19100000,2,1,41,-40,0.02
202501,19100000,3,1,6,-5,0.17
202501,19100000,3S2,1,0,1,NA
202501,19100000,3S3,0,2,-2,0
202501,19100000,CA,0,4,-4,0
202501,19100004,3S3,0,1,-1,0
202501,19100021,2,0,5,-5,0
202501,19110000,2,2,14,-12,0.14
202501,19110000,3,0,2,-2,0
202501,19110000,CA,0,1,-1,0
202501,19110012,2,0,2,-2,0
202501,19110012,3S3,0,20,-20,0
202501,19130000,2,0,26,-26,0
202501,19130000,3,0,11,-11,0
202501,19130000,CA,0,34,-34,0
202501,19130010,2,0,1,-1,0
202501,19137000,2,3,15,-12,0.2
202501,19137000,3,1,3,-2,0.33
202501,19137000,3S3,2,0,2,NA
202501,19137000,CA,0,43,-43,0
202501,19137004,2,1,7,-6,0.14
202501,19137008,2,1,1,0,1
202501,19137008,CA,0,1,-1,0
202501,19142000,2,1600,734,866,2.18
202501,19142000,2B1,4,1,3,4
202501,19142000,2B2,4,3,1,1.33
202501,19142000,2R2,1,0,1,NA
202501,19142000,2S1,0,3,-3,0
202501,19142000,2S2,138,135,3,1.02
202501,19142000,2S3,25,41,-16,0.61
202501,19142000,3,73,22,51,3.32
202501,19142000,3S1,0,6,-6,0
202501,19142000,3S2,236,128,108,1.84
202501,19142000,3S3,912,1019,-107,0.89
202501,19142000,CA,197,193,4,1.02
202501,19142006,2,205,74,131,2.77
202501,19142006,2S2,30,6,24,5
202501,19142006,2S3,5,1,4,5
202501,19142006,3,1,0,1,NA
202501,19142006,3S2,121,50,71,2.42
202501,19142006,3S3,211,198,13,1.07
202501,19142006,CA,1,8,-7,0.12
202501,19142020,2S2,0,1,-1,0
202501,19142020,CA,0,1,-1,0
202501,19142028,2,1,0,1,NA
202501,19212000,2,2,131,-129,0.02
202501,19212000,3,0,8,-8,0
202501,19212000,3S3,0,1,-1,0
202501,19212000,CA,1,82,-81,0.01
202501,19256000,2,0,56,-56,0
202501,19256000,3,0,8,-8,0
202501,19256000,3S2,0,1,-1,0
202501,19256000,3S3,0,6,-6,0
202501,19256000,CA,0,16,-16,0
202501,19256018,2,0,3,-3,0
202501,19256018,2R3,0,1,-1,0
202501,19256018,2S2,3,0,3,NA
202501,19256018,3S3,2,2,0,1
202501,19256018,CA,0,24,-24,0
202501,19256050,CA,0,1,-1,0
202501,19290000,2,0,45,-45,0
202501,19290000,3S3,0,6,-6,0
202501,19290000,CA,0,7,-7,0
202501,19300000,2,247,76,171,3.25
202501,19300000,2S2,90,51,39,1.76
202501,19300000,2S3,21,20,1,1.05
202501,19300000,3,1,0,1,NA
202501,19300000,3S1,11,0,11,NA
202501,19300000,3S2,51,26,25,1.96
202501,19300000,3S3,240,261,-21,0.92
202501,19300000,CA,32,5,27,6.4
202501,19300000,V2,0,6,-6,0
202501,19318000,2,0,3,-3,0
202501,19318000,CA,0,6,-6,0
202501,19355000,2,0,30,-30,0
202501,19355000,3,0,8,-8,0
202501,19355000,3S3,0,8,-8,0
202501,19355012,2,0,11,-11,0
202501,19355012,3S3,0,1,-1,0
202501,19355012,CA,0,9,-9,0
202501,19364000,2,0,4,-4,0
202501,19392000,2,1,14,-13,0.07
202501,19392000,CA,0,6,-6,0
202501,19397000,2,1,14,-13,0.07
202501,19397000,3S2,0,3,-3,0
202501,19397000,3S3,1,0,1,NA
202501,19397000,CA,0,3,-3,0
202501,19418000,2,0,1,-1,0
202501,19418020,2S3,0,2,-2,0
202501,19418020,3S3,0,14,-14,0
202501,19418033,2,0,1,-1,0
202501,19450000,2,3,56,-53,0.05
202501,19450000,3,0,3,-3,0
202501,19450000,3S2,0,1,-1,0
202501,19450000,3S3,2,3,-1,0.67
202501,19450000,CA,0,4,-4,0
202501,19450019,2,1,5,-4,0.2
202501,19450019,3S2,1,0,1,NA
202501,19455000,2,59,177,-118,0.33
202501,19455000,2S2,6,16,-10,0.38
202501,19455000,2S3,2,5,-3,0.4
202501,19455000,3,2,8,-6,0.25
202501,19455000,3S2,10,8,2,1.25
202501,19455000,3S3,579,101,478,5.73
202501,19455000,CA,4,78,-74,0.05
202501,19455005,2,95,6,89,15.83
202501,19455005,2S1,0,1,-1,0
202501,19455005,3,0,6,-6,0
202501,19455005,3S1,0,3,-3,0
202501,19455005,3S2,0,3,-3,0
202501,19455005,3S3,207,22,185,9.41
202501,19455005,CA,16,2,14,8
202501,19473000,2,5,56,-51,0.09
202501,19473000,2S3,0,2,-2,0
202501,19473000,3,0,1,-1,0
202501,19473000,3S3,0,8,-8,0
202501,19473000,CA,0,63,-63,0
202501,19513000,2,0,25,-25,0
202501,19513000,CA,0,1,-1,0
202501,19513008,3S2,0,1,-1,0
202501,19517000,2,0,14,-14,0
202501,19517000,3S3,0,4,-4,0
202501,19517000,CA,0,6,-6,0
202501,19517006,2,0,1,-1,0
202501,19532000,2,4,229,-225,0.02
202501,19532000,2S2,0,1,-1,0
202501,19532000,3,0,3,-3,0
202501,19532000,3S2,1,0,1,NA
202501,19532000,3S3,0,25,-25,0
202501,19532000,CA,23,38,-15,0.61
202501,19532005,2,0,5,-5,0
202501,19532008,2,0,17,-17,0
202501,19532008,3S3,0,2,-2,0
202501,19532008,CA,0,7,-7,0
202501,19532009,2,0,1,-1,0
202501,19532009,3,0,7,-7,0
202501,19532013,2,0,6,-6,0
202501,19532013,3S3,0,4,-4,0
202501,19533000,3,24,0,24,NA
202501,19533000,3S3,0,2,-2,0
202501,19533000,CA,0,2,-2,0
202501,19548000,2,7,119,-112,0.06
202501,19548000,2S2,1,0,1,NA
202501,19548000,2S3,0,2,-2,0
202501,19548000,3,0,3,-3,0
202501,19548000,3S2,0,1,-1,0
202501,19548000,3S3,0,23,-23,0
202501,19548000,4,0,1,-1,0
202501,19548000,CA,1,36,-35,0.03
202501,19548001,2,1,0,1,NA
202501,19573000,2,1305,526,779,2.48
202501,19573000,2B1,26,3,23,8.67
202501,19573000,2B2,1,0,1,NA
202501,19573000,2R2,11,5,6,2.2
202501,19573000,2S2,193,59,134,3.27
202501,19573000,2S3,23,26,-3,0.88
202501,19573000,3,29,26,3,1.12
202501,19573000,3S1,0,2,-2,0
202501,19573000,3S2,38,71,-33,0.54
202501,19573000,3S3,492,452,40,1.09
202501,19573000,CA,132,120,12,1.1
202501,19573003,3S3,1,0,1,NA
202501,19585000,2,0,5,-5,0
202501,19585000,CA,0,10,-10,0
202501,19585001,2,1,5,-4,0.2
202501,19585001,CA,0,3,-3,0
202501,19585004,2,0,7,-7,0
202501,19585004,CA,0,1,-1,0
202501,19622000,2,2,19,-17,0.11
202501,19622000,CA,0,27,-27,0
202501,19693000,2,0,9,-9,0
202501,19693001,2,0,3,-3,0
202501,19693001,CA,0,2,-2,0
202501,19693005,2,0,3,-3,0
202501,19698000,2,711,1275,-564,0.56
202501,19698000,2B1,2,0,2,NA
202501,19698000,2S1,0,7,-7,0
202501,19698000,2S2,138,57,81,2.42
202501,19698000,2S3,29,23,6,1.26
202501,19698000,3,19,36,-17,0.53
202501,19698000,3S1,5,5,0,1
202501,19698000,3S2,67,63,4,1.06
202501,19698000,3S3,174,392,-218,0.44
202501,19698000,4,0,1,-1,0
202501,19698000,CA,16,518,-502,0.03
202501,19698000,V2,1,0,1,NA
202501,19698000,V3,1,0,1,NA
202501,19698007,2,14,34,-20,0.41
202501,19698007,CA,2,16,-14,0.12
202501,19698028,2,0,1,-1,0
202501,19698036,2,1,0,1,NA
202501,19701000,2,0,9,-9,0
202501,19701000,3S2,1,0,1,NA
202501,19701000,3S3,0,4,-4,0
202501,19701000,3S4,0,1,-1,0
202501,19701006,2,0,1,-1,0
202501,19701006,V2,1,1,0,1
202501,19743000,2,2,39,-37,0.05
202501,19743000,CA,0,30,-30,0
202501,19760000,2,0,1,-1,0
202501,19780000,2,5,72,-67,0.07
202501,19780000,3,0,7,-7,0
202501,19780000,CA,0,24,-24,0
202501,19780001,2,0,5,-5,0
202501,19780008,2,0,1,-1,0
202501,19785000,2,0,11,-11,0
202501,19785000,CA,0,5,-5,0
202501,19785001,CA,0,1,-1,0
202501,19807000,2,12,171,-159,0.07
202501,19807000,3S3,9,13,-4,0.69
202501,19807000,CA,1,67,-66,0.01
202501,19807009,2,0,2,-2,0
202501,19809000,2,0,3,-3,0
202501,19809000,CA,0,1,-1,0
202501,19821000,2,0,29,-29,0
202501,19821000,2S2,0,1,-1,0
202501,19821000,CA,0,1,-1,0
202501,19821007,2,1,2,-1,0.5
202501,19821007,3,0,1,-1,0
202501,19824000,2,0,11,-11,0
202501,19845000,2,1419,387,1032,3.67
202501,19845000,2S2,531,190,341,2.79
202501,19845000,2S3,42,35,7,1.2
202501,19845000,3,14,19,-5,0.74
202501,19845000,3S2,104,157,-53,0.66
202501,19845000,3S3,135,534,-399,0.25
202501,19845000,CA,130,155,-25,0.84
202501,20001000,2,2941,4850,-1909,0.61
202501,20001000,2B1,0,1,-1,0
202501,20001000,2B2,0,1,-1,0
202501,20001000,2R2,68,18,50,3.78
202501,20001000,2S2,19,288,-269,0.07
202501,20001000,2S3,9,76,-67,0.12
202501,20001000,3,44,148,-104,0.3
202501,20001000,3S1,0,1,-1,0
202501,20001000,3S2,170,383,-213,0.44
202501,20001000,3S3,459,1756,-1297,0.26
202501,20001000,3S4,2,2,0,1
202501,20001000,4,0,7,-7,0
202501,20001000,CA,428,695,-267,0.62
202501,20001001,2,0,7,-7,0
202501,20001002,2,0,1,-1,0
202501,20001003,2,1,2,-1,0.5
202501,20001005,3S3,3,0,3,NA
202501,20001005,CA,0,1,-1,0
202501,20001009,2,1,0,1,NA
202501,20001013,2,1,6,-5,0.17
202501,20001013,3,1,0,1,NA
202501,20001013,3S3,1,3,-2,0.33
202501,20001013,CA,0,1,-1,0
202501,20001014,2,0,1,-1,0
202501,20001018,2,2,4,-2,0.5
202501,20001018,2S3,0,2,-2,0
202501,20001018,3S2,0,1,-1,0
202501,20001018,3S3,7,2,5,3.5
202501,20001024,2,0,1,-1,0
202501,20001024,3S3,1,0,1,NA
202501,20001025,2,1,0,1,NA
202501,20001025,3S3,1,0,1,NA
202501,20001031,2,2,5,-3,0.4
202501,20011000,2,365,1358,-993,0.27
202501,20011000,2B1,0,1,-1,0
202501,20011000,2R2,2,2,0,1
202501,20011000,2R3,0,2,-2,0
202501,20011000,2S1,1,1,0,1
202501,20011000,2S2,14,9,5,1.56
202501,20011000,2S3,6,6,0,1
202501,20011000,3,42,141,-99,0.3
202501,20011000,3S1,1,0,1,NA
202501,20011000,3S2,280,203,77,1.38
202501,20011000,3S3,334,1951,-1617,0.17
202501,20011000,3S4,8,2,6,4
202501,20011000,CA,63,136,-73,0.46
202501,20011000,V3,0,10,-10,0
202501,20011002,CA,1,0,1,NA
202501,20011021,2,0,13,-13,0
202501,20013000,2,76,295,-219,0.26
202501,20013000,2S2,1,1,0,1
202501,20013000,2S3,4,0,4,NA
202501,20013000,3,2,3,-1,0.67
202501,20013000,3S2,27,5,22,5.4
202501,20013000,3S3,366,569,-203,0.64
202501,20013000,3S4,0,10,-10,0
202501,20013000,CA,25,85,-60,0.29
202501,20013002,2,10,1,9,10
202501,20013004,3S3,2,0,2,NA
202501,20032000,2,8,68,-60,0.12
202501,20032000,2S2,0,1,-1,0
202501,20032000,2S3,1,0,1,NA
202501,20032000,3,0,1,-1,0
202501,20032000,3S2,0,1,-1,0
202501,20032000,3S3,0,12,-12,0
202501,20032000,CA,1,0,1,NA
202501,20032001,2,1,3,-2,0.33
202501,20032001,3S3,2,2,0,1
202501,20045000,2,39,122,-83,0.32
202501,20045000,2R2,0,1,-1,0
202501,20045000,2S2,0,2,-2,0
202501,20045000,2S3,0,1,-1,0
202501,20045000,3S2,0,1,-1,0
202501,20045000,3S3,1,46,-45,0.02
202501,20045000,CA,3,26,-23,0.12
202501,20060000,2,381,378,3,1.01
202501,20060000,2R2,0,1,-1,0
202501,20060000,2S2,1,19,-18,0.05
202501,20060000,2S3,3,10,-7,0.3
202501,20060000,3,61,16,45,3.81
202501,20060000,3S2,26,198,-172,0.13
202501,20060000,3S3,102,248,-146,0.41
202501,20060000,CA,24,48,-24,0.5
202501,20060000,V3,8,0,8,NA
202501,20060002,3S3,0,1,-1,0
202501,20060004,2,1,0,1,NA
202501,20060004,3S2,4,0,4,NA
202501,20175000,2,7,27,-20,0.26
202501,20175000,3S3,1,6,-5,0.17
202501,20175000,CA,0,7,-7,0
202501,20175010,2,0,2,-2,0
202501,20175010,CA,0,1,-1,0
202501,20175011,2,3,4,-1,0.75
202501,20175011,CA,0,4,-4,0
202501,20175014,2,0,1,-1,0
202501,20175014,2S2,0,1,-1,0
202501,20175016,2,2,2,0,1
202501,20175016,3S3,4,0,4,NA
202501,20178000,2,12,70,-58,0.17
202501,20178000,2S2,0,1,-1,0
202501,20178000,2S3,0,1,-1,0
202501,20178000,3,0,5,-5,0
202501,20178000,3S2,0,12,-12,0
202501,20178000,3S3,2,31,-29,0.06
202501,20178000,CA,0,6,-6,0
202501,20178006,2,5,1,4,5
202501,20178006,2S3,1,0,1,NA
202501,20178008,2,0,3,-3,0
202501,20178011,2,0,1,-1,0
202501,20178018,2,0,1,-1,0
202501,20228000,2,67,304,-237,0.22
202501,20228000,2S2,1,0,1,NA
202501,20228000,2S3,2,1,1,2
202501,20228000,3,3,5,-2,0.6
202501,20228000,3S2,3,2,1,1.5
202501,20228000,3S3,58,91,-33,0.64
202501,20228000,CA,4,25,-21,0.16
202501,20228002,2,1,1,0,1
202501,20228002,3S3,16,15,1,1.07
202501,20228003,2,0,1,-1,0
202501,20228006,2,0,1,-1,0
202501,20228010,2,0,4,-4,0
202501,20238000,2,21,158,-137,0.13
202501,20238000,2S2,1,2,-1,0.5
202501,20238000,2S3,2,0,2,NA
202501,20238000,3,0,4,-4,0
202501,20238000,3S2,4,1,3,4
202501,20238000,3S3,56,33,23,1.7
202501,20238000,CA,5,8,-3,0.62
202501,20238002,3S2,0,1,-1,0
202501,20238002,3S3,1,2,-1,0.5
202501,20238003,2,0,1,-1,0
202501,20250000,2,19,100,-81,0.19
202501,20250000,2S1,0,1,-1,0
202501,20250000,2S2,3,1,2,3
202501,20250000,3,4,18,-14,0.22
202501,20250000,3S1,3,0,3,NA
202501,20250000,3S2,13,12,1,1.08
202501,20250000,3S3,145,211,-66,0.69
202501,20250000,3S4,21,5,16,4.2
202501,20250000,CA,0,13,-13,0
202501,20250000,V3,0,4,-4,0
202501,20250002,2,63,121,-58,0.52
202501,20250002,2S2,2,4,-2,0.5
202501,20250002,2S3,4,3,1,1.33
202501,20250002,3,0,7,-7,0
202501,20250002,3S2,0,1,-1,0
202501,20250002,3S3,29,373,-344,0.08
202501,20250002,CA,1,18,-17,0.06
202501,20250002,V3R3,7,0,7,NA
202501,20250004,2,2,4,-2,0.5
202501,20250004,3S2,0,1,-1,0
202501,20250004,3S3,4,20,-16,0.2
202501,20250004,CA,1,0,1,NA
202501,20295000,2,13,74,-61,0.18
202501,20295000,2S3,1,0,1,NA
202501,20295000,3,9,3,6,3
202501,20295000,3S2,1,1,0,1
202501,20295000,3S3,150,31,119,4.84
202501,20295000,CA,0,12,-12,0
202501,20295000,V2,0,19,-19,0
202501,20295000,V3,4,26,-22,0.15
202501,20295000,V4,1,61,-60,0.02
202501,20310000,2,0,1,-1,0
202501,20383000,2,93,28,65,3.32
202501,20383000,2S2,6,0,6,NA
202501,20383000,2S3,2,11,-9,0.18
202501,20383000,3,16,0,16,NA
202501,20383000,3S2,28,134,-106,0.21
202501,20383000,3S3,477,2943,-2466,0.16
202501,20383000,CA,1,7,-6,0.14
202501,20383001,2,2,0,2,NA
202501,20383001,3S2,13,24,-11,0.54
202501,20383001,3S3,177,840,-663,0.21
202501,20383001,CA,0,1,-1,0
202501,20383005,2,1,0,1,NA
202501,20383006,2,20,3,17,6.67
202501,20383006,3S3,0,6,-6,0
202501,20383010,2,9,11,-2,0.82
202501,20383010,3S2,1,7,-6,0.14
202501,20383010,3S3,15,86,-71,0.17
202501,20400000,2,79,254,-175,0.31
202501,20400000,2B1,1,0,1,NA
202501,20400000,2S2,24,21,3,1.14
202501,20400000,2S3,4,10,-6,0.4
202501,20400000,3,0,1,-1,0
202501,20400000,3S2,25,147,-122,0.17
202501,20400000,3S3,381,491,-110,0.78
202501,20400000,CA,11,47,-36,0.23
202501,20400000,V3,0,8,-8,0
202501,20400001,2,1,1,0,1
202501,20400001,CA,0,1,-1,0
202501,20400002,2,3,0,3,NA
202501,20400002,CA,0,1,-1,0
202501,20443000,2,2,43,-41,0.05
202501,20443000,3,0,8,-8,0
202501,20443000,3S3,4,6,-2,0.67
202501,20517000,2,16,66,-50,0.24
202501,20517000,2S2,1,0,1,NA
202501,20517000,3,1,0,1,NA
202501,20517000,3S3,6,22,-16,0.27
202501,20517000,CA,2,4,-2,0.5
202501,20517002,2,0,1,-1,0
202501,20517002,CA,0,3,-3,0
202501,20550000,2,15,100,-85,0.15
202501,20550000,2R2,0,1,-1,0
202501,20550000,3,3,7,-4,0.43
202501,20550000,3S2,0,2,-2,0
202501,20550000,3S3,9,85,-76,0.11
202501,20550000,CA,2,9,-7,0.22
202501,20550001,3S2,0,1,-1,0
202501,20550010,2,0,3,-3,0
202501,20570000,2,25,86,-61,0.29
202501,20570000,3S3,5,2,3,2.5
202501,20570000,CA,1,5,-4,0.2
202501,20614000,2,7,28,-21,0.25
202501,20614000,3,1,13,-12,0.08
202501,20614000,3S3,54,9,45,6
202501,20614000,3S4,1,3,-2,0.33
202501,20614000,CA,2,1,1,2
202501,20614000,V3,0,2,-2,0
202501,20614001,3S3,0,2,-2,0
202501,20614001,V3,0,1,-1,0
202501,20614006,3S3,19,0,19,NA
202501,20614012,2,0,1,-1,0
202501,20614012,3S2,19,0,19,NA
202501,20614012,3S3,16,18,-2,0.89
202501,20614012,3S4,1,0,1,NA
202501,20621000,2,137,154,-17,0.89
202501,20621000,2S2,2,2,0,1
202501,20621000,2S3,13,2,11,6.5
202501,20621000,3,2,12,-10,0.17
202501,20621000,3S2,8,4,4,2
202501,20621000,3S3,144,305,-161,0.47
202501,20621000,3S4,1,0,1,NA
202501,20621000,CA,1,31,-30,0.03
202501,20621006,2,1,0,1,NA
202501,20621011,3S3,0,8,-8,0
202501,20710000,2,151,161,-10,0.94
202501,20710000,2S2,1,4,-3,0.25
202501,20710000,2S3,1,1,0,1
202501,20710000,3,1,38,-37,0.03
202501,20710000,3S1,0,1,-1,0
202501,20710000,3S2,10,3,7,3.33
202501,20710000,3S3,192,64,128,3
202501,20710000,3S4,1,0,1,NA
202501,20710000,4,0,1,-1,0
202501,20710000,CA,2,63,-61,0.03
202501,20710000,V3R3,10,0,10,NA
202501,20710001,2,1,0,1,NA
202501,20710001,2S3,9,0,9,NA
202501,20710001,3S2,1,0,1,NA
202501,20710001,3S3,0,2,-2,0
202501,20750000,2,7,64,-57,0.11
202501,20750000,3,1,2,-1,0.5
202501,20750000,3S2,2,1,1,2
202501,20750000,3S3,6,8,-2,0.75
202501,20750000,CA,0,16,-16,0
202501,20750002,2,0,1,-1,0
202501,20750009,2,0,1,-1,0
202501,20770000,2,37,114,-77,0.32
202501,20770000,2R2,0,24,-24,0
202501,20770000,2S2,0,3,-3,0
202501,20770000,2S3,0,4,-4,0
202501,20770000,3,10,7,3,1.43
202501,20770000,3S1,5,1,4,5
202501,20770000,3S2,10,5,5,2
202501,20770000,3S3,1816,91,1725,19.96
202501,20770000,CA,3,37,-34,0.08
202501,20770000,V3,0,2,-2,0
202501,20770001,2,0,1,-1,0
202501,20770002,2,0,1,-1,0
202501,20770003,3S3,2,0,2,NA
202501,20770014,2,7,4,3,1.75
202501,20770014,3,0,4,-4,0
202501,20770014,3S2,8,22,-14,0.36
202501,20770014,3S3,918,8,910,114.75
202501,20770014,CA,1,4,-3,0.25
202501,20787000,2,2,10,-8,0.2
202501,20787000,3S3,2,8,-6,0.25
202501,20787000,CA,0,2,-2,0
202501,20787005,2,0,1,-1,0
202501,20787005,CA,1,0,1,NA
202501,23001000,2,2045,4527,-2482,0.45
202501,23001000,2B1,0,1,-1,0
202501,23001000,2B2,0,61,-61,0
202501,23001000,2R2,2,18,-16,0.11
202501,23001000,2R3,0,14,-14,0
202501,23001000,2S1,1,0,1,NA
202501,23001000,2S2,38,251,-213,0.15
202501,23001000,2S3,13,67,-54,0.19
202501,23001000,3,31,189,-158,0.16
202501,23001000,3S2,142,557,-415,0.25
202501,23001000,3S3,541,1863,-1322,0.29
202501,23001000,3S4,2,0,2,NA
202501,23001000,4,0,10,-10,0
202501,23001000,CA,834,643,191,1.3
202501,23001000,V3,20,0,20,NA
202501,23001001,2,0,3,-3,0
202501,23001001,2R2,3,0,3,NA
202501,23001001,3S2,3,0,3,NA
202501,23001001,3S3,0,1,-1,0
202501,23001005,2,1,0,1,NA
202501,23001009,3S2,2,0,2,NA
202501,23001010,2,4,0,4,NA
202501,23001011,2,1,0,1,NA
202501,23001014,2,2,0,2,NA
202501,23001017,2,1,0,1,NA
202501,23001019,3,4,0,4,NA
202501,23001020,2,2,1,1,2
202501,23001020,3S2,1,3,-2,0.33
202501,23001032,2S2,2,0,2,NA
202501,23001032,2S3,1,0,1,NA
202501,23068000,2,7,89,-82,0.08
202501,23068000,3,2,9,-7,0.22
202501,23068000,3S2,5,9,-4,0.56
202501,23068000,3S3,4,54,-50,0.07
202501,23068000,4,0,2,-2,0
202501,23068000,CA,0,17,-17,0
202501,23068014,2,0,1,-1,0
202501,23068014,3,0,8,-8,0
202501,23068014,CA,1,1,0,1
202501,23068014,V3,1,41,-40,0.02
202501,23079000,2,47,36,11,1.31
202501,23079000,2S3,1,0,1,NA
202501,23079000,3,0,1,-1,0
202501,23079000,3S2,1,0,1,NA
202501,23079000,3S3,3,59,-56,0.05
202501,23079000,CA,0,1,-1,0
202501,23079003,2,0,1,-1,0
202501,23079007,2,0,1,-1,0
202501,23079012,2,1,1,0,1
202501,23090000,2,26,6,20,4.33
202501,23090000,2S2,1,0,1,NA
202501,23090000,2S3,2,0,2,NA
202501,23090000,3,3,0,3,NA
202501,23090000,3S3,1,0,1,NA
202501,23090000,CA,0,4,-4,0
202501,23090020,3S3,72,0,72,NA
202501,23090022,3R3,24,0,24,NA
202501,23090022,3S3,1145,0,1145,NA
202501,23162000,2,1254,1073,181,1.17
202501,23162000,2B2,241,0,241,NA
202501,23162000,2R2,1,0,1,NA
202501,23162000,2R3,21,0,21,NA
202501,23162000,2S2,1,68,-67,0.01
202501,23162000,2S3,15,11,4,1.36
202501,23162000,3,27,95,-68,0.28
202501,23162000,3S2,10,129,-119,0.08
202501,23162000,3S3,316,961,-645,0.33
202501,23162000,4,0,2,-2,0
202501,23162000,CA,81,188,-107,0.43
202501,23162002,2,1,0,1,NA
202501,23162003,2,0,2,-2,0
202501,23162016,2,0,1,-1,0
202501,23162017,3S3,0,1,-1,0
202501,23168000,2,0,2,-2,0
202501,23168000,2S2,1,0,1,NA
202501,23168000,CA,0,1,-1,0
202501,23182000,2,21,136,-115,0.15
202501,23182000,2B2,0,3,-3,0
202501,23182000,2S2,0,1,-1,0
202501,23182000,2S3,1,0,1,NA
202501,23182000,3,0,12,-12,0
202501,23182000,3S2,1,0,1,NA
202501,23182000,3S3,9,10,-1,0.9
202501,23182000,CA,1,13,-12,0.08
202501,23182011,2,0,1,-1,0
202501,23182011,3,0,1,-1,0
202501,23189000,2,1140,488,652,2.34
202501,23189000,2R2,3,1,2,3
202501,23189000,2S2,1,2,-1,0.5
202501,23189000,2S3,1,8,-7,0.12
202501,23189000,3,89,27,62,3.3
202501,23189000,3S2,137,79,58,1.73
202501,23189000,3S3,299,733,-434,0.41
202501,23189000,CA,5,28,-23,0.18
202501,23189000,V3,782,3,779,260.67
202501,23189001,2,1,0,1,NA
202501,23300000,2,0,27,-27,0
202501,23300000,2S2,2,0,2,NA
202501,23300000,3,0,3,-3,0
202501,23300000,3S3,1,5,-4,0.2
202501,23300000,CA,0,2,-2,0
202501,23350000,2,9,19,-10,0.47
202501,23350000,2S3,1,1,0,1
202501,23350000,3,1,0,1,NA
202501,23350000,3S2,0,1,-1,0
202501,23350000,3S3,1,18,-17,0.06
202501,23350000,CA,1,5,-4,0.2
202501,23417000,2,64,430,-366,0.15
202501,23417000,2R2,0,1,-1,0
202501,23417000,2S2,1,0,1,NA
202501,23417000,2S3,0,1,-1,0
202501,23417000,3,2,17,-15,0.12
202501,23417000,3S2,1,11,-10,0.09
202501,23417000,3S3,20,99,-79,0.2
202501,23417000,CA,1,75,-74,0.01
202501,23417003,2,1,0,1,NA
202501,23417006,2,0,1,-1,0
202501,23417010,2,0,16,-16,0
202501,23417016,2,7,2,5,3.5
202501,23417016,2S2,0,1,-1,0
202501,23417016,3,0,14,-14,0
202501,23417016,3S3,6,3,3,2
202501,23417036,3,0,1,-1,0
202501,23417036,3S3,0,6,-6,0
202501,23419000,2,4,13,-9,0.31
202501,23419000,3S3,0,2,-2,0
202501,23419000,CA,0,1,-1,0
202501,23464000,2,8,21,-13,0.38
202501,23464000,2S2,0,1,-1,0
202501,23464000,3,1,0,1,NA
202501,23464000,3S3,0,18,-18,0
202501,23464000,CA,0,8,-8,0
202501,23464001,2,0,7,-7,0
202501,23464001,2S3,0,9,-9,0
202501,23466000,2,25,367,-342,0.07
202501,23466000,2B2,0,2,-2,0
202501,23466000,2R3,0,1,-1,0
202501,23466000,2S2,0,3,-3,0
202501,23466000,2S3,1,2,-1,0.5
202501,23466000,3,1,22,-21,0.05
202501,23466000,3S2,2,7,-5,0.29
202501,23466000,3S3,475,2876,-2401,0.17
202501,23466000,4,0,1,-1,0
202501,23466000,CA,5,93,-88,0.05
202501,23466000,V3,0,253,-253,0
202501,23466001,2,1,0,1,NA
202501,23466001,3S2,1,0,1,NA
202501,23466005,2,5,0,5,NA
202501,23466006,2,0,2,-2,0
202501,23466006,3S3,84,0,84,NA
202501,23466007,2,1,0,1,NA
202501,23466008,3S3,0,21,-21,0
202501,23466023,2,1,0,1,NA
202501,23466023,CA,0,1,-1,0
202501,23500000,2,1,37,-36,0.03
202501,23500000,3,0,10,-10,0
202501,23500000,3S2,1,2,-1,0.5
202501,23500000,3S3,2,2,0,1
202501,23500000,CA,0,10,-10,0
202501,23555000,2,158,313,-155,0.5
202501,23555000,2R2,1,3,-2,0.33
202501,23555000,2S2,5,5,0,1
202501,23555000,2S3,1,3,-2,0.33
202501,23555000,3,32,38,-6,0.84
202501,23555000,3S2,13,41,-28,0.32
202501,23555000,3S3,2566,254,2312,10.1
202501,23555000,4,1,1,0,1
202501,23555000,CA,2,53,-51,0.04
202501,23555007,2,17,0,17,NA
202501,23555007,2S2,3,0,3,NA
202501,23555007,2S3,4,0,4,NA
202501,23555007,3S2,2,0,2,NA
202501,23555011,2,0,5,-5,0
202501,23555022,2,0,7,-7,0
202501,23570000,2,43,75,-32,0.57
202501,23570000,2B2,0,1,-1,0
202501,23570000,2S1,0,2,-2,0
202501,23570000,2S2,3,5,-2,0.6
202501,23570000,2S3,2,3,-1,0.67
202501,23570000,3,18,52,-34,0.35
202501,23570000,3S1,9,9,0,1
202501,23570000,3S2,15,8,7,1.88
202501,23570000,3S3,42,37,5,1.14
202501,23570000,3S4,7,2,5,3.5
202501,23570000,4,2,2,0,1
202501,23570000,CA,0,5,-5,0
202501,23570000,V3,1,762,-761,0
202501,23570011,2,5,54,-49,0.09
202501,23570011,2S2,2,57,-55,0.04
202501,23570011,2S3,0,13,-13,0
202501,23570011,3,0,12,-12,0
202501,23570011,3S3,2,2,0,1
202501,23570011,CA,0,3,-3,0
202501,23570013,2,78,7,71,11.14
202501,23570013,3,28,1,27,28
202501,23570013,3S3,1,9,-8,0.11
202501,23570013,CA,8,3,5,2.67
202501,23574000,2,19,7,12,2.71
202501,23574000,3S3,0,5,-5,0
202501,23574000,CA,0,7,-7,0
202501,23574011,CA,0,1,-1,0
202501,23580000,2,54,102,-48,0.53
202501,23580000,2B2,0,6,-6,0
202501,23580000,2S2,2,1,1,2
202501,23580000,2S3,6,0,6,NA
202501,23580000,3,2,31,-29,0.06
202501,23580000,3R3,2,24,-22,0.08
202501,23580000,3S2,203,4,199,50.75
202501,23580000,3S3,3937,2814,1123,1.4
202501,23580000,4,0,1,-1,0
202501,23580000,CA,0,16,-16,0
202501,23580000,V3,264,0,264,NA
202501,23580002,3S3,1504,0,1504,NA
202501,23580003,3S3,5,0,5,NA
202501,23580003,CA,0,1,-1,0
202501,23580005,2,0,1,-1,0
202501,23580006,3S3,141,0,141,NA
202501,23580013,2S1,1,0,1,NA
202501,23580013,3S2,1,0,1,NA
202501,23580013,3S3,3,0,3,NA
202501,23586000,2,2,2,0,1
202501,23586000,3,0,3,-3,0
202501,23586000,CA,0,1,-1,0
202501,23586003,3S2,1,0,1,NA
202501,23660000,2,122,286,-164,0.43
202501,23660000,2B2,0,4,-4,0
202501,23660000,2S2,0,1,-1,0
202501,23660000,2S3,1,0,1,NA
202501,23660000,3,16,39,-23,0.41
202501,23660000,3S1,3,1,2,3
202501,23660000,3S2,9,7,2,1.29
202501,23660000,3S3,500,90,410,5.56
202501,23660000,3S4,4,8,-4,0.5
202501,23660000,4,3,3,0,1
202501,23660000,CA,9,59,-50,0.15
202501,23660000,V2,1,0,1,NA
202501,23660004,2,0,1,-1,0
202501,23660005,2,1,1,0,1
202501,23660005,2S3,2,0,2,NA
202501,23660005,3,2,6,-4,0.33
202501,23660005,3S1,1,1,0,1
202501,23660005,3S2,1,1,0,1
202501,23660005,3S3,6,8,-2,0.75
202501,23660005,4,1,1,0,1
202501,23660005,CA,1,0,1,NA
202501,23660006,2,1,4,-3,0.25
202501,23660006,3S1,1,3,-2,0.33
202501,23660006,3S2,1,2,-1,0.5
202501,23660006,3S3,0,1,-1,0
202501,23660006,3S4,2,1,1,2
202501,23660006,CA,1,3,-2,0.33
202501,23660008,2,0,3,-3,0
202501,23660008,3S3,1,14,-13,0.07
202501,23660012,V2,0,1,-1,0
202501,23660015,2,0,1,-1,0
202501,23660015,3,0,1,-1,0
202501,23660015,3S3,0,1,-1,0
202501,23660016,2,1,0,1,NA
202501,23660016,2S2,0,1,-1,0
202501,23660016,2S3,1,1,0,1
202501,23660016,3S1,0,3,-3,0
202501,23660016,3S2,2,1,1,2
202501,23660016,3S3,6,7,-1,0.86
202501,23670000,2,4,48,-44,0.08
202501,23670000,2B2,0,3,-3,0
202501,23670000,3,0,3,-3,0
202501,23670000,3S2,2,0,2,NA
202501,23670000,CA,0,1,-1,0
202501,23670011,2,0,4,-4,0
202501,23670011,3S3,0,1,-1,0
202501,23670011,CA,0,1,-1,0
202501,23670018,3S3,30,0,30,NA
202501,23672000,2,6,43,-37,0.14
202501,23672000,2B2,0,1,-1,0
202501,23672000,3,0,4,-4,0
202501,23672000,CA,0,5,-5,0
202501,23675000,2,11,69,-58,0.16
202501,23675000,2S3,2,0,2,NA
202501,23675000,3,0,17,-17,0
202501,23675000,3S2,0,4,-4,0
202501,23675000,3S3,0,8,-8,0
202501,23675000,4,0,1,-1,0
202501,23675000,CA,0,3,-3,0
202501,23678000,2,6,32,-26,0.19
202501,23678000,2S3,1,0,1,NA
202501,23678000,3,0,4,-4,0
202501,23678000,3S2,1,1,0,1
202501,23678002,3,0,1,-1,0
202501,23678015,CA,0,1,-1,0
202501,23682000,2,2,12,-10,0.17
202501,23682000,3S3,0,4,-4,0
202501,23682000,CA,0,1,-1,0
202501,23682000,V3,0,2,-2,0
202501,23686000,2,5,33,-28,0.15
202501,23686000,3,0,16,-16,0
202501,23686000,3S2,1,2,-1,0.5
202501,23686000,3S3,0,7,-7,0
202501,23686000,CA,0,6,-6,0
202501,23686003,2R2,1,2,-1,0.5
202501,23686004,3,0,1,-1,0
202501,23686009,2,1,0,1,NA
202501,23686024,2,1,1,0,1
202501,23807000,2,51,269,-218,0.19
202501,23807000,2B2,0,2,-2,0
202501,23807000,2R3,0,1,-1,0
202501,23807000,2S2,0,1,-1,0
202501,23807000,3,1,25,-24,0.04
202501,23807000,3S2,3,5,-2,0.6
202501,23807000,3S3,60,47,13,1.28
202501,23807000,3S4,0,1,-1,0
202501,23807000,4,0,2,-2,0
202501,23807000,CA,4,58,-54,0.07
202501,23807017,CA,0,1,-1,0
202501,23807027,2,0,21,-21,0
202501,23807027,3S3,0,5,-5,0
202501,23807033,2,0,11,-11,0
202501,23815000,2,3,19,-16,0.16
202501,23815000,2S2,0,1,-1,0
202501,23815000,3S3,1,1,0,1
202501,23815000,CA,1,1,0,1
202501,23855000,2,62,69,-7,0.9
202501,23855000,2B2,0,1,-1,0
202501,23855000,2R3,0,2,-2,0
202501,23855000,3,14,14,0,1
202501,23855000,3S2,5,1,4,5
202501,23855000,3S3,2,18,-16,0.11
202501,23855000,CA,0,10,-10,0
202501,23855001,3,0,1,-1,0
202501,23855003,3S3,16,0,16,NA
202501,23855008,2,0,1,-1,0
202501,25001000,2,4,65,-61,0.06
202501,25001000,2R2,0,1,-1,0
202501,25001000,3,1,0,1,NA
202501,25001000,3S2,0,1,-1,0
202501,25001000,3S3,0,11,-11,0
202501,25001000,CA,1,56,-55,0.02
202501,25019000,2,46,120,-74,0.38
202501,25019000,2S3,0,3,-3,0
202501,25019000,3,2,2,0,1
202501,25019000,3S2,7,12,-5,0.58
202501,25019000,3S3,3,5,-2,0.6
202501,25019000,CA,0,5,-5,0
202501,25035000,2,18,138,-120,0.13
202501,25035000,3,0,1,-1,0
202501,25035000,3S3,0,38,-38,0
202501,25035000,CA,12,105,-93,0.11
202501,25035001,2,0,1,-1,0
202501,25040000,2,20,103,-83,0.19
202501,25040000,3S3,0,2,-2,0
202501,25040000,CA,0,32,-32,0
202501,25040002,2,0,1,-1,0
202501,25040002,CA,0,2,-2,0
202501,25053000,2,2,358,-356,0.01
202501,25053000,3S2,1,2,-1,0.5
202501,25053000,CA,1,46,-45,0.02
202501,25053000,V2,0,1,-1,0
202501,25086000,2,1,13,-12,0.08
202501,25086000,CA,0,2,-2,0
202501,25095000,2,0,12,-12,0
202501,25095000,CA,0,8,-8,0
202501,25095001,2,1,0,1,NA
202501,25095003,2,0,1,-1,0
202501,25099000,2,82,132,-50,0.62
202501,25099000,2S2,9,0,9,NA
202501,25099000,3,1,2,-1,0.5
202501,25099000,3S2,4,0,4,NA
202501,25099000,3S3,0,2,-2,0
202501,25099000,CA,61,50,11,1.22
202501,25099000,V2,1,1,0,1
202501,25120000,2,0,15,-15,0
202501,25120000,3,0,2,-2,0
202501,25120000,CA,0,13,-13,0
202501,25120003,2,1,1,0,1
202501,25120003,3S2,0,1,-1,0
202501,25123000,2,10,63,-53,0.16
202501,25123000,3,0,1,-1,0
202501,25123000,3S2,1,2,-1,0.5
202501,25123000,CA,2,42,-40,0.05
202501,25123000,V3,0,2,-2,0
202501,25126000,2,3224,1767,1457,1.82
202501,25126000,2B1,23,1,22,23
202501,25126000,2R2,6,1,5,6
202501,25126000,2S1,10,4,6,2.5
202501,25126000,2S2,438,165,273,2.65
202501,25126000,2S3,83,75,8,1.11
202501,25126000,3,75,145,-70,0.52
202501,25126000,3S1,33,36,-3,0.92
202501,25126000,3S2,904,495,409,1.83
202501,25126000,3S3,1178,821,357,1.43
202501,25126000,3S4,1,5,-4,0.2
202501,25126000,4,4,6,-2,0.67
202501,25126000,CA,1172,979,193,1.2
202501,25126000,V3,174,59,115,2.95
202501,25126000,V4,0,18,-18,0
202501,25126009,2,2,17,-15,0.12
202501,25126011,2,1,0,1,NA
202501,25148000,2,6,38,-32,0.16
202501,25148000,CA,3,15,-12,0.2
202501,25148005,2,0,1,-1,0
202501,25151000,2,15,110,-95,0.14
202501,25151000,2S3,0,16,-16,0
202501,25151000,3,0,12,-12,0
202501,25151000,3S2,5,3,2,1.67
202501,25151000,3S3,11,266,-255,0.04
202501,25151000,3S4,0,1,-1,0
202501,25151000,4,0,1,-1,0
202501,25151000,CA,3,85,-82,0.04
202501,25154000,2,3,26,-23,0.12
202501,25154000,3,0,1,-1,0
202501,25154000,CA,0,31,-31,0
202501,25168000,2,0,9,-9,0
202501,25175000,2,899,2661,-1762,0.34
202501,25175000,2R2,0,2,-2,0
202501,25175000,2S1,0,2,-2,0
202501,25175000,2S2,152,191,-39,0.8
202501,25175000,2S3,23,40,-17,0.58
202501,25175000,3,11,90,-79,0.12
202501,25175000,3S2,176,108,68,1.63
202501,25175000,3S3,169,323,-154,0.52
202501,25175000,3S4,1,8,-7,0.12
202501,25175000,4,0,3,-3,0
202501,25175000,CA,362,1822,-1460,0.2
202501,25175000,V2,2,5,-3,0.4
202501,25175000,V3,0,2,-2,0
202501,25175004,3S3,0,5,-5,0
202501,25175004,CA,1,0,1,NA
202501,25175008,2,0,1,-1,0
202501,25178000,2,31,90,-59,0.34
202501,25178000,2S3,0,1,-1,0
202501,25178000,3,0,3,-3,0
202501,25178000,3S2,1,0,1,NA
202501,25178000,3S3,1,6,-5,0.17
202501,25178000,CA,0,16,-16,0
202501,25181000,2,1,107,-106,0.01
202501,25181000,3,1,19,-18,0.05
202501,25181000,3S3,0,3,-3,0
202501,25181000,CA,1,66,-65,0.02
202501,25181000,V2,0,5,-5,0
202501,25181000,V3,0,5,-5,0
202501,25183000,2,13,134,-121,0.1
202501,25183000,2R3,0,1,-1,0
202501,25183000,2S3,0,6,-6,0
202501,25183000,3,1,17,-16,0.06
202501,25183000,3S2,2,1,1,2
202501,25183000,3S3,17,7,10,2.43
202501,25183000,CA,1,54,-53,0.02
202501,25183000,V2,0,1,-1,0
202501,25183000,V3,0,4,-4,0
202501,25183001,2,0,26,-26,0
202501,25183001,3,0,1,-1,0
202501,25200000,2,309,380,-71,0.81
202501,25200000,2S1,22,3,19,7.33
202501,25200000,2S2,324,87,237,3.72
202501,25200000,2S3,568,28,540,20.29
202501,25200000,3,17,15,2,1.13
202501,25200000,3S1,2,0,2,NA
202501,25200000,3S2,164,30,134,5.47
202501,25200000,3S3,819,650,169,1.26
202501,25200000,4,0,1,-1,0
202501,25200000,CA,24,122,-98,0.2
202501,25200000,V2,0,6,-6,0
202501,25200000,V3,0,20,-20,0
202501,25200010,3S3,11,0,11,NA
202501,25200010,V2,3,0,3,NA
202501,25200010,V3,16,0,16,NA
202501,25214000,2,18456,6554,11902,2.82
202501,25214000,2B1,17,0,17,NA
202501,25214000,2R2,23,9,14,2.56
202501,25214000,2R3,32,13,19,2.46
202501,25214000,2S1,7,36,-29,0.19
202501,25214000,2S2,940,1484,-544,0.63
202501,25214000,2S3,407,396,11,1.03
202501,25214000,3,391,114,277,3.43
202501,25214000,3S1,4,3,1,1.33
202501,25214000,3S2,618,756,-138,0.82
202501,25214000,3S2S3,0,1,-1,0
202501,25214000,3S3,2027,2815,-788,0.72
202501,25214000,3S4,21,4,17,5.25
202501,25214000,4,3,9,-6,0.33
202501,25214000,CA,11245,1924,9321,5.84
202501,25214000,V2,3,1,2,3
202501,25214000,V3,0,30,-30,0
202501,25214008,2,936,444,492,2.11
202501,25214008,2B2,0,1,-1,0
202501,25214008,2R3,39,0,39,NA
202501,25214008,2S1,4,0,4,NA
202501,25214008,2S2,301,61,240,4.93
202501,25214008,2S3,265,22,243,12.05
202501,25214008,3,10,5,5,2
202501,25214008,3S2,39,42,-3,0.93
202501,25214008,3S3,115,99,16,1.16
202501,25214008,3S4,1,0,1,NA
202501,25214008,4,5,2,3,2.5
202501,25214008,CA,371,456,-85,0.81
202501,25224000,2,0,23,-23,0
202501,25224000,3,1,1,0,1
202501,25224000,3S2,1,3,-2,0.33
202501,25224000,3S3,1496,89,1407,16.81
202501,25224000,4,5,1,4,5
202501,25224000,CA,0,18,-18,0
202501,25224000,V2,0,2,-2,0
202501,25224000,V3,57,57,0,1
202501,25224000,V4,59,50,9,1.18
202501,25224000,V4R2,7,0,7,NA
202501,25245000,2,6,96,-90,0.06
202501,25245000,2R3,0,2,-2,0
202501,25245000,3,0,12,-12,0
202501,25245000,3S3,1,15,-14,0.07
202501,25245000,3S4,0,1,-1,0
202501,25245000,CA,3,63,-60,0.05
202501,25245002,CA,0,5,-5,0
202501,25258000,2,0,2,-2,0
202501,25258000,CA,0,3,-3,0
202501,25258002,2,0,1,-1,0
202501,25260000,2,196,670,-474,0.29
202501,25260000,2S2,28,17,11,1.65
202501,25260000,2S3,4,10,-6,0.4
202501,25260000,3,1,9,-8,0.11
202501,25260000,3S2,2,38,-36,0.05
202501,25260000,3S2S3,0,1,-1,0
202501,25260000,3S3,4,140,-136,0.03
202501,25260000,3S4,0,1,-1,0
202501,25260000,CA,58,269,-211,0.22
202501,25260000,V2,0,21,-21,0
202501,25260000,V3,0,19,-19,0
202501,25260002,2,3,0,3,NA
202501,25269000,2,1399,2693,-1294,0.52
202501,25269000,2B1,3,0,3,NA
202501,25269000,2R3,0,2,-2,0
202501,25269000,2S2,147,22,125,6.68
202501,25269000,2S3,331,23,308,14.39
202501,25269000,3,570,38,532,15
202501,25269000,3S2,1333,276,1057,4.83
202501,25269000,3S3,3660,2116,1544,1.73
202501,25269000,3S4,0,1,-1,0
202501,25269000,4,7,0,7,NA
202501,25269000,CA,205,1716,-1511,0.12
202501,25269000,V2,0,6,-6,0
202501,25269000,V3,0,5,-5,0
202501,25269007,3S3,2,0,2,NA
202501,25269009,2,0,1,-1,0
202501,25269009,3S3,0,11,-11,0
202501,25269012,2,1,0,1,NA
202501,25269013,2,1,0,1,NA
202501,25269017,2,27,11,16,2.45
202501,25269018,2,3,0,3,NA
202501,25279000,2,1,61,-60,0.02
202501,25279000,3,0,5,-5,0
202501,25279000,3S2,0,1,-1,0
202501,25279000,3S3,0,78,-78,0
202501,25279000,CA,1,41,-40,0.02
202501,25279000,V3,0,3,-3,0
202501,25281000,2,3,8,-5,0.38
202501,25281000,CA,0,8,-8,0
202501,25286000,2,35627,12234,23393,2.91
202501,25286000,2B1,7,6,1,1.17
202501,25286000,2B2,3,0,3,NA
202501,25286000,2R2,84,3,81,28
202501,25286000,2R3,33,8,25,4.12
202501,25286000,2S1,43,56,-13,0.77
202501,25286000,2S2,4419,3724,695,1.19
202501,25286000,2S3,893,1108,-215,0.81
202501,25286000,3,330,173,157,1.91
202501,25286000,3S1,2,3,-1,0.67
202501,25286000,3S2,1175,1961,-786,0.6
202501,25286000,3S3,2950,6743,-3793,0.44
202501,25286000,3S4,6,9,-3,0.67
202501,25286000,4,25,11,14,2.27
202501,25286000,CA,16891,3374,13517,5.01
202501,25286000,V2,45,7,38,6.43
202501,25286000,V3,0,2,-2,0
202501,25288000,2,14,44,-30,0.32
202501,25288000,2S2,18,56,-38,0.32
202501,25288000,2S3,7,0,7,NA
202501,25288000,3,9,0,9,NA
202501,25288000,3S2,130,12,118,10.83
202501,25288000,3S3,52,10,42,5.2
202501,25288000,3S4,0,1,-1,0
202501,25288000,CA,15,6,9,2.5
202501,25288001,2,2,3,-1,0.67
202501,25288001,CA,1,0,1,NA
202501,25290000,2,145,1405,-1260,0.1
202501,25290000,2R2,0,2,-2,0
202501,25290000,2R3,0,3,-3,0
202501,25290000,2S2,3,12,-9,0.25
202501,25290000,2S3,3,5,-2,0.6
202501,25290000,3,4,90,-86,0.04
202501,25290000,3S2,2,56,-54,0.04
202501,25290000,3S2S3,0,1,-1,0
202501,25290000,3S3,4,483,-479,0.01
202501,25290000,4,0,1,-1,0
202501,25290000,CA,111,387,-276,0.29
202501,25290000,V2,0,21,-21,0
202501,25290000,V3,0,2,-2,0
202501,25290011,2,0,8,-8,0
202501,25290011,3S3,0,1,-1,0
202501,25290011,3S4,1,0,1,NA
202501,25290011,CA,1,3,-2,0.33
202501,25290012,3S3,0,50,-50,0
202501,25293000,2,0,11,-11,0
202501,25293000,3,0,3,-3,0
202501,25293000,CA,0,45,-45,0
202501,25295000,2,3610,1074,2536,3.36
202501,25295000,2S1,0,9,-9,0
202501,25295000,2S2,150,341,-191,0.44
202501,25295000,2S3,53,159,-106,0.33
202501,25295000,3,43,109,-66,0.39
202501,25295000,3S2,45,214,-169,0.21
202501,25295000,3S3,228,345,-117,0.66
202501,25295000,3S4,3,1,2,3
202501,25295000,CA,45,324,-279,0.14
202501,25295000,V2,5,5,0,1
202501,25295000,V3,6,5,1,1.2
202501,25295005,2,257,0,257,NA
202501,25297000,2,4,43,-39,0.09
202501,25297000,3,0,9,-9,0
202501,25297000,3S3,1,1,0,1
202501,25297000,CA,0,60,-60,0
202501,25297000,V2,1,1,0,1
202501,25297000,V3,0,1,-1,0
202501,25299000,2,0,16,-16,0
202501,25299000,3,0,3,-3,0
202501,25299000,CA,0,5,-5,0
202501,25307000,2,355,1737,-1382,0.2
202501,25307000,2R2,0,15,-15,0
202501,25307000,2R3,0,1,-1,0
202501,25307000,2S2,34,66,-32,0.52
202501,25307000,2S3,34,38,-4,0.89
202501,25307000,3,26,60,-34,0.43
202501,25307000,3S2,5,24,-19,0.21
202501,25307000,3S3,450,688,-238,0.65
202501,25307000,4,0,3,-3,0
202501,25307000,CA,407,563,-156,0.72
202501,25307000,V3,1,2,-1,0.5
202501,25312000,2,1,48,-47,0.02
202501,25312000,2S3,0,1,-1,0
202501,25312000,3,0,1,-1,0
202501,25312000,3S2,29,2,27,14.5
202501,25312000,3S3,2,3,-1,0.67
202501,25312000,3S4,2,1,1,2
202501,25312000,CA,3,8,-5,0.38
202501,25312000,V2,0,4,-4,0
202501,25312013,2,0,1,-1,0
202501,25317000,2,3,53,-50,0.06
202501,25317000,3,0,3,-3,0
202501,25317000,3S2,3,0,3,NA
202501,25317000,3S3,2089,24,2065,87.04
202501,25317000,4,1,0,1,NA
202501,25317000,CA,0,19,-19,0
202501,25317000,V2,56,3,53,18.67
202501,25317000,V3,445,372,73,1.2
202501,25317000,V4,129,206,-77,0.63
202501,25320000,2,242,441,-199,0.55
202501,25320000,2S2,2,11,-9,0.18
202501,25320000,2S3,1,41,-40,0.02
202501,25320000,3,0,19,-19,0
202501,25320000,3S2,2,571,-569,0
202501,25320000,3S3,10,904,-894,0.01
202501,25320000,CA,5,123,-118,0.04
202501,25320002,2,0,3,-3,0
202501,25320003,2,1,0,1,NA
202501,25320003,CA,1,0,1,NA
202501,25322000,2,27,186,-159,0.15
202501,25322000,2S2,0,2,-2,0
202501,25322000,2S3,0,1,-1,0
202501,25322000,3,51,14,37,3.64
202501,25322000,3S2,21,1,20,21
202501,25322000,3S3,22,4,18,5.5
202501,25322000,CA,2,207,-205,0.01
202501,25322000,V2,0,1,-1,0
202501,25322000,V3,149,0,149,NA
202501,25324000,2,1,5,-4,0.2
202501,25324000,3S2,0,1,-1,0
202501,25324000,CA,2,9,-7,0.22
202501,25326000,2,4,41,-37,0.1
202501,25326000,2S2,0,1,-1,0
202501,25326000,2S3,0,3,-3,0
202501,25326000,3,1,1,0,1
202501,25326000,3S2,1,2,-1,0.5
202501,25326000,3S3,5,3,2,1.67
202501,25326000,CA,0,17,-17,0
202501,25328000,2,3,37,-34,0.08
202501,25328000,2S3,0,1,-1,0
202501,25328000,3,0,6,-6,0
202501,25328000,3S2,0,1,-1,0
202501,25328000,3S3,0,8,-8,0
202501,25328000,CA,0,1,-1,0
202501,25328000,V2,0,2,-2,0
202501,25328001,3S3,0,4,-4,0
202501,25335000,2,3,27,-24,0.11
202501,25335000,2S2,2,0,2,NA
202501,25335000,2S3,0,1,-1,0
202501,25335000,3,0,6,-6,0
202501,25335000,3S2,0,1,-1,0
202501,25335000,3S3,2,41,-39,0.05
202501,25335000,CA,0,21,-21,0
202501,25339000,CA,0,3,-3,0
202501,25368000,2,0,18,-18,0
202501,25368000,3,0,1,-1,0
202501,25368000,CA,1,1,0,1
202501,25372000,2,0,1,-1,0
202501,25372000,3S3,0,1,-1,0
202501,25372000,CA,0,5,-5,0
202501,25377000,2,491,529,-38,0.93
202501,25377000,2S1,1,0,1,NA
202501,25377000,2S2,1,5,-4,0.2
202501,25377000,2S3,0,5,-5,0
202501,25377000,3,168,60,108,2.8
202501,25377000,3S2,2,3,-1,0.67
202501,25377000,3S3,412,141,271,2.92
202501,25377000,CA,10,395,-385,0.03
202501,25377000,V2,4,2,2,2
202501,25377000,V3,136,0,136,NA
202501,25377003,2,0,1,-1,0
202501,25377003,3S3,0,2,-2,0
202501,25386000,2,18,402,-384,0.04
202501,25386000,2R3,0,1,-1,0
202501,25386000,2S3,0,2,-2,0
202501,25386000,3,2,7,-5,0.29
202501,25386000,3S2,3,3,0,1
202501,25386000,3S3,5,130,-125,0.04
202501,25386000,4,0,1,-1,0
202501,25386000,CA,6,143,-137,0.04
202501,25386001,2,0,10,-10,0
202501,25386003,2,0,1,-1,0
202501,25386003,CA,0,1,-1,0
202501,25394000,2,2,12,-10,0.17
202501,25394000,3,0,1,-1,0
202501,25394000,CA,0,15,-15,0
202501,25398000,2,1,17,-16,0.06
202501,25398000,CA,0,12,-12,0
202501,25402000,2,11,261,-250,0.04
202501,25402000,2S3,0,6,-6,0
202501,25402000,3,2,22,-20,0.09
202501,25402000,3S2,0,14,-14,0
202501,25402000,3S3,1,4,-3,0.25
202501,25402000,CA,2,49,-47,0.04
202501,25402000,V2,0,1,-1,0
202501,25402000,V3,0,1,-1,0
202501,25407000,2,6,68,-62,0.09
202501,25407000,2S2,0,1,-1,0
202501,25407000,2S3,0,1,-1,0
202501,25407000,3,1,2,-1,0.5
202501,25407000,3S2,2,2,0,1
202501,25407000,3S3,756,47,709,16.09
202501,25407000,4,14,15,-1,0.93
202501,25407000,CA,2,28,-26,0.07
202501,25407000,V2,0,2,-2,0
202501,25407000,V3,105,94,11,1.12
202501,25407000,V4,26,12,14,2.17
202501,25426000,2,1,33,-32,0.03
202501,25426000,3,0,2,-2,0
202501,25426000,3S3,0,2,-2,0
202501,25426000,CA,0,6,-6,0
202501,25430000,2,5258,2959,2299,1.78
202501,25430000,2B1,1,7,-6,0.14
202501,25430000,2B2,2,15,-13,0.13
202501,25430000,2R2,3,15,-12,0.2
202501,25430000,2R3,0,5,-5,0
202501,25430000,2S1,2,4,-2,0.5
202501,25430000,2S2,1441,587,854,2.45
202501,25430000,2S3,348,141,207,2.47
202501,25430000,3,266,167,99,1.59
202501,25430000,3S1,9,0,9,NA
202501,25430000,3S2,290,359,-69,0.81
202501,25430000,3S3,1477,2371,-894,0.62
202501,25430000,3S4,0,3,-3,0
202501,25430000,4,12,13,-1,0.92
202501,25430000,CA,1326,1011,315,1.31
202501,25430000,V2,2,10,-8,0.2
202501,25430000,V3,3,497,-494,0.01
202501,25430000,V4,0,154,-154,0
202501,25430003,2,2,4,-2,0.5
202501,25430003,3S3,0,6,-6,0
202501,25430004,2,10,4,6,2.5
202501,25430004,2S2,72,0,72,NA
202501,25430004,2S3,9,0,9,NA
202501,25430004,3S2,25,0,25,NA
202501,25430004,3S3,0,10,-10,0
202501,25430004,CA,3,1,2,3
202501,25430005,2,7,3,4,2.33
202501,25430006,2,12,4,8,3
202501,25436000,2,0,10,-10,0
202501,25436000,3,0,8,-8,0
202501,25436000,3S3,0,1,-1,0
202501,25436000,CA,0,6,-6,0
202501,25438000,2,12,30,-18,0.4
202501,25438000,2S3,0,2,-2,0
202501,25438000,3,0,5,-5,0
202501,25438000,3S3,1,6,-5,0.17
202501,25438000,CA,0,4,-4,0
202501,25438000,V4,0,1,-1,0
202501,25473000,2,9479,4860,4619,1.95
202501,25473000,2B1,0,19,-19,0
202501,25473000,2R3,1,3,-2,0.33
202501,25473000,2S1,6,4,2,1.5
202501,25473000,2S2,936,776,160,1.21
202501,25473000,2S3,251,198,53,1.27
202501,25473000,3,130,420,-290,0.31
202501,25473000,3S1,5,1,4,5
202501,25473000,3S2,435,429,6,1.01
202501,25473000,3S3,1280,4171,-2891,0.31
202501,25473000,3S4,4,1,3,4
202501,25473000,4,0,48,-48,0
202501,25473000,CA,3339,1494,1845,2.23
202501,25473000,V2,21,62,-41,0.34
202501,25473000,V3,87,330,-243,0.26
202501,25473000,V4,1,8,-7,0.12
202501,25473004,2,1,0,1,NA
202501,25483000,2,3,10,-7,0.3
202501,25483000,3S3,2,1,1,2
202501,25483000,CA,0,11,-11,0
202501,25486000,2,159,275,-116,0.58
202501,25486000,2S2,5,0,5,NA
202501,25486000,2S3,1,0,1,NA
202501,25486000,3,89,0,89,NA
202501,25486000,3S2,14,18,-4,0.78
202501,25486000,3S3,338,6,332,56.33
202501,25486000,CA,1,151,-150,0.01
202501,25486000,V2,0,1,-1,0
202501,25486000,V3,1349,24,1325,56.21
202501,25486000,V4,276,0,276,NA
202501,25486001,2,1,1,0,1
202501,25486002,2,2,0,2,NA
202501,25486005,3S3,1,0,1,NA
202501,25488000,2,7,82,-75,0.09
202501,25488000,3,0,8,-8,0
202501,25488000,3S2,0,2,-2,0
202501,25488000,3S3,0,10,-10,0
202501,25488000,CA,0,23,-23,0
202501,25488000,V2,0,1,-1,0
202501,25489000,2,3,52,-49,0.06
202501,25489000,CA,0,5,-5,0
202501,25489000,V3,0,1,-1,0
202501,25489001,2,0,1,-1,0
202501,25489001,CA,0,1,-1,0
202501,25491000,2,0,3,-3,0
202501,25491000,3S3,1,0,1,NA
202501,25491000,CA,0,11,-11,0
202501,25506000,2,3,9,-6,0.33
202501,25506000,3,0,1,-1,0
202501,25506000,CA,0,3,-3,0
202501,25513000,2,15,162,-147,0.09
202501,25513000,3,0,9,-9,0
202501,25513000,3S2,1,0,1,NA
202501,25513000,3S3,0,6,-6,0
202501,25513000,CA,2,65,-63,0.03
202501,25513000,V3,0,9,-9,0
202501,25513001,CA,1,0,1,NA
202501,25518000,2,0,12,-12,0
202501,25518000,3,1,2,-1,0.5
202501,25518000,CA,0,3,-3,0
202501,25518004,2,0,1,-1,0
202501,25518004,CA,0,1,-1,0
202501,25524000,2,0,3,-3,0
202501,25524000,3,0,1,-1,0
202501,25524000,CA,1,12,-11,0.08
202501,25530000,2,2,49,-47,0.04
202501,25530000,2S2,0,1,-1,0
202501,25530000,2S3,3,2,1,1.5
202501,25530000,3,5,21,-16,0.24
202501,25530000,3S2,3,8,-5,0.38
202501,25530000,3S3,5,22,-17,0.23
202501,25530000,4,1,1,0,1
202501,25530000,CA,1,7,-6,0.14
202501,25530001,2,0,1,-1,0
202501,25530001,3,1,1,0,1
202501,25530002,2,2,0,2,NA
202501,25530002,2S3,1,3,-2,0.33
202501,25535000,2,7,35,-28,0.2
202501,25535000,3,1,0,1,NA
202501,25535000,3S3,0,3,-3,0
202501,25535000,CA,0,7,-7,0
202501,25535000,V2,0,7,-7,0
202501,25572000,2,21,140,-119,0.15
202501,25572000,2R2,0,2,-2,0
202501,25572000,2S2,1,0,1,NA
202501,25572000,3,1,3,-2,0.33
202501,25572000,3S2,51,2,49,25.5
202501,25572000,3S3,218,121,97,1.8
202501,25572000,3S4,1,3,-2,0.33
202501,25572000,CA,1,22,-21,0.05
202501,25572003,2,1,2,-1,0.5
202501,25572005,2,1,0,1,NA
202501,25580000,2,1,9,-8,0.11
202501,25592000,2,0,8,-8,0
202501,25592000,3,0,3,-3,0
202501,25592000,CA,0,11,-11,0
202501,25594000,2,1,27,-26,0.04
202501,25594000,3S2,3,1,2,3
202501,25594000,3S3,0,15,-15,0
202501,25594000,CA,0,14,-14,0
202501,25594002,2,0,6,-6,0
202501,25594002,3S3,0,4,-4,0
202501,25594002,CA,2,16,-14,0.12
202501,25596000,2,1,9,-8,0.11
202501,25596000,CA,1,3,-2,0.33
202501,25599000,2,6,49,-43,0.12
202501,25599000,3S3,0,3,-3,0
202501,25599000,CA,3,62,-59,0.05
202501,25599002,2,0,5,-5,0
202501,25599002,CA,0,1,-1,0
202501,25612000,2,8,243,-235,0.03
202501,25612000,2R2,0,1,-1,0
202501,25612000,2R3,0,1,-1,0
202501,25612000,2S2,1,2,-1,0.5
202501,25612000,3,72,2,70,36
202501,25612000,3S3,3,171,-168,0.02
202501,25612000,CA,9,126,-117,0.07
202501,25612000,V2,1,0,1,NA
202501,25612000,V3,19,0,19,NA
202501,25612002,3,1,0,1,NA
202501,25645000,2,2,37,-35,0.05
202501,25645000,3,0,3,-3,0
202501,25645000,3S3,0,2,-2,0
202501,25645000,CA,0,4,-4,0
202501,25645001,2,2,0,2,NA
202501,25649000,2,0,47,-47,0
202501,25649000,CA,4,16,-12,0.25
202501,25653000,2,0,1,-1,0
202501,25653000,CA,0,1,-1,0
202501,25658000,2,0,84,-84,0
202501,25658000,3,0,5,-5,0
202501,25658000,3S2,2,10,-8,0.2
202501,25658000,3S3,0,4,-4,0
202501,25658000,CA,1,24,-23,0.04
202501,25662000,2,1,42,-41,0.02
202501,25662000,3,0,4,-4,0
202501,25662000,3S3,0,2,-2,0
202501,25662000,CA,0,13,-13,0
202501,25662001,2,10,9,1,1.11
202501,25662001,2S2,0,1,-1,0
202501,25662001,2S3,0,2,-2,0
202501,25662001,3S3,0,1,-1,0
202501,25662001,CA,0,7,-7,0
202501,25718000,2,19,219,-200,0.09
202501,25718000,3,29,0,29,NA
202501,25718000,CA,24,22,2,1.09
202501,25718000,V2,0,3,-3,0
202501,25736000,2,771,241,530,3.2
202501,25736000,2R2,1,0,1,NA
202501,25736000,2S2,24,97,-73,0.25
202501,25736000,2S3,0,74,-74,0
202501,25736000,3,6,6,0,1
202501,25736000,3S2,18,36,-18,0.5
202501,25736000,3S3,699,220,479,3.18
202501,25736000,CA,172,82,90,2.1
202501,25736000,V2,79,0,79,NA
202501,25736000,V3,59,0,59,NA
202501,25740000,2,995,1301,-306,0.76
202501,25740000,2R3,1,0,1,NA
202501,25740000,2S2,91,96,-5,0.95
202501,25740000,2S3,19,43,-24,0.44
202501,25740000,3,28,71,-43,0.39
202501,25740000,3S1,1,0,1,NA
202501,25740000,3S2,110,226,-116,0.49
202501,25740000,3S3,1292,1945,-653,0.66
202501,25740000,4,2,0,2,NA
202501,25740000,CA,900,460,440,1.96
202501,25740000,V2,0,38,-38,0
202501,25740000,V3,2,1,1,2
202501,25740000,V4,0,1,-1,0
202501,25740004,2,7,1,6,7
202501,25740005,2,1,1,0,1
202501,25743000,2,10,266,-256,0.04
202501,25743000,2S2,3,0,3,NA
202501,25743000,2S3,5,1,4,5
202501,25743000,3,2,33,-31,0.06
202501,25743000,3S2,3,10,-7,0.3
202501,25743000,3S3,4,15,-11,0.27
202501,25743000,3S4,1,0,1,NA
202501,25743000,CA,0,41,-41,0
202501,25743000,V2,0,20,-20,0
202501,25743005,2,1,1,0,1
202501,25743005,2S2,8,0,8,NA
202501,25743005,3S2,13,0,13,NA
202501,25745000,2,9,130,-121,0.07
202501,25745000,2S2,1,11,-10,0.09
202501,25745000,2S3,5,31,-26,0.16
202501,25745000,3S2,120,1,119,120
202501,25745000,3S3,45,19,26,2.37
202501,25745000,CA,0,88,-88,0
202501,25754000,2,6127,3706,2421,1.65
202501,25754000,2B1,0,2,-2,0
202501,25754000,2R2,2,3,-1,0.67
202501,25754000,2S1,2,1,1,2
202501,25754000,2S2,134,171,-37,0.78
202501,25754000,2S3,85,67,18,1.27
202501,25754000,3,843,160,683,5.27
202501,25754000,3S1,3,0,3,NA
202501,25754000,3S2,34,106,-72,0.32
202501,25754000,3S3,2444,1235,1209,1.98
202501,25754000,4,63,2,61,31.5
202501,25754000,CA,3560,1653,1907,2.15
202501,25754000,V2,76,6,70,12.67
202501,25754000,V3,115,17,98,6.76
202501,25754001,2,68,5,63,13.6
202501,25754001,2S2,24,0,24,NA
202501,25754001,2S3,3,1,2,3
202501,25754001,3S2,1,0,1,NA
202501,25754001,3S3,7,1,6,7
202501,25754001,3S4,1,0,1,NA
202501,25754001,CA,3,0,3,NA
202501,25758000,2,1027,1216,-189,0.84
202501,25758000,2R3,0,3,-3,0
202501,25758000,2S2,37,46,-9,0.8
202501,25758000,2S3,15,65,-50,0.23
202501,25758000,3,511,170,341,3.01
202501,25758000,3S2,490,72,418,6.81
202501,25758000,3S3,1328,205,1123,6.48
202501,25758000,4,18,12,6,1.5
202501,25758000,CA,98,304,-206,0.32
202501,25758000,V2,0,7,-7,0
202501,25758000,V3,3,2533,-2530,0
202501,25758000,V4,0,236,-236,0
202501,25758006,2,30,23,7,1.3
202501,25758006,2S2,2,14,-12,0.14
202501,25758006,2S3,5,7,-2,0.71
202501,25758006,3,2,1,1,2
202501,25758006,3S2,1,1,0,1
202501,25758006,3S3,804,21,783,38.29
202501,25758006,4,1,0,1,NA
202501,25758006,CA,1,8,-7,0.12
202501,25758006,V3,22,0,22,NA
202501,25769000,2,101,394,-293,0.26
202501,25769000,2S2,4,3,1,1.33
202501,25769000,2S3,0,1,-1,0
202501,25769000,3,90,3,87,30
202501,25769000,3S2,4,0,4,NA
202501,25769000,3S3,0,10,-10,0
202501,25769000,CA,1,179,-178,0.01
202501,25769000,V2,0,2,-2,0
202501,25769002,CA,0,2,-2,0
202501,25772000,2,134,264,-130,0.51
202501,25772000,2S2,7,1,6,7
202501,25772000,2S3,1,28,-27,0.04
202501,25772000,3,13,15,-2,0.87
202501,25772000,3S2,11,1,10,11
202501,25772000,3S3,382,1295,-913,0.29
202501,25772000,CA,1,149,-148,0.01
202501,25772000,V3,0,1,-1,0
202501,25772000,V4,0,1,-1,0
202501,25772004,2,8,0,8,NA
202501,25777000,2,0,31,-31,0
202501,25777000,3,0,4,-4,0
202501,25777000,CA,1,19,-18,0.05
202501,25779000,2,0,22,-22,0
202501,25779000,3S3,0,1,-1,0
202501,25779000,CA,0,19,-19,0
202501,25781000,2,1,18,-17,0.06
202501,25781000,3,1,0,1,NA
202501,25781000,3S2,2,0,2,NA
202501,25781000,3S3,506,3,503,168.67
202501,25781000,CA,0,10,-10,0
202501,25781000,V2,9,0,9,NA
202501,25781000,V3,60,22,38,2.73
202501,25781000,V4,9,3,6,3
202501,25785000,2,69,179,-110,0.39
202501,25785000,2S2,0,8,-8,0
202501,25785000,3,4,0,4,NA
202501,25785000,3S2,0,3,-3,0
202501,25785000,3S3,4,21,-17,0.19
202501,25785000,4,1,0,1,NA
202501,25785000,CA,5,176,-171,0.03
202501,25785000,V2,0,12,-12,0
202501,25785000,V3,0,9,-9,0
202501,25793000,2,4,43,-39,0.09
202501,25793000,3,0,1,-1,0
202501,25793000,3S2,5,5,0,1
202501,25793000,3S3,1581,51,1530,31
202501,25793000,CA,0,15,-15,0
202501,25793000,V2,1,0,1,NA
202501,25793000,V3,25,0,25,NA
202501,25793003,3S3,0,15,-15,0
202501,25797000,2,0,74,-74,0
202501,25797000,3,0,11,-11,0
202501,25797000,CA,0,9,-9,0
202501,25797001,CA,0,4,-4,0
202501,25799000,2,16154,3395,12759,4.76
202501,25799000,2B1,3,0,3,NA
202501,25799000,2R2,29,3,26,9.67
202501,25799000,2R3,33,16,17,2.06
202501,25799000,2S1,50,6,44,8.33
202501,25799000,2S2,1870,1795,75,1.04
202501,25799000,2S3,272,214,58,1.27
202501,25799000,3,42,63,-21,0.67
202501,25799000,3S2,469,721,-252,0.65
202501,25799000,3S3,467,666,-199,0.7
202501,25799000,3S4,4,2,2,2
202501,25799000,4,0,2,-2,0
202501,25799000,CA,12355,883,11472,13.99
202501,25799000,V2,0,3,-3,0
202501,25799000,V3,0,1,-1,0
202501,25799001,2,15,10,5,1.5
202501,25799001,2S2,0,9,-9,0
202501,25799001,3,1,7,-6,0.14
202501,25799001,3S2,0,4,-4,0
202501,25799001,3S3,0,1,-1,0
202501,25799001,CA,5,3,2,1.67
202501,25805000,2,0,25,-25,0
202501,25805000,CA,0,3,-3,0
202501,25807000,2,0,4,-4,0
202501,25807000,3,0,3,-3,0
202501,25807000,3S3,0,1,-1,0
202501,25807000,CA,0,4,-4,0
202501,25815000,2,5,79,-74,0.06
202501,25815000,2R2,0,1,-1,0
202501,25815000,2S2,0,1,-1,0
202501,25815000,2S3,1,1,0,1
202501,25815000,3S3,1,26,-25,0.04
202501,25815000,CA,0,51,-51,0
202501,25817000,2,9004,5421,3583,1.66
202501,25817000,2B1,17,14,3,1.21
202501,25817000,2R2,11,14,-3,0.79
202501,25817000,2R3,113,6,107,18.83
202501,25817000,2S1,4,12,-8,0.33
202501,25817000,2S2,2129,1399,730,1.52
202501,25817000,2S3,1648,763,885,2.16
202501,25817000,3,746,94,652,7.94
202501,25817000,3S2,1140,766,374,1.49
202501,25817000,3S3,7960,7053,907,1.13
202501,25817000,3S4,5,5,0,1
202501,25817000,4,15,4,11,3.75
202501,25817000,CA,2820,1276,1544,2.21
202501,25817000,V2,5,6,-1,0.83
202501,25817000,V3,0,6,-6,0
202501,25817000,V4,0,1,-1,0
202501,25817001,2,0,2,-2,0
202501,25817001,3S3,5,0,5,NA
202501,25817002,2,2,13,-11,0.15
202501,25817002,2S3,1,0,1,NA
202501,25817002,3S3,28,13,15,2.15
202501,25817005,2,1,0,1,NA
202501,25817005,CA,0,1,-1,0
202501,25817006,2,2,4,-2,0.5
202501,25817014,3,0,5,-5,0
202501,25817014,3S3,178,359,-181,0.5
202501,25817014,V2,3,0,3,NA
202501,25823000,2,0,4,-4,0
202501,25839000,2,2,23,-21,0.09
202501,25839000,3,54,5,49,10.8
202501,25839000,CA,0,10,-10,0
202501,25839000,V3,1552,0,1552,NA
202501,25839003,2,0,5,-5,0
202501,25839003,3,1,2,-1,0.5
202501,25839003,CA,0,2,-2,0
202501,25841000,2,4,55,-51,0.07
202501,25841000,3,0,8,-8,0
202501,25841000,3S2,0,4,-4,0
202501,25841000,3S3,1,37,-36,0.03
202501,25841000,CA,5,15,-10,0.33
202501,25843000,2,96,366,-270,0.26
202501,25843000,2R2,0,1,-1,0
202501,25843000,2R3,0,1,-1,0
202501,25843000,3,45,37,8,1.22
202501,25843000,3S2,28,5,23,5.6
202501,25843000,3S3,109,132,-23,0.83
202501,25843000,3S4,0,1,-1,0
202501,25843000,4,0,5,-5,0
202501,25843000,CA,9,209,-200,0.04
202501,25843000,V2,0,75,-75,0
202501,25843000,V3,0,169,-169,0
202501,25843000,V4,0,18,-18,0
202501,25843000,V4R2,0,2,-2,0
202501,25845000,2,0,8,-8,0
202501,25845000,3,0,3,-3,0
202501,25845000,3S3,2,3,-1,0.67
202501,25845000,CA,0,5,-5,0
202501,25851000,2,0,49,-49,0
202501,25851000,3,0,1,-1,0
202501,25851000,3S2,1,1,0,1
202501,25851000,CA,0,42,-42,0
202501,25862000,2,0,15,-15,0
202501,25862000,3,0,1,-1,0
202501,25862000,CA,0,6,-6,0
202501,25862005,CA,0,1,-1,0
202501,25867000,2,1,20,-19,0.05
202501,25867000,2S2,0,1,-1,0
202501,25867000,CA,0,7,-7,0
202501,25871000,2,0,2,-2,0
202501,25873000,2,7,94,-87,0.07
202501,25873000,2R3,0,2,-2,0
202501,25873000,3,1,9,-8,0.11
202501,25873000,3S2,1,0,1,NA
202501,25873000,3S3,25,37,-12,0.68
202501,25873000,CA,8,93,-85,0.09
202501,25873000,V2,0,1,-1,0
202501,25875000,2,53,595,-542,0.09
202501,25875000,2S2,1,0,1,NA
202501,25875000,3,4,13,-9,0.31
202501,25875000,3S2,1,7,-6,0.14
202501,25875000,3S2S3,2,0,2,NA
202501,25875000,3S3,3,71,-68,0.04
202501,25875000,CA,2,184,-182,0.01
202501,25875000,V3,0,4,-4,0
202501,25878000,2,13,72,-59,0.18
202501,25878000,3S3,4,9,-5,0.44
202501,25878000,CA,0,68,-68,0
202501,25885000,2,0,32,-32,0
202501,25885000,CA,0,7,-7,0
202501,25898000,2,0,19,-19,0
202501,25898000,CA,3,10,-7,0.3
202501,25898006,3S3,0,1,-1,0
202501,25899000,2,846,2390,-1544,0.35
202501,25899000,2R2,6,0,6,NA
202501,25899000,2S2,123,83,40,1.48
202501,25899000,2S3,138,33,105,4.18
202501,25899000,3,44,59,-15,0.75
202501,25899000,3S2,123,63,60,1.95
202501,25899000,3S3,772,507,265,1.52
202501,25899000,3S4,1,0,1,NA
202501,25899000,4,11,0,11,NA
202501,25899000,CA,173,1672,-1499,0.1
202501,25899000,V2,1,6,-5,0.17
202501,25899000,V3,107,151,-44,0.71
202501,25899000,V4,11,1,10,11
202501,25899001,3S3,0,1,-1,0
202501,25899010,2,0,3,-3,0
202501,27001000,2,196,1701,-1505,0.12
202501,27001000,2S2,12,14,-2,0.86
202501,27001000,2S3,0,1,-1,0
202501,27001000,3,6,114,-108,0.05
202501,27001000,3S2,0,15,-15,0
202501,27001000,3S3,0,139,-139,0
202501,27001000,4,1,25,-24,0.04
202501,27001000,CA,11,130,-119,0.08
202501,27001024,2,0,2,-2,0
202501,27001032,2,0,3,-3,0
202501,27001032,3S3,0,1,-1,0
202501,27001060,2,0,5,-5,0
202501,27001060,2R3,0,1,-1,0
202501,27001060,3S3,0,1,-1,0
202501,27006000,2,0,2,-2,0
202501,27006000,3S3,0,4,-4,0
202501,27006007,2,0,1,-1,0
202501,27025003,3S3,1,0,1,NA
202501,27050000,2,1,3,-2,0.33
202501,27050000,2S2,0,1,-1,0
202501,27073000,2,0,5,-5,0
202501,27073000,3,0,2,-2,0
202501,27075000,2,0,3,-3,0
202501,27077000,2,0,1,-1,0
202501,27086000,2,3,61,-58,0.05
202501,27086000,2S3,1,1,0,1
202501,27086000,3,0,23,-23,0
202501,27086000,3S2,3,0,3,NA
202501,27086000,3S3,1,11,-10,0.09
202501,27086000,CA,0,10,-10,0
202501,27086001,2,0,2,-2,0
202501,27086003,2,0,1,-1,0
202501,27086003,3,0,1,-1,0
202501,27086005,3,0,1,-1,0
202501,27135000,3,0,2,-2,0
202501,27135000,CA,2,1,1,2
202501,27150000,2,0,1,-1,0
202501,27150000,3,1,1,0,1
202501,27150001,2B2,0,1,-1,0
202501,27160000,2,2,8,-6,0.25
202501,27160000,3,0,1,-1,0
202501,27160000,3S2,0,1,-1,0
202501,27205000,2,5,119,-114,0.04
202501,27205000,3,0,20,-20,0
202501,27205000,3S2,1,1,0,1
202501,27205000,3S3,1,7,-6,0.14
202501,27205000,CA,0,12,-12,0
202501,27205015,3S2,0,1,-1,0
202501,27245000,2,5,61,-56,0.08
202501,27245000,2S2,0,4,-4,0
202501,27245000,3,2,22,-20,0.09
202501,27245000,3S2,1,20,-19,0.05
202501,27245000,3S3,170,17,153,10
202501,27245000,V3,0,2,-2,0
202501,27361000,2,66,692,-626,0.1
202501,27361000,3,0,27,-27,0
202501,27361000,3S2,2,9,-7,0.22
202501,27361000,3S3,3,25,-22,0.12
202501,27361000,4,0,5,-5,0
202501,27361000,CA,4,70,-66,0.06
202501,27361005,CA,0,1,-1,0
202501,27361033,2,1,0,1,NA
202501,27413000,2,0,5,-5,0
202501,27430000,2,1,2,-1,0.5
202501,27430000,3,1,12,-11,0.08
202501,27430011,2,0,12,-12,0
202501,27430011,3,0,2,-2,0
202501,27450000,2,0,2,-2,0
202501,27450000,3,0,2,-2,0
202501,27450006,3S2,0,1,-1,0
202501,27450006,V3,0,1,-1,0
202501,27450009,2,0,2,-2,0
202501,27450009,3,0,1,-1,0
202501,27450009,3S2,1,0,1,NA
202501,27491000,2,0,3,-3,0
202501,27491000,3,0,4,-4,0
202501,27491000,3S2,0,17,-17,0
202501,27495000,2,0,1,-1,0
202501,27495000,3S3,0,1,-1,0
202501,27615000,2,0,4,-4,0
202501,27615000,3,0,4,-4,0
202501,27615000,3S2,0,1,-1,0
202501,27615000,3S3,0,5,-5,0
202501,27615000,CA,0,2,-2,0
202501,27660000,2,0,5,-5,0
202501,27660000,3,0,1,-1,0
202501,27660000,3S2,0,4,-4,0
202501,27787000,2,4,44,-40,0.09
202501,27787000,3,0,7,-7,0
202501,27787000,3S2,4,0,4,NA
202501,27787000,3S3,0,4,-4,0
202501,27787000,CA,0,7,-7,0
202501,27787010,3S2,0,1,-1,0
202501,27810000,2,1,6,-5,0.17
202501,27810000,3S2,3,1,2,3
202501,27810000,CA,1,4,-3,0.25
202501,27810002,2,0,12,-12,0
202501,27810002,3,0,2,-2,0
202501,27810002,3S2,2,1,1,2
202501,27810002,CA,1,0,1,NA
202501,41001000,2,2497,3746,-1249,0.67
202501,41001000,2B1,0,1,-1,0
202501,41001000,2R2,53,27,26,1.96
202501,41001000,2R3,0,1,-1,0
202501,41001000,2S2,58,369,-311,0.16
202501,41001000,2S3,41,83,-42,0.49
202501,41001000,3,198,152,46,1.3
202501,41001000,3S1,3,1,2,3
202501,41001000,3S2,163,305,-142,0.53
202501,41001000,3S2S2,1,0,1,NA
202501,41001000,3S3,2021,2425,-404,0.83
202501,41001000,3S4,1,9,-8,0.11
202501,41001000,4,13,18,-5,0.72
202501,41001000,CA,683,818,-135,0.83
202501,41001001,CA,0,25,-25,0
202501,41001003,2,38,3,35,12.67
202501,41001003,3,7,0,7,NA
202501,41001003,3S2,0,1,-1,0
202501,41001003,3S3,1,4,-3,0.25
202501,41001009,2,0,2,-2,0
202501,41001009,3,0,2,-2,0
202501,41001012,2,0,1,-1,0
202501,41001018,2,0,1,-1,0
202501,41006000,2,12,184,-172,0.07
202501,41006000,3,3,3,0,1
202501,41006000,3S3,2,28,-26,0.07
202501,41006000,CA,1,29,-28,0.03
202501,41006001,2,0,1,-1,0
202501,41006005,3S2,1,0,1,NA
202501,41006005,3S3,5,0,5,NA
202501,41013000,2,1,12,-11,0.08
202501,41013000,3,1,0,1,NA
202501,41013000,3S2,0,2,-2,0
202501,41013000,3S3,0,7,-7,0
202501,41016000,2,60,76,-16,0.79
202501,41016000,2S2,2,4,-2,0.5
202501,41016000,2S3,1,2,-1,0.5
202501,41016000,3,14,341,-327,0.04
202501,41016000,3S1,1,2,-1,0.5
202501,41016000,3S2,7,14,-7,0.5
202501,41016000,3S2S2,0,1,-1,0
202501,41016000,3S3,31,215,-184,0.14
202501,41016000,4,4,6,-2,0.67
202501,41016000,CA,2,35,-33,0.06
202501,41016000,V4,0,1,-1,0
202501,41016001,2,0,7,-7,0
202501,41016003,3S2,0,1,-1,0
202501,41020000,2,3,43,-40,0.07
202501,41020000,3S3,0,3,-3,0
202501,41020000,CA,2,16,-14,0.12
202501,41026000,2,9,3,6,3
202501,41026000,3S2,0,2,-2,0
202501,41026000,3S3,1,5,-4,0.2
202501,41026000,CA,0,2,-2,0
202501,41078000,2,0,4,-4,0
202501,41078000,3S3,0,11,-11,0
202501,41078000,CA,0,3,-3,0
202501,41132000,2,14,163,-149,0.09
202501,41132000,2S2,1,0,1,NA
202501,41132000,3,38,1,37,38
202501,41132000,3S2,2,0,2,NA
202501,41132000,3S3,80,52,28,1.54
202501,41132000,CA,3,32,-29,0.09
202501,41132000,V3,55,0,55,NA
202501,41206000,2,0,1,-1,0
202501,41298000,2,100,444,-344,0.23
202501,41298000,2R2,0,1,-1,0
202501,41298000,2S2,0,3,-3,0
202501,41298000,2S3,0,2,-2,0
202501,41298000,3,12,41,-29,0.29
202501,41298000,3S2,1,1,0,1
202501,41298000,3S3,113,203,-90,0.56
202501,41298000,CA,12,99,-87,0.12
202501,41298002,3,0,9,-9,0
202501,41298004,3,0,1,-1,0
202501,41298004,3S3,0,4,-4,0
202501,41306000,2,18,48,-30,0.38
202501,41306000,2S3,0,11,-11,0
202501,41306000,3,1,1,0,1
202501,41306000,3S2,1,2,-1,0.5
202501,41306000,3S3,68,34,34,2
202501,41306000,CA,1,11,-10,0.09
202501,41319000,2,5,41,-36,0.12
202501,41319000,2S3,0,1,-1,0
202501,41319000,3,0,2,-2,0
202501,41319000,3S3,8,13,-5,0.62
202501,41319000,CA,0,3,-3,0
202501,41349000,2,6,16,-10,0.38
202501,41349000,2R3,0,2,-2,0
202501,41349000,3,27,1,26,27
202501,41349000,3S2,0,1,-1,0
202501,41349000,3S3,69,1,68,69
202501,41349000,CA,1,3,-2,0.33
202501,41357000,2,0,2,-2,0
202501,41357000,3S3,0,1,-1,0
202501,41357000,CA,1,3,-2,0.33
202501,41357003,2,0,1,-1,0
202501,41359000,2,22,104,-82,0.21
202501,41359000,3,2,3,-1,0.67
202501,41359000,3S3,0,14,-14,0
202501,41359000,CA,1,18,-17,0.06
202501,41359002,3S3,0,10,-10,0
202501,41359004,2,0,1,-1,0
202501,41378000,2,20,45,-25,0.44
202501,41378000,3,1,9,-8,0.11
202501,41378000,3S3,0,5,-5,0
202501,41378000,CA,1,16,-15,0.06
202501,41396000,2,71,348,-277,0.2
202501,41396000,2S3,0,1,-1,0
202501,41396000,3,2,15,-13,0.13
202501,41396000,3S3,1,94,-93,0.01
202501,41396000,CA,0,74,-74,0
202501,41483000,2,0,1,-1,0
202501,41483000,3,1,2,-1,0.5
202501,41503000,2,2,11,-9,0.18
202501,41503000,CA,0,9,-9,0
202501,41518000,2,9,10,-1,0.9
202501,41518000,3,268,21,247,12.76
202501,41518000,3S3,0,1,-1,0
202501,41518000,CA,0,2,-2,0
202501,41524000,2,135,328,-193,0.41
202501,41524000,2S1,0,5,-5,0
202501,41524000,2S2,3,5,-2,0.6
202501,41524000,2S3,10,3,7,3.33
202501,41524000,3,7,14,-7,0.5
202501,41524000,3S1,1,0,1,NA
202501,41524000,3S2,9,30,-21,0.3
202501,41524000,3S3,415,584,-169,0.71
202501,41524000,3S4,1,0,1,NA
202501,41524000,4,2,4,-2,0.5
202501,41524000,CA,22,58,-36,0.38
202501,41524001,3S3,0,2,-2,0
202501,41524006,CA,0,1,-1,0
202501,41530000,2,5,22,-17,0.23
202501,41530000,2S3,0,1,-1,0
202501,41530000,3,0,1,-1,0
202501,41530000,3S3,0,1,-1,0
202501,41530000,CA,1,22,-21,0.05
202501,41548000,2,1,7,-6,0.14
202501,41548000,3,0,8,-8,0
202501,41548000,3S3,0,2,-2,0
202501,41548000,CA,0,2,-2,0
202501,41551000,2,500,1763,-1263,0.28
202501,41551000,2B1,0,1,-1,0
202501,41551000,2R2,0,1,-1,0
202501,41551000,2S2,0,14,-14,0
202501,41551000,2S3,6,57,-51,0.11
202501,41551000,3,8,51,-43,0.16
202501,41551000,3S1,0,1,-1,0
202501,41551000,3S2,26,64,-38,0.41
202501,41551000,3S3,248,406,-158,0.61
202501,41551000,3S4,4,0,4,NA
202501,41551000,4,0,1,-1,0
202501,41551000,CA,147,307,-160,0.48
202501,41551000,V3,0,4,-4,0
202501,41551001,2,42,18,24,2.33
202501,41551001,3,1,8,-7,0.12
202501,41551001,3S2,1,0,1,NA
202501,41551001,3S3,1,6,-5,0.17
202501,41551001,CA,2,22,-20,0.09
202501,41615000,2,125,66,59,1.89
202501,41615000,2S3,48,1,47,48
202501,41615000,3,22,37,-15,0.59
202501,41615000,3S2,2,0,2,NA
202501,41615000,3S3,189,279,-90,0.68
202501,41615000,CA,25,55,-30,0.45
202501,41615000,V3,0,53,-53,0
202501,41660000,2,0,23,-23,0
202501,41660000,3,0,5,-5,0
202501,41660000,3S3,0,3,-3,0
202501,41660000,CA,0,11,-11,0
202501,41668000,2,35,218,-183,0.16
202501,41668000,2S3,3,0,3,NA
202501,41668000,3,0,6,-6,0
202501,41668000,3S3,1,28,-27,0.04
202501,41668000,CA,1,29,-28,0.03
202501,41668007,2,0,1,-1,0
202501,41668007,2S2,0,1,-1,0
202501,41676000,2,0,11,-11,0
202501,41676000,3S3,0,2,-2,0
202501,41676000,CA,1,4,-3,0.25
202501,41770000,2,2,38,-36,0.05
202501,41770000,3,0,3,-3,0
202501,41770000,3S2,1,5,-4,0.2
202501,41770000,3S3,1,15,-14,0.07
202501,41770000,CA,2,3,-1,0.67
202501,41770001,2,0,5,-5,0
202501,41791000,2,0,21,-21,0
202501,41791000,3,0,1,-1,0
202501,41791000,3S3,0,14,-14,0
202501,41791000,CA,0,2,-2,0
202501,41797000,2,12,79,-67,0.15
202501,41797000,2S2,1,12,-11,0.08
202501,41797000,2S3,1,5,-4,0.2
202501,41797000,3,15,179,-164,0.08
202501,41797000,3S2,1,4,-3,0.25
202501,41797000,3S3,187,84,103,2.23
202501,41797000,3S4,5,0,5,NA
202501,41797000,CA,5,6,-1,0.83
202501,41797001,CA,0,1,-1,0
202501,41799000,2,0,12,-12,0
202501,41799000,2S2,0,1,-1,0
202501,41799000,2S3,1,1,0,1
202501,41799000,3,0,1,-1,0
202501,41799000,3S2,0,29,-29,0
202501,41799000,3S3,1,30,-29,0.03
202501,41799000,CA,1,3,-2,0.33
202501,41801000,2,1,18,-17,0.06
202501,41801000,CA,1,30,-29,0.03
202501,41807000,2,21,60,-39,0.35
202501,41807000,2S2,0,1,-1,0
202501,41807000,3,0,3,-3,0
202501,41807000,3S2,1,2,-1,0.5
202501,41807000,3S3,2,93,-91,0.02
202501,41807000,CA,1,0,1,NA
202501,41872000,2,0,5,-5,0
202501,41872000,3S2,22,0,22,NA
202501,41872000,3S3,26,15,11,1.73
202501,41872000,4,2,0,2,NA
202501,41872000,CA,0,14,-14,0
202501,41872002,2,0,1,-1,0
202501,41885000,2,2,19,-17,0.11
202501,41885000,3,4,5,-1,0.8
202501,41885000,3S2,5,6,-1,0.83
202501,41885000,3S3,5,5,0,1
202501,41885000,4,2,3,-1,0.67
202501,41885000,CA,2,11,-9,0.18
202501,44001000,2,250,1579,-1329,0.16
202501,44001000,2B1,0,1,-1,0
202501,44001000,2R2,0,9,-9,0
202501,44001000,2S2,2,26,-24,0.08
202501,44001000,2S3,0,25,-25,0
202501,44001000,3,1,35,-34,0.03
202501,44001000,3S2,9,24,-15,0.38
202501,44001000,3S3,166,382,-216,0.43
202501,44001000,3S4,31,4,27,7.75
202501,44001000,CA,123,245,-122,0.5
202501,44001000,V3,5,0,5,NA
202501,44001001,2,0,3,-3,0
202501,44001001,3S3,0,2,-2,0
202501,44001002,3S3,0,3,-3,0
202501,44001003,2,1,4,-3,0.25
202501,44001003,2S3,0,2,-2,0
202501,44001011,2,0,1,-1,0
202501,44001011,3S2,1,3,-2,0.33
202501,44001011,3S3,1,0,1,NA
202501,44001016,2S3,1,0,1,NA
202501,44001020,3S3,3,0,3,NA
202501,44001025,3S2,19,1,18,19
202501,44001025,3S3,9,9,0,1
202501,44001025,V3R3,20,0,20,NA
202501,44001027,3S3,0,1,-1,0
202501,44035000,2,49,235,-186,0.21
202501,44035000,2S2,74,63,11,1.17
202501,44035000,2S3,2,4,-2,0.5
202501,44035000,3,0,3,-3,0
202501,44035000,3S2,7,28,-21,0.25
202501,44035000,3S3,70,280,-210,0.25
202501,44035000,3S4,1,11,-10,0.09
202501,44035000,CA,1,79,-78,0.01
202501,44035001,2,11,11,0,1
202501,44035001,2S2,0,1,-1,0
202501,44035001,3,0,1,-1,0
202501,44035001,3S2,0,6,-6,0
202501,44035001,3S3,3,17,-14,0.18
202501,44035001,CA,0,5,-5,0
202501,44078000,2,13,121,-108,0.11
202501,44078000,2S2,1,0,1,NA
202501,44078000,2S3,0,1,-1,0
202501,44078000,3,0,2,-2,0
202501,44078000,3S2,1,0,1,NA
202501,44078000,3S3,1,61,-60,0.02
202501,44078000,CA,2,18,-16,0.11
202501,44078006,2,0,1,-1,0
202501,44078006,CA,0,2,-2,0
202501,44090000,2,6,70,-64,0.09
202501,44090000,2S3,0,2,-2,0
202501,44090000,3S3,26,3164,-3138,0.01
202501,44090000,3S4,0,1,-1,0
202501,44090000,CA,0,1,-1,0
202501,44090003,2,16,17,-1,0.94
202501,44090003,2S3,1,0,1,NA
202501,44090003,3R3,0,2,-2,0
202501,44090003,3S2,0,7,-7,0
202501,44090003,3S3,14,2211,-2197,0.01
202501,44090003,CA,1,9,-8,0.11
202501,44090004,2,16,40,-24,0.4
202501,44090004,2S3,2,0,2,NA
202501,44090004,3,0,1,-1,0
202501,44090004,3S2,0,1,-1,0
202501,44090004,3S3,0,3,-3,0
202501,44090004,CA,4,16,-12,0.25
202501,44090006,2,1,0,1,NA
202501,44098000,2,3,30,-27,0.1
202501,44098000,2S3,0,1,-1,0
202501,44098000,3S4,1,0,1,NA
202501,44098000,CA,0,2,-2,0
202501,44098001,2,2,0,2,NA
202501,44110000,2,2,12,-10,0.17
202501,44110000,3S3,0,4,-4,0
202501,44279000,2,64,291,-227,0.22
202501,44279000,2S2,0,2,-2,0
202501,44279000,3,2,6,-4,0.33
202501,44279000,3S2,0,2,-2,0
202501,44279000,3S3,31,88,-57,0.35
202501,44279000,CA,1,83,-82,0.01
202501,44279002,2,0,1,-1,0
202501,44378000,2,33,111,-78,0.3
202501,44378000,2S2,0,1,-1,0
202501,44378000,2S3,1,1,0,1
202501,44378000,3S2,0,1,-1,0
202501,44378000,3S3,1010,15,995,67.33
202501,44378000,3S4,0,1,-1,0
202501,44378000,CA,0,18,-18,0
202501,44430000,2,269,1784,-1515,0.15
202501,44430000,2B1,0,1,-1,0
202501,44430000,2B2,0,1,-1,0
202501,44430000,2R2,0,26,-26,0
202501,44430000,2S2,2,55,-53,0.04
202501,44430000,2S3,0,33,-33,0
202501,44430000,3,2,77,-75,0.03
202501,44430000,3S2,1,24,-23,0.04
202501,44430000,3S3,51,987,-936,0.05
202501,44430000,3S4,0,2,-2,0
202501,44430000,4,0,1,-1,0
202501,44430000,CA,7,170,-163,0.04
202501,44430000,V3,0,6,-6,0
202501,44430002,3S3,0,7,-7,0
202501,44430005,2,0,1,-1,0
202501,44430005,3S2,0,2,-2,0
202501,44430007,2,10,83,-73,0.12
202501,44430007,2B2,0,2,-2,0
202501,44430007,2S2,22,39,-17,0.56
202501,44430007,2S3,11,15,-4,0.73
202501,44430007,3,0,1,-1,0
202501,44430007,3S2,20,19,1,1.05
202501,44430007,3S3,98,276,-178,0.36
202501,44430007,CA,0,15,-15,0
202501,44560000,2,4,64,-60,0.06
202501,44560000,3,0,2,-2,0
202501,44560000,3S2,1,0,1,NA
202501,44560000,3S3,6,22,-16,0.27
202501,44560000,CA,2,10,-8,0.2
202501,44560001,2,1,0,1,NA
202501,44560003,2,0,1,-1,0
202501,44560003,3S3,0,1,-1,0
202501,44560007,2,0,1,-1,0
202501,44560007,2S2,1,0,1,NA
202501,44560007,2S3,2,0,2,NA
202501,44560007,3S3,4,5,-1,0.8
202501,44560007,3S4,1,0,1,NA
202501,44650000,2,10,159,-149,0.06
202501,44650000,2R2,0,2,-2,0
202501,44650000,3,0,2,-2,0
202501,44650000,3S2,1,10,-9,0.1
202501,44650000,3S3,4,25,-21,0.16
202501,44650000,CA,1,25,-24,0.04
202501,44847000,2,176,201,-25,0.88
202501,44847000,2R2,0,7,-7,0
202501,44847000,2S2,18,10,8,1.8
202501,44847000,2S3,1,0,1,NA
202501,44847000,3,12,5,7,2.4
202501,44847000,3S2,7,3,4,2.33
202501,44847000,3S3,328,207,121,1.58
202501,44847000,CA,1,71,-70,0.01
202501,44847003,2,1,0,1,NA
202501,44847003,CA,1,0,1,NA
202501,44855000,2,1,11,-10,0.09
202501,44855000,2S2,0,1,-1,0
202501,44855000,3S2,0,1,-1,0
202501,44855000,3S3,0,9,-9,0
202501,44855000,CA,0,10,-10,0
202501,44874000,2,6,145,-139,0.04
202501,44874000,3S2,0,2,-2,0
202501,44874000,3S3,4,13,-9,0.31
202501,44874000,CA,0,30,-30,0
202501,47001000,2,1969,6271,-4302,0.31
202501,47001000,2B1,1,3,-2,0.33
202501,47001000,2B2,4,2,2,2
202501,47001000,2R2,3,203,-200,0.01
202501,47001000,2R3,0,1,-1,0
202501,47001000,2S1,3,2,1,1.5
202501,47001000,2S2,749,861,-112,0.87
202501,47001000,2S3,185,231,-46,0.8
202501,47001000,3,95,183,-88,0.52
202501,47001000,3S1,0,5,-5,0
202501,47001000,3S2,1108,2178,-1070,0.51
202501,47001000,3S2S2,1,0,1,NA
202501,47001000,3S3,13021,8848,4173,1.47
202501,47001000,3S4,8,11,-3,0.73
202501,47001000,CA,502,1185,-683,0.42
202501,47001000,V2,3,0,3,NA
202501,47001000,V3,0,9,-9,0
202501,47001000,V3R3,20,32,-12,0.62
202501,47001002,2,1,6,-5,0.17
202501,47001002,CA,0,1,-1,0
202501,47001003,2,1,0,1,NA
202501,47001003,3S2,21,0,21,NA
202501,47001003,3S3,1,0,1,NA
202501,47001005,2,1,4,-3,0.25
202501,47001005,3S3,0,2,-2,0
202501,47001006,2,11,14,-3,0.79
202501,47001006,3S2,68,56,12,1.21
202501,47001006,3S3,52,0,52,NA
202501,47001006,CA,1,1,0,1
202501,47001009,2,0,3,-3,0
202501,47001009,CA,0,9,-9,0
202501,47001010,2,1,7,-6,0.14
202501,47001010,3S3,1,0,1,NA
202501,47001011,2,2,13,-11,0.15
202501,47001011,2S3,0,1,-1,0
202501,47001011,3S2,25,25,0,1
202501,47001011,3S3,11,1,10,11
202501,47001011,CA,0,4,-4,0
202501,47001019,2,0,1,-1,0
202501,47001019,3,0,1,-1,0
202501,47001019,3S3,1,1,0,1
202501,47030000,2,6,16,-10,0.38
202501,47030000,2S2,1,0,1,NA
202501,47030000,2S3,0,1,-1,0
202501,47030000,3,0,1,-1,0
202501,47030000,3S2,0,1,-1,0
202501,47030000,3S3,1,3,-2,0.33
202501,47030000,CA,0,1,-1,0
202501,47030004,2,6,0,6,NA
202501,47053000,2,11,129,-118,0.09
202501,47053000,2S3,6,5,1,1.2
202501,47053000,3,11,1,10,11
202501,47053000,3S2,4,4,0,1
202501,47053000,3S3,240,168,72,1.43
202501,47053000,CA,0,10,-10,0
202501,47053000,V3R3,2,43,-41,0.05
202501,47053008,2,0,2,-2,0
202501,47053008,2S3,0,5,-5,0
202501,47053008,3,0,4,-4,0
202501,47053008,3S3,0,1,-1,0
202501,47053008,CA,1,0,1,NA
202501,47053013,2,1,1,0,1
202501,47058000,2,7,86,-79,0.08
202501,47058000,3,0,2,-2,0
202501,47058000,3S2,7,100,-93,0.07
202501,47058000,3S3,4,146,-142,0.03
202501,47058000,CA,0,2,-2,0
202501,47058003,2,7,3,4,2.33
202501,47058003,3,1,0,1,NA
202501,47058003,3S1,2,0,2,NA
202501,47058003,3S2,1,4,-3,0.25
202501,47058003,3S3,3,4,-1,0.75
202501,47058003,V3,1,0,1,NA
202501,47058005,2,0,1,-1,0
202501,47058007,2,0,1,-1,0
202501,47058009,3S3,0,1,-1,0
202501,47161002,3S3,1,0,1,NA
202501,47170000,2,7,62,-55,0.11
202501,47170000,3,0,5,-5,0
202501,47170000,3S2,1,1,0,1
202501,47170000,3S3,0,9,-9,0
202501,47170000,CA,0,6,-6,0
202501,47189000,2,177,914,-737,0.19
202501,47189000,2B1,0,10,-10,0
202501,47189000,2R2,0,17,-17,0
202501,47189000,2S2,2,13,-11,0.15
202501,47189000,2S3,10,18,-8,0.56
202501,47189000,3,24,30,-6,0.8
202501,47189000,3S2,11,52,-41,0.21
202501,47189000,3S3,378,293,85,1.29
202501,47189000,3S4,0,1,-1,0
202501,47189000,CA,9,141,-132,0.06
202501,47189000,V3,8,0,8,NA
202501,47189006,2,0,2,-2,0
202501,47189009,2,1,0,1,NA
202501,47189009,3S2,2,2,0,1
202501,47189018,2,0,1,-1,0
202501,47189022,2S3,1,0,1,NA
202501,47189022,3S3,4,0,4,NA
202501,47205000,2,3,6,-3,0.5
202501,47205000,CA,2,1,1,2
202501,47205001,2S3,1,0,1,NA
202501,47245000,2,28,455,-427,0.06
202501,47245000,2B2,0,1,-1,0
202501,47245000,2R2,0,5,-5,0
202501,47245000,2S2,0,1,-1,0
202501,47245000,2S3,0,14,-14,0
202501,47245000,3,0,20,-20,0
202501,47245000,3S2,5,3,2,1.67
202501,47245000,3S3,4,35,-31,0.11
202501,47245000,3S4,1,2,-1,0.5
202501,47245000,CA,23,40,-17,0.58
202501,47245001,2,0,4,-4,0
202501,47245002,2S3,1,0,1,NA
202501,47245002,3S3,0,1,-1,0
202501,47245005,2,0,1,-1,0
202501,47245005,3S3,0,2,-2,0
202501,47245028,3S2,0,4,-4,0
202501,47245028,3S3,0,13,-13,0
202501,47258000,2,4,31,-27,0.13
202501,47258000,CA,0,2,-2,0
202501,47258003,2S3,0,1,-1,0
202501,47258005,2,0,1,-1,0
202501,47258005,2S2,0,1,-1,0
202501,47258015,2,0,1,-1,0
202501,47268000,2,9,68,-59,0.13
202501,47268000,2S2,1,0,1,NA
202501,47268000,2S3,0,1,-1,0
202501,47268000,3,0,1,-1,0
202501,47268000,3S2,14,12,2,1.17
202501,47268000,3S3,0,9,-9,0
202501,47268000,CA,0,2,-2,0
202501,47288000,2,75,459,-384,0.16
202501,47288000,2R2,0,1,-1,0
202501,47288000,2S2,0,25,-25,0
202501,47288000,2S3,1,2,-1,0.5
202501,47288000,3,9,20,-11,0.45
202501,47288000,3S1,0,2,-2,0
202501,47288000,3S2,13,13,0,1
202501,47288000,3S3,25,140,-115,0.18
202501,47288000,CA,10,52,-42,0.19
202501,47318000,2,29,128,-99,0.23
202501,47318000,2B2,0,1,-1,0
202501,47318000,2S3,0,5,-5,0
202501,47318000,3,0,3,-3,0
202501,47318000,3S2,0,2,-2,0
202501,47318000,3S3,0,19,-19,0
202501,47318000,CA,10,27,-17,0.37
202501,47318005,2S3,1,0,1,NA
202501,47318005,3S3,0,2,-2,0
202501,47318012,2,4,1,3,4
202501,47318012,2S3,0,1,-1,0
202501,47318012,3S3,3,0,3,NA
202501,47318012,CA,1,3,-2,0.33
202501,47460000,2,8,25,-17,0.32
202501,47460000,3,1,0,1,NA
202501,47460000,3S2,0,4,-4,0
202501,47460000,3S3,1,9,-8,0.11
202501,47460000,CA,1,6,-5,0.17
202501,47460000,V2,0,1,-1,0
202501,47460001,2,0,2,-2,0
202501,47460001,CA,0,4,-4,0
202501,47460002,2,1,1,0,1
202501,47460002,3S3,1,0,1,NA
202501,47460004,2,0,1,-1,0
202501,47460004,3S2,0,1,-1,0
202501,47460005,2,0,5,-5,0
202501,47460005,3S3,0,1,-1,0
202501,47460005,CA,0,1,-1,0
202501,47541000,2,0,4,-4,0
202501,47545000,2,9,10,-1,0.9
202501,47545000,3S3,0,4,-4,0
202501,47545000,CA,1,0,1,NA
202501,47545001,3S2,1,0,1,NA
202501,47551000,2,4,194,-190,0.02
202501,47551000,2S1,3,0,3,NA
202501,47551000,2S2,1,0,1,NA
202501,47551000,2S3,0,2,-2,0
202501,47551000,3,1,0,1,NA
202501,47551000,3S1,1,2,-1,0.5
202501,47551000,3S2,4,0,4,NA
202501,47551000,3S3,14,4,10,3.5
202501,47551000,3S4,0,1,-1,0
202501,47551000,CA,4,40,-36,0.1
202501,47551000,V3,1,0,1,NA
202501,47551009,2,0,1,-1,0
202501,47551009,2S2,1,0,1,NA
202501,47551009,3S3,3,0,3,NA
202501,47555000,2,42,324,-282,0.13
202501,47555000,2S3,1,3,-2,0.33
202501,47555000,3,0,6,-6,0
202501,47555000,3S2,113,6,107,18.83
202501,47555000,3S3,662,40,622,16.55
202501,47555000,CA,4,49,-45,0.08
202501,47555001,3S2,25,0,25,NA
202501,47555001,3S3,70,0,70,NA
202501,47570000,2,1,1,0,1
202501,47570000,CA,0,3,-3,0
202501,47570004,2,1,0,1,NA
202501,47605000,2,0,7,-7,0
202501,47605000,CA,0,3,-3,0
202501,47660000,2,6,4,2,1.5
202501,47660000,2S2,0,1,-1,0
202501,47660000,2S3,1,1,0,1
202501,47660000,3,0,4,-4,0
202501,47660000,3S2,0,2,-2,0
202501,47660000,3S3,2,2,0,1
202501,47660000,CA,0,1,-1,0
202501,47675000,2,1,7,-6,0.14
202501,47675000,2S2,1,0,1,NA
202501,47675000,3S3,0,2,-2,0
202501,47675000,CA,0,1,-1,0
202501,47692000,2,7,29,-22,0.24
202501,47692000,3,0,11,-11,0
202501,47692000,3S2,1,0,1,NA
202501,47692000,3S3,58,6,52,9.67
202501,47692001,3,0,1,-1,0
202501,47692008,2,0,1,-1,0
202501,47703000,2,1,0,1,NA
202501,47703000,3S2,0,1,-1,0
202501,47707000,2,8,63,-55,0.13
202501,47707000,2S2,0,2,-2,0
202501,47707000,3,0,4,-4,0
202501,47707000,3S2,5,1,4,5
202501,47707000,3S3,21,17,4,1.24
202501,47707000,CA,1,3,-2,0.33
202501,47707001,2,0,5,-5,0
202501,47707004,2,1,0,1,NA
202501,47720000,2,1,3,-2,0.33
202501,47720000,CA,1,0,1,NA
202501,47745000,2,12,68,-56,0.18
202501,47745000,2S2,5,23,-18,0.22
202501,47745000,2S3,70,96,-26,0.73
202501,47745000,3,0,1,-1,0
202501,47745000,3S2,114,5,109,22.8
202501,47745000,3S3,3119,3205,-86,0.97
202501,47745000,3S4,9,1,8,9
202501,47745000,CA,0,8,-8,0
202501,47745000,V2,33,9,24,3.67
202501,47745000,V3,158,29,129,5.45
202501,47745000,V4,54,1,53,54
202501,47745003,2,304,60,244,5.07
202501,47745003,2S2,3,2,1,1.5
202501,47745003,2S3,12,10,2,1.2
202501,47745003,3,106,3,103,35.33
202501,47745003,3S2,60,33,27,1.82
202501,47745003,3S3,1513,726,787,2.08
202501,47745003,CA,0,11,-11,0
202501,47745003,V2,0,3,-3,0
202501,47745003,V3,1,6,-5,0.17
202501,47798000,2,2,8,-6,0.25
202501,47798000,3,1,0,1,NA
202501,47798000,3S3,0,5,-5,0
202501,47798000,CA,1,1,0,1
202501,47960000,3,0,2,-2,0
202501,47980000,2,246,119,127,2.07
202501,47980000,2S2,0,3,-3,0
202501,47980000,2S3,1,0,1,NA
202501,47980000,3,0,4,-4,0
202501,47980000,3S2,341,125,216,2.73
202501,47980000,3S2S3,1,0,1,NA
202501,47980000,3S3,94,58,36,1.62
202501,47980000,CA,0,11,-11,0
202501,47980001,2,79,42,37,1.88
202501,47980001,3S2,69,54,15,1.28
202501,47980001,3S3,0,4,-4,0
202501,47980001,CA,0,4,-4,0
202501,47980002,2,0,1,-1,0
202501,47980002,3S2,1,0,1,NA
202501,47980002,3S3,4,1,3,4
202501,47980003,2,42,4,38,10.5
202501,47980003,2R2,0,6,-6,0
202501,47980003,2S2,0,8,-8,0
202501,47980003,2S3,0,6,-6,0
202501,47980003,3,0,3,-3,0
202501,47980003,3S2,5,3,2,1.67
202501,47980003,3S3,2,33,-31,0.06
202501,47980003,CA,1,0,1,NA
202501,47980004,2,133,119,14,1.12
202501,47980004,2R2,0,9,-9,0
202501,47980004,2S2,0,2,-2,0
202501,47980004,2S3,0,1,-1,0
202501,47980004,3,1,5,-4,0.2
202501,47980004,3S2,202,166,36,1.22
202501,47980004,3S3,0,3,-3,0
202501,47980004,CA,0,4,-4,0
202501,47980006,2,108,71,37,1.52
202501,47980006,3,0,3,-3,0
202501,47980006,3S2,9,8,1,1.12
202501,47980006,3S3,3,0,3,NA
202501,47980006,CA,0,1,-1,0
202501,47980007,3S2,0,5,-5,0
202501,47980007,3S3,0,1,-1,0
202501,47980008,2,53,67,-14,0.79
202501,47980008,2S2,0,1,-1,0
202501,47980008,2S3,0,1,-1,0
202501,47980008,3,1,1,0,1
202501,47980008,3S2,104,96,8,1.08
202501,47980008,3S3,3,6,-3,0.5
202501,47980010,2,4,8,-4,0.5
202501,47980010,2S2,2,0,2,NA
202501,47980010,2S3,1,0,1,NA
202501,47980010,3,1,1,0,1
202501,47980010,3S2,59,43,16,1.37
202501,47980010,3S3,7,13,-6,0.54
202501,47980010,3S4,1,0,1,NA
202501,47980010,CA,1,0,1,NA
202501,47980010,V3R3,16,0,16,NA
202501,47980011,2,0,1,-1,0
202501,47980011,3S2,3,0,3,NA
202501,47980012,2,4,0,4,NA
202501,47980012,2S3,1,0,1,NA
202501,47980012,3S3,489,0,489,NA
202501,47980013,3S2,6,2,4,3
202501,47980013,3S3,20,6,14,3.33
202501,50001000,2,3092,5566,-2474,0.56
202501,50001000,2B1,0,1,-1,0
202501,50001000,2B2,45,0,45,NA
202501,50001000,2R2,8,15,-7,0.53
202501,50001000,2S1,0,8,-8,0
202501,50001000,2S2,178,652,-474,0.27
202501,50001000,2S3,208,248,-40,0.84
202501,50001000,3,382,468,-86,0.82
202501,50001000,3S1,4,8,-4,0.5
202501,50001000,3S2,895,1144,-249,0.78
202501,50001000,3S3,2461,4227,-1766,0.58
202501,50001000,3S4,6,13,-7,0.46
202501,50001000,4,14,12,2,1.17
202501,50001000,CA,874,1441,-567,0.61
202501,50001000,V2,1,2,-1,0.5
202501,50001000,V2R3,3,0,3,NA
202501,50001000,V3,27,12,15,2.25
202501,50001000,V3R3,29,0,29,NA
202501,50001000,V4,1,0,1,NA
202501,50001001,3S3,0,13,-13,0
202501,50001002,2,6,8,-2,0.75
202501,50001002,2S3,1,0,1,NA
202501,50001002,3S2,0,12,-12,0
202501,50001002,3S3,15,81,-66,0.19
202501,50001002,3S4,1,1,0,1
202501,50001002,CA,0,1,-1,0
202501,50001002,V3,1,0,1,NA
202501,50001003,2,0,1,-1,0
202501,50001013,2,0,1,-1,0
202501,50001015,2,12,8,4,1.5
202501,50001015,2S2,2,0,2,NA
202501,50001015,3S3,5,75,-70,0.07
202501,50001015,CA,2,3,-1,0.67
202501,50001019,2,60,3,57,20
202501,50001019,2S2,0,2,-2,0
202501,50001019,2S3,1,0,1,NA
202501,50001019,3,89,0,89,NA
202501,50001019,3S2,14,4,10,3.5
202501,50001019,3S3,43,127,-84,0.34
202501,50001019,CA,2,12,-10,0.17
202501,50006000,2,429,804,-375,0.53
202501,50006000,2B2,0,2,-2,0
202501,50006000,2R3,0,1,-1,0
202501,50006000,2S1,1,1,0,1
202501,50006000,2S2,37,27,10,1.37
202501,50006000,2S3,13,20,-7,0.65
202501,50006000,3,175,51,124,3.43
202501,50006000,3S1,18,5,13,3.6
202501,50006000,3S2,1033,142,891,7.27
202501,50006000,3S3,1322,728,594,1.82
202501,50006000,3S4,5,26,-21,0.19
202501,50006000,4,3,5,-2,0.6
202501,50006000,CA,41,232,-191,0.18
202501,50006000,V2,1,3,-2,0.33
202501,50006000,V3,215,11,204,19.55
202501,50006000,V4,0,2,-2,0
202501,50006001,2,2,3,-1,0.67
202501,50006001,3S3,2,2,0,1
202501,50006001,CA,0,1,-1,0
202501,50006003,2,11,37,-26,0.3
202501,50006003,2S2,3,6,-3,0.5
202501,50006003,2S3,5,2,3,2.5
202501,50006003,3,0,1,-1,0
202501,50006003,3S1,2,6,-4,0.33
202501,50006003,3S2,16,31,-15,0.52
202501,50006003,3S3,10,37,-27,0.27
202501,50006003,3S4,1,1,0,1
202501,50006003,CA,16,8,8,2
202501,50110000,2,32,54,-22,0.59
202501,50110000,2S2,3,5,-2,0.6
202501,50110000,2S3,1,2,-1,0.5
202501,50110000,3,16,13,3,1.23
202501,50110000,3S2,489,89,400,5.49
202501,50110000,3S3,941,103,838,9.14
202501,50110000,3S4,77,5,72,15.4
202501,50110000,CA,5,28,-23,0.18
202501,50110000,V2,0,2,-2,0
202501,50110000,V3,9,0,9,NA
202501,50110001,3S3,28,0,28,NA
202501,50110004,3S2,0,1,-1,0
202501,50110004,3S3,1,1,0,1
202501,50124000,2,20,71,-51,0.28
202501,50124000,2S2,2,4,-2,0.5
202501,50124000,2S3,8,8,0,1
202501,50124000,3,1,67,-66,0.01
202501,50124000,3S1,0,1,-1,0
202501,50124000,3S2,1178,5,1173,235.6
202501,50124000,3S3,2999,248,2751,12.09
202501,50124000,3S4,2,74,-72,0.03
202501,50124000,CA,1,5,-4,0.2
202501,50124000,V2,0,31,-31,0
202501,50124000,V3,79,358,-279,0.22
202501,50124002,3S3,4,0,4,NA
202501,50150000,2,65,260,-195,0.25
202501,50150000,2S2,6,16,-10,0.38
202501,50150000,2S3,8,28,-20,0.29
202501,50150000,3,9,52,-43,0.17
202501,50150000,3S1,6,8,-2,0.75
202501,50150000,3S2,228,274,-46,0.83
202501,50150000,3S3,203,282,-79,0.72
202501,50150000,3S4,1,5,-4,0.2
202501,50150000,4,2,0,2,NA
202501,50150000,CA,9,50,-41,0.18
202501,50150000,V2,4,63,-59,0.06
202501,50150000,V3,22,77,-55,0.29
202501,50150001,3S3,0,2,-2,0
202501,50150001,CA,1,2,-1,0.5
202501,50223000,2,3,26,-23,0.12
202501,50223000,3,0,1,-1,0
202501,50223000,3S3,0,6,-6,0
202501,50223000,CA,1,8,-7,0.12
202501,50226000,2,27,151,-124,0.18
202501,50226000,2B2,0,3,-3,0
202501,50226000,2S3,0,1,-1,0
202501,50226000,3,4,70,-66,0.06
202501,50226000,3S2,44,1,43,44
202501,50226000,3S3,193,55,138,3.51
202501,50226000,4,0,1,-1,0
202501,50226000,CA,6,78,-72,0.08
202501,50226004,2,0,3,-3,0
202501,50226004,2S3,0,1,-1,0
202501,50226004,CA,0,2,-2,0
202501,50226005,2,1,2,-1,0.5
202501,50226005,3,1,0,1,NA
202501,50245000,CA,1,0,1,NA
202501,50251000,2,12,35,-23,0.34
202501,50251000,3S2,0,2,-2,0
202501,50251000,3S3,3,6,-3,0.5
202501,50251000,CA,1,4,-3,0.25
202501,50270000,2,1,9,-8,0.11
202501,50270000,3,0,3,-3,0
202501,50270000,3S3,0,1,-1,0
202501,50270000,CA,0,6,-6,0
202501,50287000,2,2,39,-37,0.05
202501,50287000,2B2,0,2,-2,0
202501,50287000,3,0,2,-2,0
202501,50287000,3S3,2,1,1,2
202501,50287000,CA,0,8,-8,0
202501,50313000,2,137,828,-691,0.17
202501,50313000,2B2,0,5,-5,0
202501,50313000,2R2,0,1,-1,0
202501,50313000,2S2,1,6,-5,0.17
202501,50313000,2S3,7,4,3,1.75
202501,50313000,3,4,30,-26,0.13
202501,50313000,3S2,3,12,-9,0.25
202501,50313000,3S3,156,308,-152,0.51
202501,50313000,3S4,2,0,2,NA
202501,50313000,CA,13,253,-240,0.05
202501,50313002,2,0,28,-28,0
202501,50313002,2R3,0,5,-5,0
202501,50313002,2S2,0,9,-9,0
202501,50313002,2S3,0,3,-3,0
202501,50313005,2,2,0,2,NA
202501,50313007,3S4,1,0,1,NA
202501,50318000,2,164,162,2,1.01
202501,50318000,2S2,7,3,4,2.33
202501,50318000,2S3,3,2,1,1.5
202501,50318000,3,298,47,251,6.34
202501,50318000,3S1,5,4,1,1.25
202501,50318000,3S2,1170,261,909,4.48
202501,50318000,3S3,1031,307,724,3.36
202501,50318000,3S4,3,0,3,NA
202501,50318000,4,4,0,4,NA
202501,50318000,CA,6,46,-40,0.13
202501,50318000,V2,74,1,73,74
202501,50318000,V3,288,0,288,NA
202501,50318001,2,2,3,-1,0.67
202501,50318001,3S2,0,1,-1,0
202501,50325000,2,1,7,-6,0.14
202501,50325000,2S3,0,1,-1,0
202501,50325000,3,0,3,-3,0
202501,50325000,3S2,9,1,8,9
202501,50325000,3S3,51,23,28,2.22
202501,50325000,CA,1,1,0,1
202501,50325000,V3,1,4,-3,0.25
202501,50330000,2,3,53,-50,0.06
202501,50330000,2B2,0,6,-6,0
202501,50330000,2S2,0,3,-3,0
202501,50330000,2S3,1,0,1,NA
202501,50330000,CA,1,2,-1,0.5
202501,50330008,2,0,1,-1,0
202501,50350000,2,0,15,-15,0
202501,50350000,3,0,1,-1,0
202501,50350000,CA,1,0,1,NA
202501,50350003,CA,1,0,1,NA
202501,50370000,2,0,20,-20,0
202501,50370000,2S2,0,1,-1,0
202501,50370000,3,0,2,-2,0
202501,50370000,3S1,0,1,-1,0
202501,50370000,3S3,1,4,-3,0.25
202501,50370000,CA,1,3,-2,0.33
202501,50370001,4,0,1,-1,0
202501,50370001,CA,1,0,1,NA
202501,50400000,2,0,32,-32,0
202501,50400000,3,1,2,-1,0.5
202501,50400000,3S3,0,4,-4,0
202501,50400000,CA,1,8,-7,0.12
202501,50400000,V2,1,0,1,NA
202501,50400001,2,0,1,-1,0
202501,50400001,3,0,2,-2,0
202501,50400001,3S3,0,5,-5,0
202501,50450000,2,0,7,-7,0
202501,50450000,2S3,1,0,1,NA
202501,50450000,3,0,1,-1,0
202501,50450000,3S3,2,3,-1,0.67
202501,50450000,CA,2,1,1,2
202501,50568000,2,162,882,-720,0.18
202501,50568000,2B2,0,4,-4,0
202501,50568000,2S1,0,8,-8,0
202501,50568000,2S2,14,29,-15,0.48
202501,50568000,2S3,31,66,-35,0.47
202501,50568000,3,19,76,-57,0.25
202501,50568000,3R2,0,1,-1,0
202501,50568000,3R3,0,6,-6,0
202501,50568000,3S1,0,1,-1,0
202501,50568000,3S2,1388,435,953,3.19
202501,50568000,3S3,3139,1633,1506,1.92
202501,50568000,3S4,2,6,-4,0.33
202501,50568000,4,1,2,-1,0.5
202501,50568000,CA,31,148,-117,0.21
202501,50568000,V2,0,1,-1,0
202501,50568000,V2R2,0,2,-2,0
202501,50568000,V2R3,0,20,-20,0
202501,50568000,V3,1,2,-1,0.5
202501,50568000,V3R2,0,10,-10,0
202501,50568000,V3R3,0,340,-340,0
202501,50568000,V4,1,0,1,NA
202501,50568001,2,0,6,-6,0
202501,50568001,3S3,3,1,2,3
202501,50568002,2,0,3,-3,0
202501,50568002,3S3,0,1,-1,0
202501,50568004,3S2,1,0,1,NA
202501,50568004,3S3,3,0,3,NA
202501,50568006,3S2,1,0,1,NA
202501,50568007,2,1,4,-3,0.25
202501,50568007,CA,0,2,-2,0
202501,50568009,3S3,0,1,-1,0
202501,50568010,2,5,38,-33,0.13
202501,50568010,2S2,2,3,-1,0.67
202501,50568010,2S3,11,10,1,1.1
202501,50568010,3S2,1,3,-2,0.33
202501,50568010,3S3,23,22,1,1.05
202501,50568010,3S4,0,3,-3,0
202501,50568010,CA,1,11,-10,0.09
202501,50568011,2,38,179,-141,0.21
202501,50568011,2S1,1,3,-2,0.33
202501,50568011,2S2,5,28,-23,0.18
202501,50568011,2S3,3,19,-16,0.16
202501,50568011,3,0,10,-10,0
202501,50568011,3S1,1,1,0,1
202501,50568011,3S2,85,372,-287,0.23
202501,50568011,3S3,194,894,-700,0.22
202501,50568011,3S4,13,5,8,2.6
202501,50568011,CA,9,43,-34,0.21
202501,50568011,V2R3,0,14,-14,0
202501,50568011,V3,1,2,-1,0.5
202501,50568011,V3R2,0,3,-3,0
202501,50568011,V3R3,0,83,-83,0
202501,50568011,V4R2,0,7,-7,0
202501,50573000,2,68,309,-241,0.22
202501,50573000,2B2,0,6,-6,0
202501,50573000,2S2,5,6,-1,0.83
202501,50573000,2S3,37,39,-2,0.95
202501,50573000,3,18,21,-3,0.86
202501,50573000,3R2,1,0,1,NA
202501,50573000,3R3,6,0,6,NA
202501,50573000,3S2,218,36,182,6.06
202501,50573000,3S3,711,214,497,3.32
202501,50573000,3S4,3,2,1,1.5
202501,50573000,4,1,1,0,1
202501,50573000,CA,4,54,-50,0.07
202501,50573000,V2,27,0,27,NA
202501,50573000,V2R2,2,0,2,NA
202501,50573000,V2R3,31,0,31,NA
202501,50573000,V3,340,0,340,NA
202501,50573000,V3R2,13,0,13,NA
202501,50573000,V3R3,399,0,399,NA
202501,50573000,V4R2,7,0,7,NA
202501,50573001,3S3,24,0,24,NA
202501,50573003,2,5,3,2,1.67
202501,50573003,3,0,1,-1,0
202501,50573003,3S3,4,0,4,NA
202501,50573003,CA,1,1,0,1
202501,50577000,2,2,21,-19,0.1
202501,50577000,2S2,1,0,1,NA
202501,50577000,3S2,0,1,-1,0
202501,50577000,3S3,1,4,-3,0.25
202501,50577000,CA,1,4,-3,0.25
202501,50590000,2,1,26,-25,0.04
202501,50590000,2S2,0,6,-6,0
202501,50590000,3S2,25,1,24,25
202501,50590000,3S3,105,18,87,5.83
202501,50590000,4,0,2,-2,0
202501,50590000,CA,1,7,-6,0.14
202501,50590000,V3,230,1,229,230
202501,50606000,2,31,244,-213,0.13
202501,50606000,2B2,0,6,-6,0
202501,50606000,2S2,2,1,1,2
202501,50606000,3,2,53,-51,0.04
202501,50606000,3S2,4,32,-28,0.12
202501,50606000,3S3,12,39,-27,0.31
202501,50606000,CA,5,73,-68,0.07
202501,50680000,2,22,70,-48,0.31
202501,50680000,2S2,1,2,-1,0.5
202501,50680000,2S3,3,6,-3,0.5
202501,50680000,3,0,17,-17,0
202501,50680000,3S2,96,82,14,1.17
202501,50680000,3S3,635,200,435,3.17
202501,50680000,CA,1,15,-14,0.07
202501,50680000,V2,0,3,-3,0
202501,50680000,V3,1,371,-370,0
202501,50680001,2,0,5,-5,0
202501,50680002,CA,0,1,-1,0
202501,50680003,2,0,1,-1,0
202501,50680003,3S2,0,1,-1,0
202501,50680003,3S3,0,4,-4,0
202501,50683000,2,2,14,-12,0.14
202501,50683000,3S2,1,3,-2,0.33
202501,50683000,3S3,1,1,0,1
202501,50683000,4,0,1,-1,0
202501,50683000,CA,1,6,-5,0.17
202501,50683000,V2,0,2,-2,0
202501,50683000,V3,0,2,-2,0
202501,50686000,CA,1,0,1,NA
202501,50689000,2,113,117,-4,0.97
202501,50689000,2B2,0,1,-1,0
202501,50689000,2S3,0,1,-1,0
202501,50689000,3,12,13,-1,0.92
202501,50689000,3S2,51,1,50,51
202501,50689000,3S3,324,56,268,5.79
202501,50689000,4,1,2,-1,0.5
202501,50689000,CA,60,28,32,2.14
202501,50689000,V2,0,4,-4,0
202501,50689000,V3,0,245,-245,0
202501,50711000,2,2,58,-56,0.03
202501,50711000,3,1,2,-1,0.5
202501,50711000,3S2,1,1,0,1
202501,50711000,3S3,0,14,-14,0
202501,50711000,CA,2,11,-9,0.18
202501,50711000,V3,0,3,-3,0
202501,52001000,2,3197,4041,-844,0.79
202501,52001000,2B1,0,1,-1,0
202501,52001000,2S2,28,304,-276,0.09
202501,52001000,2S3,14,103,-89,0.14
202501,52001000,3,14,97,-83,0.14
202501,52001000,3S2,131,330,-199,0.4
202501,52001000,3S3,416,1646,-1230,0.25
202501,52001000,CA,1216,445,771,2.73
202501,52001000,V2,0,1,-1,0
202501,52001001,2,28,23,5,1.22
202501,52001001,3,1,0,1,NA
202501,52001001,3S2,25,1,24,25
202501,52001001,3S3,0,3,-3,0
202501,52001001,CA,22,14,8,1.57
202501,52001003,2,0,5,-5,0
202501,52001003,3,0,2,-2,0
202501,52001003,3S2,0,1,-1,0
202501,52001003,CA,0,30,-30,0
202501,52001004,2,1,0,1,NA
202501,52001006,2,4,14,-10,0.29
202501,52001006,2S2,2,0,2,NA
202501,52001010,2,0,1,-1,0
202501,52001010,3S3,0,1,-1,0
202501,52001010,CA,0,1,-1,0
202501,52001030,2,1,0,1,NA
202501,52001031,2,0,1,-1,0
202501,52001031,3S3,1,0,1,NA
202501,52001039,2,0,2,-2,0
202501,52001039,3S3,0,1,-1,0
202501,52001042,3S2,0,1,-1,0
202501,52001056,2,0,1,-1,0
202501,52001056,3S3,0,1,-1,0
202501,52001058,CA,0,1,-1,0
202501,52001059,2,1,0,1,NA
202501,52001061,2,0,2,-2,0
202501,52019000,2,1,23,-22,0.04
202501,52019003,2,0,4,-4,0
202501,52019003,CA,0,22,-22,0
202501,52022000,2,0,16,-16,0
202501,52022000,CA,0,20,-20,0
202501,52036000,2,1,9,-8,0.11
202501,52036000,CA,0,20,-20,0
202501,52051000,2,0,5,-5,0
202501,52051000,3,0,1,-1,0
202501,52051000,CA,2,2,0,1
202501,52079000,2,2,65,-63,0.03
202501,52079000,3S3,0,3,-3,0
202501,52079000,CA,0,22,-22,0
202501,52079006,2,0,1,-1,0
202501,52079012,2,0,7,-7,0
202501,52079012,3S3,0,1,-1,0
202501,52083000,2,5,19,-14,0.26
202501,52083000,3S3,0,1,-1,0
202501,52083000,CA,0,22,-22,0
202501,52110000,2,10,43,-33,0.23
202501,52110000,3,2,1,1,2
202501,52110000,3S2,0,2,-2,0
202501,52110000,3S3,1,13,-12,0.08
202501,52110000,CA,1,29,-28,0.03
202501,52110000,V2,0,1,-1,0
202501,52110007,2,0,1,-1,0
202501,52110007,CA,0,1,-1,0
202501,52203000,2,0,24,-24,0
202501,52203000,CA,0,33,-33,0
202501,52203007,2,2,7,-5,0.29
202501,52203007,CA,0,2,-2,0
202501,52207000,2,5,21,-16,0.24
202501,52207000,3,0,2,-2,0
202501,52207000,3S3,0,2,-2,0
202501,52207000,CA,0,18,-18,0
202501,52210000,2,0,9,-9,0
202501,52210000,CA,0,2,-2,0
202501,52215000,2,0,20,-20,0
202501,52215000,3,0,3,-3,0
202501,52215000,3S3,0,1,-1,0
202501,52215000,CA,0,21,-21,0
202501,52215002,2,0,5,-5,0
202501,52224000,2,0,2,-2,0
202501,52224000,3S3,0,1,-1,0
202501,52224000,CA,0,3,-3,0
202501,52227000,2,2,89,-87,0.02
202501,52227000,3S3,0,12,-12,0
202501,52227000,CA,0,35,-35,0
202501,52233000,2,0,3,-3,0
202501,52233000,CA,0,2,-2,0
202501,52240000,2,0,30,-30,0
202501,52240000,3,0,1,-1,0
202501,52240000,3S2,1,3,-2,0.33
202501,52240000,3S3,0,8,-8,0
202501,52240000,CA,31,36,-5,0.86
202501,52250000,2,0,4,-4,0
202501,52250000,3S3,0,1,-1,0
202501,52254000,2,0,19,-19,0
202501,52254000,3S3,0,2,-2,0
202501,52254002,2,0,1,-1,0
202501,52254002,3S3,0,1,-1,0
202501,52256000,2,0,5,-5,0
202501,52256000,CA,0,21,-21,0
202501,52256003,2,0,2,-2,0
202501,52256005,2,0,6,-6,0
202501,52256017,2,0,4,-4,0
202501,52256021,2,0,4,-4,0
202501,52256021,3S3,0,4,-4,0
202501,52258000,2,3,25,-22,0.12
202501,52258000,3S3,0,2,-2,0
202501,52258000,CA,0,1,-1,0
202501,52258001,2,0,2,-2,0
202501,52258003,2,0,5,-5,0
202501,52258003,CA,0,3,-3,0
202501,52260000,2,22,38,-16,0.58
202501,52260000,3,0,1,-1,0
202501,52260000,3S2,1,0,1,NA
202501,52260000,3S3,0,5,-5,0
202501,52260000,CA,0,18,-18,0
202501,52260009,2,0,4,-4,0
202501,52287000,2,2,10,-8,0.2
202501,52287000,3S3,0,1,-1,0
202501,52287000,CA,0,10,-10,0
202501,52317000,2,1,91,-90,0.01
202501,52317000,3,0,1,-1,0
202501,52317000,3S3,0,28,-28,0
202501,52317000,CA,0,31,-31,0
202501,52320000,2,1,29,-28,0.03
202501,52320000,3S3,0,1,-1,0
202501,52320000,CA,0,4,-4,0
202501,52320001,2,0,3,-3,0
202501,52320001,2S2,0,2,-2,0
202501,52320001,CA,0,1,-1,0
202501,52323000,2,0,14,-14,0
202501,52323000,3,0,1,-1,0
202501,52323000,CA,0,1,-1,0
202501,52352000,2,1,19,-18,0.05
202501,52352000,3,1,0,1,NA
202501,52352000,3S3,0,2,-2,0
202501,52352000,CA,0,18,-18,0
202501,52352002,2,0,2,-2,0
202501,52354000,2,0,1,-1,0
202501,52354000,3S2,0,1,-1,0
202501,52354000,3S3,0,1,-1,0
202501,52354000,CA,0,13,-13,0
202501,52354000,V2,1,0,1,NA
202501,52356000,2,551,2461,-1910,0.22
202501,52356000,2S1,0,1,-1,0
202501,52356000,2S2,50,207,-157,0.24
202501,52356000,2S3,19,51,-32,0.37
202501,52356000,3,10,23,-13,0.43
202501,52356000,3S1,0,1,-1,0
202501,52356000,3S2,76,122,-46,0.62
202501,52356000,3S3,822,823,-1,1
202501,52356000,CA,152,267,-115,0.57
202501,52356000,V3,0,1,-1,0
202501,52356003,2,0,9,-9,0
202501,52356003,3S2,1,1,0,1
202501,52356003,3S3,0,42,-42,0
202501,52356006,2,0,1,-1,0
202501,52378000,2,0,46,-46,0
202501,52378000,3,0,8,-8,0
202501,52378000,3S3,0,5,-5,0
202501,52378000,CA,0,34,-34,0
202501,52378009,2,0,2,-2,0
202501,52381000,2,0,5,-5,0
202501,52381000,3,0,1,-1,0
202501,52381000,CA,0,21,-21,0
202501,52381001,2,0,1,-1,0
202501,52385000,2,0,15,-15,0
202501,52385000,3S3,0,1,-1,0
202501,52385000,CA,0,13,-13,0
202501,52385007,2,0,2,-2,0
202501,52385007,3S3,0,1,-1,0
202501,52399000,2,89,280,-191,0.32
202501,52399000,3,5,3,2,1.67
202501,52399000,3S2,1,1,0,1
202501,52399000,3S3,9,37,-28,0.24
202501,52399000,CA,27,67,-40,0.4
202501,52399000,V2,2,0,2,NA
202501,52399014,2,0,2,-2,0
202501,52405000,2,1,11,-10,0.09
202501,52405000,CA,0,2,-2,0
202501,52405000,V2,0,1,-1,0
202501,52405001,2,0,2,-2,0
202501,52405005,2,0,2,-2,0
202501,52405005,3,0,1,-1,0
202501,52405005,3S3,0,5,-5,0
202501,52405006,2,0,2,-2,0
202501,52405008,2,5,0,5,NA
202501,52405008,CA,0,9,-9,0
202501,52411000,2,0,51,-51,0
202501,52411000,3S3,0,3,-3,0
202501,52411000,CA,0,28,-28,0
202501,52418000,2,1,17,-16,0.06
202501,52418000,CA,0,3,-3,0
202501,52427000,3S2,0,1,-1,0
202501,52427000,3S3,0,1,-1,0
202501,52435000,2,0,2,-2,0
202501,52435000,3,1,0,1,NA
202501,52435000,3S3,1,1,0,1
202501,52435000,CA,0,10,-10,0
202501,52435002,2,0,1,-1,0
202501,52473000,2,6,0,6,NA
202501,52473000,2S3,0,3,-3,0
202501,52473000,3S3,2,0,2,NA
202501,52473000,CA,1,0,1,NA
202501,52473010,2,0,1,-1,0
202501,52480000,2,3,18,-15,0.17
202501,52480000,3S2,0,1,-1,0
202501,52480000,3S3,0,2,-2,0
202501,52480000,CA,0,2,-2,0
202501,52506000,2,0,3,-3,0
202501,52506000,3S2,0,1,-1,0
202501,52506000,3S3,0,2,-2,0
202501,52506000,CA,0,12,-12,0
202501,52520000,2,0,1,-1,0
202501,52520001,2,0,1,-1,0
202501,52540000,2,0,17,-17,0
202501,52540000,3S2,0,2,-2,0
202501,52540000,CA,0,5,-5,0
202501,52540001,2,0,1,-1,0
202501,52540002,2,0,2,-2,0
202501,52560000,2,0,6,-6,0
202501,52560000,CA,0,26,-26,0
202501,52565000,2,0,1,-1,0
202501,52565000,CA,0,10,-10,0
202501,52573000,2,1,17,-16,0.06
202501,52573000,CA,0,19,-19,0
202501,52573004,2,0,1,-1,0
202501,52585000,2,0,93,-93,0
202501,52585000,3S3,0,11,-11,0
202501,52585000,CA,0,37,-37,0
202501,52612000,2,0,31,-31,0
202501,52612000,3,0,2,-2,0
202501,52612000,3S3,1,1,0,1
202501,52612000,CA,0,14,-14,0
202501,52678000,2,12,88,-76,0.14
202501,52678000,3S3,0,9,-9,0
202501,52678000,CA,0,27,-27,0
202501,52678017,2,3,30,-27,0.1
202501,52678017,2S2,0,12,-12,0
202501,52678017,2S3,0,16,-16,0
202501,52678017,CA,0,1,-1,0
202501,52683000,2,34,72,-38,0.47
202501,52683000,3S2,1,0,1,NA
202501,52683000,3S3,5,22,-17,0.23
202501,52683000,CA,0,27,-27,0
202501,52683000,V2,2,0,2,NA
202501,52683003,2,0,1,-1,0
202501,52683021,3S3,0,1,-1,0
202501,52685000,2,13,26,-13,0.5
202501,52685000,CA,0,10,-10,0
202501,52687000,2,1,23,-22,0.04
202501,52687000,3S3,0,13,-13,0
202501,52687000,CA,1,21,-20,0.05
202501,52693000,2,2,75,-73,0.03
202501,52693000,3,0,1,-1,0
202501,52693000,3S3,0,2,-2,0
202501,52693000,CA,0,33,-33,0
202501,52694000,2,0,4,-4,0
202501,52699000,2,2,1,1,2
202501,52720000,2,2,9,-7,0.22
202501,52720000,CA,0,2,-2,0
202501,52720001,2,1,0,1,NA
202501,52720001,3S3,0,3,-3,0
202501,52786000,2,5,56,-51,0.09
202501,52786000,3,0,7,-7,0
202501,52786000,3S2,0,2,-2,0
202501,52786000,3S3,0,5,-5,0
202501,52786000,CA,0,36,-36,0
202501,52786002,3,1,0,1,NA
202501,52786019,2,3,9,-6,0.33
202501,52786019,3S2,8,0,8,NA
202501,52786019,3S3,1,5,-4,0.2
202501,52786019,CA,0,1,-1,0
202501,52788000,2,1,7,-6,0.14
202501,52788000,3S2,2,0,2,NA
202501,52788000,3S3,1,0,1,NA
202501,52788000,CA,0,17,-17,0
202501,52835000,2,79,976,-897,0.08
202501,52835000,2S2,0,3,-3,0
202501,52835000,3,26,35,-9,0.74
202501,52835000,3S2,2,14,-12,0.14
202501,52835000,3S3,96,203,-107,0.47
202501,52835000,CA,21,121,-100,0.17
202501,52835017,3S3,1,0,1,NA
202501,52835031,2,2,70,-68,0.03
202501,52835031,3,0,1,-1,0
202501,52835031,3S2,0,1,-1,0
202501,52835031,3S3,7,3,4,2.33
202501,52835031,CA,0,3,-3,0
202501,52835062,2,0,3,-3,0
202501,52835062,3S3,0,2,-2,0
202501,52835135,3S3,0,1,-1,0
202501,52835143,2,0,1,-1,0
202501,52835160,3S3,3,0,3,NA
202501,52835163,3,0,17,-17,0
202501,52838000,2,38,303,-265,0.13
202501,52838000,2S2,1,2,-1,0.5
202501,52838000,3,0,1,-1,0
202501,52838000,3S3,0,46,-46,0
202501,52838000,CA,93,72,21,1.29
202501,52838001,2,0,1,-1,0
202501,52838001,CA,0,1,-1,0
202501,52885000,2,0,30,-30,0
202501,52885000,CA,0,12,-12,0
202501,54001000,2,4331,8007,-3676,0.54
202501,54001000,2B1,1,1,0,1
202501,54001000,2B2,0,2,-2,0
202501,54001000,2R2,119,21,98,5.67
202501,54001000,2R3,2,8,-6,0.25
202501,54001000,2S2,181,418,-237,0.43
202501,54001000,2S3,58,122,-64,0.48
202501,54001000,3,211,338,-127,0.62
202501,54001000,3R3,0,15,-15,0
202501,54001000,3S1,1,0,1,NA
202501,54001000,3S2,254,558,-304,0.46
202501,54001000,3S3,4216,4472,-256,0.94
202501,54001000,3S4,1,2,-1,0.5
202501,54001000,4,4,2,2,2
202501,54001000,CA,976,1194,-218,0.82
202501,54001000,V2,331,123,208,2.69
202501,54001000,V3,88,22,66,4
202501,54001000,V4,53,297,-244,0.18
202501,54001001,2,0,12,-12,0
202501,54001001,2S2,1,0,1,NA
202501,54001001,3S3,0,50,-50,0
202501,54001001,CA,0,25,-25,0
202501,54001017,2,0,1,-1,0
202501,54001017,3S2,0,1,-1,0
202501,54001017,3S3,92,0,92,NA
202501,54001018,V2,36,0,36,NA
202501,54001026,2,0,1,-1,0
202501,54001026,2S2,2,0,2,NA
202501,54001027,2,1,0,1,NA
202501,54001027,3S3,1,0,1,NA
202501,54001030,2S2,0,1,-1,0
202501,54001031,3S2,0,2,-2,0
202501,54001042,2,5,9,-4,0.56
202501,54001042,3S3,0,4,-4,0
202501,54001045,2S2,1,0,1,NA
202501,54001046,3S2,1,0,1,NA
202501,54001046,3S3,449,0,449,NA
202501,54001047,2,0,7,-7,0
202501,54001047,3,0,9,-9,0
202501,54001049,3S2,1,0,1,NA
202501,54003000,2,34,281,-247,0.12
202501,54003000,3,0,21,-21,0
202501,54003000,3S3,0,23,-23,0
202501,54003000,CA,1,19,-18,0.05
202501,54003012,2,0,1,-1,0
202501,54003012,CA,0,1,-1,0
202501,54003018,2,0,2,-2,0
202501,54051000,2,1,13,-12,0.08
202501,54051000,2S2,1,0,1,NA
202501,54051000,CA,0,22,-22,0
202501,54099000,2,6,21,-15,0.29
202501,54099000,2S2,1,0,1,NA
202501,54099000,3R3,15,0,15,NA
202501,54099000,3S2,1,3,-2,0.33
202501,54099000,3S3,214,9,205,23.78
202501,54099000,V2,29,2,27,14.5
202501,54099000,V3,3,0,3,NA
202501,54099002,2,14,1,13,14
202501,54099002,2S2,1,1,0,1
202501,54099002,3S2,0,1,-1,0
202501,54099002,V2,30,24,6,1.25
202501,54099002,V3,4,0,4,NA
202501,54109000,2,0,31,-31,0
202501,54109000,CA,0,4,-4,0
202501,54125000,2,0,1,-1,0
202501,54125000,3S2,1,0,1,NA
202501,54125000,3S3,2,0,2,NA
202501,54128000,2,1,2,-1,0.5
202501,54128000,3,0,1,-1,0
202501,54128000,CA,0,7,-7,0
202501,54128005,CA,0,1,-1,0
202501,54128012,2,0,2,-2,0
202501,54172000,2,18,177,-159,0.1
202501,54172000,3,0,11,-11,0
202501,54172000,3S2,2,2,0,1
202501,54172000,3S3,11,4,7,2.75
202501,54172000,CA,0,35,-35,0
202501,54172000,V2,0,18,-18,0
202501,54174000,2,18,19,-1,0.95
202501,54174000,3S3,1,6,-5,0.17
202501,54174000,CA,0,10,-10,0
202501,54174000,V2,23,0,23,NA
202501,54206000,2,0,14,-14,0
202501,54206008,2,0,2,-2,0
202501,54206010,2,0,11,-11,0
202501,54206010,3,0,1,-1,0
202501,54206010,3S3,0,7,-7,0
202501,54206013,2,0,24,-24,0
202501,54206013,3S3,0,2,-2,0
202501,54206013,CA,0,2,-2,0
202501,54223000,2,3,8,-5,0.38
202501,54223000,3S3,0,2,-2,0
202501,54223000,CA,0,21,-21,0
202501,54239000,2,0,7,-7,0
202501,54239000,V2,39,0,39,NA
202501,54245000,2,8,9,-1,0.89
202501,54245006,2,0,1,-1,0
202501,54261000,2,68,208,-140,0.33
202501,54261000,2S2,2,4,-2,0.5
202501,54261000,2S3,2,0,2,NA
202501,54261000,3,16,13,3,1.23
202501,54261000,3S2,1,1,0,1
202501,54261000,3S3,1686,58,1628,29.07
202501,54261000,CA,1,89,-88,0.01
202501,54261000,V2,14,96,-82,0.15
202501,54261000,V3,19,0,19,NA
202501,54261000,V4,40,0,40,NA
202501,54261003,2,1,4,-3,0.25
202501,54261003,3S3,2,0,2,NA
202501,54261007,2,3,4,-1,0.75
202501,54261007,2S2,1,5,-4,0.2
202501,54261007,3S2,0,1,-1,0
202501,54261007,3S3,1,1,0,1
202501,54261007,CA,0,21,-21,0
202501,54313000,2,2,1,1,2
202501,54313000,3S3,2,0,2,NA
202501,54313000,4,0,1,-1,0
202501,54344000,2,0,5,-5,0
202501,54344001,3S3,1,0,1,NA
202501,54347000,2,0,1,-1,0
202501,54347000,V2,22,0,22,NA
202501,54347002,CA,0,1,-1,0
202501,54377000,2,0,5,-5,0
202501,54377000,CA,0,29,-29,0
202501,54385000,2,8,26,-18,0.31
202501,54385000,3,1,2,-1,0.5
202501,54385000,3S3,28,8,20,3.5
202501,54385000,CA,0,14,-14,0
202501,54398000,2,0,12,-12,0
202501,54405000,2,535,434,101,1.23
202501,54405000,2S2,1,14,-13,0.07
202501,54405000,2S3,2,8,-6,0.25
202501,54405000,3,65,9,56,7.22
202501,54405000,3S2,7,6,1,1.17
202501,54405000,3S3,411,901,-490,0.46
202501,54405000,CA,14,122,-108,0.11
202501,54405000,V2,133,37,96,3.59
202501,54405000,V3,0,49,-49,0
202501,54405001,2S2,1,0,1,NA
202501,54405001,3S2,0,1,-1,0
202501,54405003,2,11,0,11,NA
202501,54405003,3S2,0,1,-1,0
202501,54405003,3S3,1,0,1,NA
202501,54405004,2,5,0,5,NA
202501,54405004,3,3,0,3,NA
202501,54405004,3S3,1,8,-7,0.12
202501,54418000,2,0,1,-1,0
202501,54480000,2,0,4,-4,0
202501,54480001,2,0,3,-3,0
202501,54480001,3S3,0,1,-1,0
202501,54498000,2,257,2343,-2086,0.11
202501,54498000,2R2,0,16,-16,0
202501,54498000,2S2,7,8,-1,0.88
202501,54498000,2S3,0,2,-2,0
202501,54498000,3,3,73,-70,0.04
202501,54498000,3S2,0,6,-6,0
202501,54498000,3S3,23,317,-294,0.07
202501,54498000,CA,17,116,-99,0.15
202501,54498000,V3,0,10,-10,0
202501,54498001,2,0,7,-7,0
202501,54498002,2,0,1,-1,0
202501,54498002,3S3,0,1,-1,0
202501,54498003,3S3,0,2,-2,0
202501,54498011,2,0,4,-4,0
202501,54498011,CA,0,1,-1,0
202501,54498021,CA,0,2,-2,0
202501,54518000,2,27,462,-435,0.06
202501,54518000,2S2,9,1,8,9
202501,54518000,2S3,1,0,1,NA
202501,54518000,3,0,19,-19,0
202501,54518000,3S2,1,2,-1,0.5
202501,54518000,3S3,241,63,178,3.83
202501,54518000,CA,0,76,-76,0
202501,54518000,V2,0,23,-23,0
202501,54520000,2,0,7,-7,0
202501,54520000,3,1,0,1,NA
202501,54520000,CA,0,1,-1,0
202501,54520000,V2,28,0,28,NA
202501,54520000,V4,10,0,10,NA
202501,54520001,2,2,0,2,NA
202501,54520001,3S3,0,2,-2,0
202501,54553000,2,1,56,-55,0.02
202501,54553000,3,0,4,-4,0
202501,54553000,3S3,0,2,-2,0
202501,54553000,CA,0,33,-33,0
202501,54599000,2,0,4,-4,0
202501,54660000,2,12,9,3,1.33
202501,54660000,2S2,1,0,1,NA
202501,54660000,3S2,0,1,-1,0
202501,54660000,CA,1,26,-25,0.04
202501,54660000,V2,10,0,10,NA
202501,54670000,2,0,5,-5,0
202501,54673000,2,2,21,-19,0.1
202501,54673000,2S2,6,1,5,6
202501,54673000,3,0,10,-10,0
202501,54673000,3S2,0,2,-2,0
202501,54673000,3S3,168,10,158,16.8
202501,54673000,CA,0,24,-24,0
202501,54673000,V2,0,300,-300,0
202501,54673000,V3,0,16,-16,0
202501,54673000,V4,21,0,21,NA
202501,54673002,2S2,1,1,0,1
202501,54673002,3,0,1,-1,0
202501,54673002,3S2,1,0,1,NA
202501,54673005,2,0,5,-5,0
202501,54673005,2S2,0,1,-1,0
202501,54673005,3S3,7,5,2,1.4
202501,54673005,V2,0,37,-37,0
202501,54680000,2,0,1,-1,0
202501,54680000,2S2,1,1,0,1
202501,54680000,CA,0,20,-20,0
202501,54680000,V2,0,12,-12,0
202501,54720000,2,4,73,-69,0.05
202501,54720000,2S2,0,3,-3,0
202501,54720000,2S3,2,0,2,NA
202501,54720000,3,0,6,-6,0
202501,54720000,3S2,2,1,1,2
202501,54720000,3S3,2426,18,2408,134.78
202501,54720000,CA,0,4,-4,0
202501,54720000,V2,33,1,32,33
202501,54720000,V3,4,0,4,NA
202501,54720000,V4,226,0,226,NA
202501,54720002,2,0,7,-7,0
202501,54720006,CA,0,1,-1,0
202501,54720024,2,0,14,-14,0
202501,54743000,2,1,13,-12,0.08
202501,54743000,3,0,1,-1,0
202501,54743000,CA,0,12,-12,0
202501,54800000,2,0,6,-6,0
202501,54800019,2,0,3,-3,0
202501,54810000,2,4,110,-106,0.04
202501,54810000,2S2,5,0,5,NA
202501,54810000,3,0,15,-15,0
202501,54810000,3S2,1,1,0,1
202501,54810000,3S3,291,65,226,4.48
202501,54810000,CA,0,24,-24,0
202501,54810017,2,3,0,3,NA
202501,54810017,2S2,1,0,1,NA
202501,54810017,3S2,15,0,15,NA
202501,54810017,3S3,113,2,111,56.5
202501,54810017,CA,0,21,-21,0
202501,54820000,2,6,50,-44,0.12
202501,54820000,2S2,1,2,-1,0.5
202501,54820000,3,0,1,-1,0
202501,54820000,3S3,189,0,189,NA
202501,54820000,CA,3,28,-25,0.11
202501,54820000,V2,0,2,-2,0
202501,54820015,2,2,8,-6,0.25
202501,54871000,CA,0,1,-1,0
202501,54874000,2,146,285,-139,0.51
202501,54874000,2S2,2,1,1,2
202501,54874000,2S3,2,0,2,NA
202501,54874000,3,4,12,-8,0.33
202501,54874000,3S1,0,1,-1,0
202501,54874000,3S2,6,39,-33,0.15
202501,54874000,3S3,57,779,-722,0.07
202501,54874000,CA,6,263,-257,0.02
202501,54874000,V2,0,10,-10,0
202501,54874001,2,0,2,-2,0
202501,54874001,3,1,1,0,1
202501,54874005,2,2,2,0,1
202501,54874005,3S3,6,2,4,3
202501,54874007,3S3,15,0,15,NA
202501,54874010,3,0,1,-1,0
202501,63001000,2,2094,4487,-2393,0.47
202501,63001000,2R2,0,36,-36,0
202501,63001000,2R3,0,2,-2,0
202501,63001000,2S2,19,200,-181,0.1
202501,63001000,2S3,13,41,-28,0.32
202501,63001000,3,104,256,-152,0.41
202501,63001000,3S1,0,2,-2,0
202501,63001000,3S2,28,72,-44,0.39
202501,63001000,3S3,582,1166,-584,0.5
202501,63001000,3S4,0,1,-1,0
202501,63001000,4,6,3,3,2
202501,63001000,CA,450,1304,-854,0.35
202501,63001000,V2R2,1,0,1,NA
202501,63001000,V3,0,1,-1,0
202501,63001001,2,19,1,18,19
202501,63001001,3S3,3,0,3,NA
202501,63001001,CA,0,1,-1,0
202501,63111000,2,30,7,23,4.29
202501,63111000,3,0,12,-12,0
202501,63111000,CA,0,1,-1,0
202501,63130000,2,103,597,-494,0.17
202501,63130000,2R2,0,1,-1,0
202501,63130000,2S2,13,20,-7,0.65
202501,63130000,2S3,3,6,-3,0.5
202501,63130000,3,1,56,-55,0.02
202501,63130000,3S2,136,115,21,1.18
202501,63130000,3S3,86,389,-303,0.22
202501,63130000,CA,14,149,-135,0.09
202501,63130000,V2,0,1,-1,0
202501,63130000,V2R2,1,1,0,1
202501,63130000,V3,0,1,-1,0
202501,63130001,2,3,11,-8,0.27
202501,63130001,2S3,0,1,-1,0
202501,63130001,CA,0,6,-6,0
202501,63130001,V3,1,0,1,NA
202501,63130004,2,1,0,1,NA
202501,63130004,CA,0,3,-3,0
202501,63190000,2,74,254,-180,0.29
202501,63190000,3,0,73,-73,0
202501,63190000,3S3,0,9,-9,0
202501,63190000,CA,6,52,-46,0.12
202501,63190000,V2R2,0,1,-1,0
202501,63190019,3S2,1,0,1,NA
202501,63212000,2,1,20,-19,0.05
202501,63212000,CA,0,4,-4,0
202501,63272000,2,5,87,-82,0.06
202501,63272000,3S3,0,9,-9,0
202501,63272000,CA,1,47,-46,0.02
202501,63272000,V2,0,3,-3,0
202501,63272000,V2R2,1,0,1,NA
202501,63302000,2,8,24,-16,0.33
202501,63302000,CA,1,40,-39,0.03
202501,63401000,2,930,870,60,1.07
202501,63401000,2R2,89,6,83,14.83
202501,63401000,2R3,0,4,-4,0
202501,63401000,2S2,51,24,27,2.12
202501,63401000,2S3,9,27,-18,0.33
202501,63401000,3,4,5,-1,0.8
202501,63401000,3S2,277,72,205,3.85
202501,63401000,3S3,131,147,-16,0.89
202501,63401000,4,0,1,-1,0
202501,63401000,CA,12,234,-222,0.05
202501,63401001,2,1,0,1,NA
202501,63401001,2S2,3,5,-2,0.6
202501,63401001,2S3,2,8,-6,0.25
202501,63401001,3S2,0,8,-8,0
202501,63401001,3S3,2,10,-8,0.2
202501,63470000,2,96,249,-153,0.39
202501,63470000,3,0,13,-13,0
202501,63470000,3S2,0,7,-7,0
202501,63470000,3S3,1,15,-14,0.07
202501,63470000,CA,1,135,-134,0.01
202501,63470003,2,4,19,-15,0.21
202501,63470003,3,0,3,-3,0
202501,63470003,CA,1,0,1,NA
202501,63548000,2,45,44,1,1.02
202501,63548000,3,1,4,-3,0.25
202501,63548000,CA,0,14,-14,0
202501,63548001,3,1,0,1,NA
202501,63594000,2,141,245,-104,0.58
202501,63594000,2R3,0,1,-1,0
202501,63594000,2S3,0,1,-1,0
202501,63594000,3,2,82,-80,0.02
202501,63594000,3S3,22,6,16,3.67
202501,63594000,CA,1,167,-166,0.01
202501,63690000,2,10,53,-43,0.19
202501,63690000,3S3,0,3,-3,0
202501,63690000,CA,2,48,-46,0.04
202501,66001000,2,12551,9610,2941,1.31
202501,66001000,2B2,3,0,3,NA
202501,66001000,2R2,181,3,178,60.33
202501,66001000,2R3,0,2,-2,0
202501,66001000,2S1,0,9,-9,0
202501,66001000,2S2,1247,1349,-102,0.92
202501,66001000,2S3,220,560,-340,0.39
202501,66001000,3,400,232,168,1.72
202501,66001000,3S1,1,1,0,1
202501,66001000,3S2,577,1028,-451,0.56
202501,66001000,3S3,1583,3537,-1954,0.45
202501,66001000,3S4,3,2,1,1.5
202501,66001000,4,3,3,0,1
202501,66001000,CA,3013,2910,103,1.04
202501,66001000,V4,0,1,-1,0
202501,66001001,3S4,0,1,-1,0
202501,66001002,2,0,3,-3,0
202501,66001005,2,75,6,69,12.5
202501,66001005,2S2,0,1,-1,0
202501,66001005,3,1,21,-20,0.05
202501,66001014,2,0,2,-2,0
202501,66001015,2,1,3,-2,0.33
202501,66001015,2S2,3,0,3,NA
202501,66001015,2S3,3,0,3,NA
202501,66001018,2,2,3,-1,0.67
202501,66001018,2S2,3,0,3,NA
202501,66001018,3S3,0,7,-7,0
202501,66001031,2,0,3,-3,0
202501,66001056,2,2,0,2,NA
202501,66001072,2,0,2,-2,0
202501,66001072,3,1,5,-4,0.2
202501,66001080,2,5,551,-546,0.01
202501,66001080,3S2,75,0,75,NA
202501,66045000,2,15,110,-95,0.14
202501,66045000,3S2,0,1,-1,0
202501,66045000,3S3,0,4,-4,0
202501,66045000,CA,2,29,-27,0.07
202501,66075000,2,10,18,-8,0.56
202501,66075000,3,1,0,1,NA
202501,66075000,3S3,385,91,294,4.23
202501,66075000,CA,1,12,-11,0.08
202501,66075006,2,0,2,-2,0
202501,66075006,CA,0,10,-10,0
202501,66088000,2,33,175,-142,0.19
202501,66088000,3S3,0,3,-3,0
202501,66088000,CA,0,84,-84,0
202501,66170000,2,8708,3712,4996,2.35
202501,66170000,2B1,0,3,-3,0
202501,66170000,2B2,2,0,2,NA
202501,66170000,2R2,5,0,5,NA
202501,66170000,2R3,0,1,-1,0
202501,66170000,2S2,262,269,-7,0.97
202501,66170000,2S3,65,126,-61,0.52
202501,66170000,3,78,207,-129,0.38
202501,66170000,3S2,512,705,-193,0.73
202501,66170000,3S3,1198,1164,34,1.03
202501,66170000,3S4,1,0,1,NA
202501,66170000,4,4,1,3,4
202501,66170000,CA,5882,723,5159,8.14
202501,66170006,CA,0,1,-1,0
202501,66170008,2,0,4,-4,0
202501,66170009,3S3,0,2,-2,0
202501,66318000,2,51,127,-76,0.4
202501,66318000,2S2,0,2,-2,0
202501,66318000,2S3,0,1,-1,0
202501,66318000,3S2,27,8,19,3.38
202501,66318000,3S3,82,28,54,2.93
202501,66318000,CA,0,27,-27,0
202501,66318002,3,0,2,-2,0
202501,66318002,3S3,11,0,11,NA
202501,66318003,CA,1,0,1,NA
202501,66383000,2,5,20,-15,0.25
202501,66383000,3,1,0,1,NA
202501,66383000,CA,0,17,-17,0
202501,66400000,2,616,461,155,1.34
202501,66400000,2S2,2,17,-15,0.12
202501,66400000,2S3,2,10,-8,0.2
202501,66400000,3,11,16,-5,0.69
202501,66400000,3S2,10,34,-24,0.29
202501,66400000,3S3,88,123,-35,0.72
202501,66400000,3S4,1,0,1,NA
202501,66400000,4,0,1,-1,0
202501,66400000,CA,12,154,-142,0.08
202501,66400001,3S3,0,1,-1,0
202501,66440000,2,32,77,-45,0.42
202501,66440000,CA,0,78,-78,0
202501,66456000,2,8,89,-81,0.09
202501,66456000,3,0,1,-1,0
202501,66456000,CA,0,122,-122,0
202501,66572000,2,4,81,-77,0.05
202501,66572000,3,0,3,-3,0
202501,66572000,3S2,0,4,-4,0
202501,66572000,3S3,0,1,-1,0
202501,66572000,CA,2,147,-145,0.01
202501,66572001,2,1,3,-2,0.33
202501,66594000,2,10,117,-107,0.09
202501,66594000,CA,0,38,-38,0
202501,66594002,2,2,8,-6,0.25
202501,66594002,2S2,1,0,1,NA
202501,66594002,3,0,2,-2,0
202501,66594002,3S3,0,28,-28,0
202501,66594002,CA,0,2,-2,0
202501,66682000,2,126,744,-618,0.17
202501,66682000,2R2,0,6,-6,0
202501,66682000,2S2,22,16,6,1.38
202501,66682000,2S3,4,1,3,4
202501,66682000,3,2,17,-15,0.12
202501,66682000,3S2,2,4,-2,0.5
202501,66682000,3S3,56,28,28,2
202501,66682000,4,0,2,-2,0
202501,66682000,CA,8,281,-273,0.03
202501,66687000,2,8,100,-92,0.08
202501,66687000,3,0,14,-14,0
202501,66687000,3S3,0,3,-3,0
202501,66687000,CA,2,28,-26,0.07
202501,66687002,2,0,1,-1,0
202501,68001000,2,12444,11937,507,1.04
202501,68001000,2B1,0,7,-7,0
202501,68001000,2B2,0,1,-1,0
202501,68001000,2R2,3,58,-55,0.05
202501,68001000,2R3,1,24,-23,0.04
202501,68001000,2S1,0,2,-2,0
202501,68001000,2S2,168,684,-516,0.25
202501,68001000,2S3,91,249,-158,0.37
202501,68001000,3,1467,370,1097,3.96
202501,68001000,3S1,0,7,-7,0
202501,68001000,3S2,602,848,-246,0.71
202501,68001000,3S3,3090,5896,-2806,0.52
202501,68001000,3S4,0,1,-1,0
202501,68001000,CA,1793,3812,-2019,0.47
202501,68001000,V2,9,367,-358,0.02
202501,68001000,V3,24,3,21,8
202501,68001005,3S3,37,8,29,4.62
202501,68001006,2,5,0,5,NA
202501,68001006,3,0,6,-6,0
202501,68001006,3S3,0,27,-27,0
202501,68001010,2,8,14,-6,0.57
202501,68001010,3S3,0,17,-17,0
202501,68013000,CA,1,1,0,1
202501,68051000,2,64,217,-153,0.29
202501,68051000,3,0,48,-48,0
202501,68051000,3S3,3,1,2,3
202501,68051000,CA,1,11,-10,0.09
202501,68077000,2,94,646,-552,0.15
202501,68077000,2B1,0,3,-3,0
202501,68077000,2S2,0,22,-22,0
202501,68077000,2S3,0,2,-2,0
202501,68077000,3,2,17,-15,0.12
202501,68077000,3S2,12,16,-4,0.75
202501,68077000,3S3,1,189,-188,0.01
202501,68077000,CA,2,67,-65,0.03
202501,68077000,V2,0,8,-8,0
202501,68079000,2,7,28,-21,0.25
202501,68079000,3S3,0,1,-1,0
202501,68079000,CA,2,14,-12,0.14
202501,68081000,2,1086,2618,-1532,0.41
202501,68081000,2B2,1,0,1,NA
202501,68081000,2R2,1,71,-70,0.01
202501,68081000,2R3,0,2,-2,0
202501,68081000,2S2,42,118,-76,0.36
202501,68081000,2S3,53,60,-7,0.88
202501,68081000,3,159,464,-305,0.34
202501,68081000,3S1,9,6,3,1.5
202501,68081000,3S2,432,537,-105,0.8
202501,68081000,3S2S3,1,1,0,1
202501,68081000,3S3,5831,3492,2339,1.67
202501,68081000,3S3S2,4,7,-3,0.57
202501,68081000,3S4,7,2,5,3.5
202501,68081000,4,0,11,-11,0
202501,68081000,CA,228,620,-392,0.37
202501,68081000,V2,46,22,24,2.09
202501,68081000,V3,111,75,36,1.48
202501,68081001,2,0,3,-3,0
202501,68081001,3S2,2,4,-2,0.5
202501,68081001,3S3,6,11,-5,0.55
202501,68081001,CA,0,2,-2,0
202501,68081002,2,0,2,-2,0
202501,68081002,3S3,0,1,-1,0
202501,68081002,3S3S2,1,0,1,NA
202501,68081003,2,9,5,4,1.8
202501,68081003,3,0,1,-1,0
202501,68081003,3S2,0,4,-4,0
202501,68081003,3S3,16,67,-51,0.24
202501,68081003,3S4,1,0,1,NA
202501,68081003,CA,2,1,1,2
202501,68081006,CA,0,1,-1,0
202501,68081010,2,3,5,-2,0.6
202501,68081010,2S2,1,0,1,NA
202501,68081010,3S2,17,5,12,3.4
202501,68081010,3S3,396,183,213,2.16
202501,68081010,3S4,0,3,-3,0
202501,68092000,2,16,25,-9,0.64
202501,68092000,2S2,2,1,1,2
202501,68092000,2S3,3,1,2,3
202501,68092000,3,30,56,-26,0.54
202501,68092000,3S2,14,18,-4,0.78
202501,68092000,3S3,636,371,265,1.71
202501,68092000,CA,0,13,-13,0
202501,68092000,V2,1,5,-4,0.2
202501,68092000,V3,3,10,-7,0.3
202501,68092003,3S3,22,47,-25,0.47
202501,68092005,CA,0,1,-1,0
202501,68101000,2,1,11,-10,0.09
202501,68101000,CA,1,4,-3,0.25
202501,68101010,2,17,18,-1,0.94
202501,68101011,2S2,3,3,0,1
202501,68101011,2S3,2,2,0,1
202501,68101013,2,0,1,-1,0
202501,68121000,2,0,4,-4,0
202501,68121000,CA,0,8,-8,0
202501,68132000,2,0,4,-4,0
202501,68132000,CA,0,6,-6,0
202501,68147000,2,18,42,-24,0.43
202501,68147000,3S3,24,0,24,NA
202501,68147000,CA,1,6,-5,0.17
202501,68152000,2,0,1,-1,0
202501,68160000,2,0,1,-1,0
202501,68162000,2,1,11,-10,0.09
202501,68162000,2S3,0,2,-2,0
202501,68162000,3S2,9,0,9,NA
202501,68162000,3S3,1,12,-11,0.08
202501,68162000,CA,16,16,0,1
202501,68167000,2,10,97,-87,0.1
202501,68167000,3,0,1,-1,0
202501,68167000,3S3,0,1,-1,0
202501,68167000,CA,0,14,-14,0
202501,68169000,CA,0,2,-2,0
202501,68176000,2,0,3,-3,0
202501,68179000,2,0,3,-3,0
202501,68179000,V2,0,1,-1,0
202501,68190000,2,37,198,-161,0.19
202501,68190000,2S2,9,1,8,9
202501,68190000,2S3,1,0,1,NA
202501,68190000,3,22,13,9,1.69
202501,68190000,3S2,270,13,257,20.77
202501,68190000,3S3,3260,335,2925,9.73
202501,68190000,CA,1,62,-61,0.02
202501,68190000,V2,1,0,1,NA
202501,68190000,V3,4,9,-5,0.44
202501,68190002,2,8,10,-2,0.8
202501,68190002,2R2,0,1,-1,0
202501,68190002,3,2,2,0,1
202501,68190002,3S2,1,1,0,1
202501,68190002,3S3,9,6,3,1.5
202501,68190002,CA,0,1,-1,0
202501,68190003,2,79,0,79,NA
202501,68190003,3,8,0,8,NA
202501,68190003,3S2,5,0,5,NA
202501,68190003,3S3,103,2,101,51.5
202501,68190012,2,0,1,-1,0
202501,68190012,3S3,0,1,-1,0
202501,68190014,3S2,0,1,-1,0
202501,68207000,2,0,8,-8,0
202501,68207000,3S3,0,2,-2,0
202501,68209000,2,23,12,11,1.92
202501,68209000,3S3,0,1,-1,0
202501,68211000,2,4,11,-7,0.36
202501,68211000,CA,0,5,-5,0
202501,68217000,2,0,2,-2,0
202501,68217000,CA,0,1,-1,0
202501,68229000,2,7,108,-101,0.06
202501,68229000,2R2,2,0,2,NA
202501,68229000,3,0,2,-2,0
202501,68229000,3S3,312,2,310,156
202501,68229000,CA,0,7,-7,0
202501,68229000,V4,1,0,1,NA
202501,68235000,2,2,38,-36,0.05
202501,68235000,3,1,4,-3,0.25
202501,68235000,3S2,0,1,-1,0
202501,68235000,3S3,0,2,-2,0
202501,68235000,4,0,1,-1,0
202501,68235000,CA,0,23,-23,0
202501,68235000,V3,0,1,-1,0
202501,68235007,2,0,1,-1,0
202501,68250000,2,0,1,-1,0
202501,68255000,2,5,123,-118,0.04
202501,68255000,3,0,26,-26,0
202501,68255000,3S2,0,1,-1,0
202501,68255000,3S3,0,11,-11,0
202501,68255000,CA,18,47,-29,0.38
202501,68264000,2,1,3,-2,0.33
202501,68266000,2,2,7,-5,0.29
202501,68271000,2,0,15,-15,0
202501,68271000,3S2,0,2,-2,0
202501,68271000,CA,0,5,-5,0
202501,68276000,2,2671,5076,-2405,0.53
202501,68276000,2R2,0,1,-1,0
202501,68276000,2R3,0,4,-4,0
202501,68276000,2S2,1,35,-34,0.03
202501,68276000,2S3,4,11,-7,0.36
202501,68276000,3,167,66,101,2.53
202501,68276000,3S2,262,31,231,8.45
202501,68276000,3S3,83,138,-55,0.6
202501,68276000,CA,1097,1048,49,1.05
202501,68276000,V2,322,1,321,322
202501,68276013,CA,0,13,-13,0
202501,68276014,2,0,1,-1,0
202501,68296000,2,0,5,-5,0
202501,68298000,2,2,8,-6,0.25
202501,68298000,CA,1,1,0,1
202501,68298000,V2,0,1,-1,0
202501,68307000,2,10764,4370,6394,2.46
202501,68307000,2B1,0,5,-5,0
202501,68307000,2R2,0,2,-2,0
202501,68307000,2R3,0,1,-1,0
202501,68307000,2S1,0,3,-3,0
202501,68307000,2S2,58,128,-70,0.45
202501,68307000,2S3,40,21,19,1.9
202501,68307000,3,847,312,535,2.71
202501,68307000,3S1,0,1,-1,0
202501,68307000,3S2,823,699,124,1.18
202501,68307000,3S3,973,3848,-2875,0.25
202501,68307000,4,20,0,20,NA
202501,68307000,CA,3682,478,3204,7.7
202501,68307000,V2,43,16,27,2.69
202501,68307000,V3,2,43,-41,0.05
202501,68307007,2,1,12,-11,0.08
202501,68307012,2,0,4,-4,0
202501,68307018,3S2,10,0,10,NA
202501,68307018,3S3,2,0,2,NA
202501,68318000,2,0,6,-6,0
202501,68318000,3,0,5,-5,0
202501,68318000,CA,0,4,-4,0
202501,68318001,CA,0,1,-1,0
202501,68320000,2,1,12,-11,0.08
202501,68320000,3S3,0,3,-3,0
202501,68320000,V2,0,1,-1,0
202501,68322000,2,1,8,-7,0.12
202501,68324000,2,2,8,-6,0.25
202501,68324000,3,1,0,1,NA
202501,68324000,3S3,2,0,2,NA
202501,68324000,V2,0,1,-1,0
202501,68327000,2,2,7,-5,0.29
202501,68327000,3S2,5,4,1,1.25
202501,68327000,3S3,0,2,-2,0
202501,68327000,V2,0,2,-2,0
202501,68344000,2,0,6,-6,0
202501,68368000,2,5,11,-6,0.45
202501,68368000,3,1,0,1,NA
202501,68368000,3S2,0,4,-4,0
202501,68370000,2,0,2,-2,0
202501,68377000,2,2,22,-20,0.09
202501,68377000,3S2,0,3,-3,0
202501,68377000,3S3,0,4,-4,0
202501,68377000,CA,0,1,-1,0
202501,68385000,2,11,46,-35,0.24
202501,68385000,3,30,16,14,1.88
202501,68385000,3S2,2,2,0,1
202501,68385000,3S3,283,7,276,40.43
202501,68385000,CA,53,78,-25,0.68
202501,68385000,V2,101,0,101,NA
202501,68385000,V3,165,0,165,NA
202501,68385000,V4,17,0,17,NA
202501,68385012,2,0,3,-3,0
202501,68397000,2,0,5,-5,0
202501,68397000,2S2,0,1,-1,0
202501,68397000,CA,0,1,-1,0
202501,68397001,2,0,2,-2,0
202501,68406000,2,1693,1816,-123,0.93
202501,68406000,2B1,0,2,-2,0
202501,68406000,2R2,0,2,-2,0
202501,68406000,2S2,1,51,-50,0.02
202501,68406000,2S3,4,6,-2,0.67
202501,68406000,3,136,137,-1,0.99
202501,68406000,3S2,115,49,66,2.35
202501,68406000,3S3,33,280,-247,0.12
202501,68406000,CA,621,284,337,2.19
202501,68406000,V2,20,7,13,2.86
202501,68406000,V3,0,17,-17,0
202501,68406009,3,0,1,-1,0
202501,68406009,3S2,0,1,-1,0
202501,68418000,2,680,1278,-598,0.53
202501,68418000,2S1,1,0,1,NA
202501,68418000,3,2,410,-408,0
202501,68418000,3S2,0,168,-168,0
202501,68418000,3S3,1,19,-18,0.05
202501,68418000,CA,0,37,-37,0
202501,68418000,V2,0,26,-26,0
202501,68418000,V3,0,2,-2,0
202501,68432000,2,32,189,-157,0.17
202501,68432000,2S2,0,1,-1,0
202501,68432000,3,1,7,-6,0.14
202501,68432000,3S2,44,0,44,NA
202501,68432000,3S3,41,18,23,2.28
202501,68432000,CA,9,25,-16,0.36
202501,68444000,2,1,9,-8,0.11
202501,68444000,CA,0,6,-6,0
202501,68464000,2,6,101,-95,0.06
202501,68464000,3,4,1,3,4
202501,68464000,3S3,0,1,-1,0
202501,68464000,CA,0,2,-2,0
202501,68464000,V2,0,2,-2,0
202501,68498000,2,2,8,-6,0.25
202501,68498000,V2,0,1,-1,0
202501,68500000,2,21,136,-115,0.15
202501,68500000,3,1,7,-6,0.14
202501,68500000,3S3,1,9,-8,0.11
202501,68500000,CA,0,13,-13,0
202501,68500000,V2,0,20,-20,0
202501,68502000,2,0,5,-5,0
202501,68502000,CA,0,4,-4,0
202501,68522000,CA,0,2,-2,0
202501,68524000,2,0,12,-12,0
202501,68524000,CA,35,49,-14,0.71
202501,68533000,2,0,86,-86,0
202501,68533000,CA,0,1,-1,0
202501,68547000,2,1874,1978,-104,0.95
202501,68547000,2S2,9,40,-31,0.22
202501,68547000,2S3,0,2,-2,0
202501,68547000,3,135,202,-67,0.67
202501,68547000,3S2,36,18,18,2
202501,68547000,3S3,1233,476,757,2.59
202501,68547000,CA,220,622,-402,0.35
202501,68547000,V2,0,4,-4,0
202501,68547000,V3,1,0,1,NA
202501,68547008,2,1,0,1,NA
202501,68547008,3S3,2,0,2,NA
202501,68547011,2,0,1,-1,0
202501,68547011,3S3,297,0,297,NA
202501,68547013,2,0,1,-1,0
202501,68549000,2,1,83,-82,0.01
202501,68549000,3,0,5,-5,0
202501,68549000,3S3,14,85,-71,0.16
202501,68549000,CA,0,7,-7,0
202501,68549000,V2,0,1,-1,0
202501,68572000,2,7,90,-83,0.08
202501,68572000,3,0,1,-1,0
202501,68572000,3S2,4,3,1,1.33
202501,68572000,3S3,129,130,-1,0.99
202501,68572000,CA,1,10,-9,0.1
202501,68573000,2,10,28,-18,0.36
202501,68573000,2S2,0,1,-1,0
202501,68573000,3,2,27,-25,0.07
202501,68573000,3S2,7,1,6,7
202501,68573000,3S3,131,7,124,18.71
202501,68573000,3S3S2,2,2,0,1
202501,68573000,CA,1,10,-9,0.1
202501,68573000,V2,8,8,0,1
202501,68573000,V3,4,4,0,1
202501,68573002,2,1,0,1,NA
202501,68573002,3S2,0,1,-1,0
202501,68573002,CA,0,4,-4,0
202501,68575000,2,17,126,-109,0.13
202501,68575000,2R2,0,1,-1,0
202501,68575000,2S2,0,23,-23,0
202501,68575000,2S3,0,11,-11,0
202501,68575000,3,5,4,1,1.25
202501,68575000,3S1,3,6,-3,0.5
202501,68575000,3S2,41,9,32,4.56
202501,68575000,3S3,386,125,261,3.09
202501,68575000,3S4,1,6,-5,0.17
202501,68575000,CA,4,34,-30,0.12
202501,68575000,V2,21,7,14,3
202501,68575000,V3,18,22,-4,0.82
202501,68575000,V3R3,2,0,2,NA
202501,68575001,2,0,2,-2,0
202501,68575007,2,0,1,-1,0
202501,68575010,3S3,5,0,5,NA
202501,68575015,2,0,3,-3,0
202501,68575015,3,1,0,1,NA
202501,68575015,CA,0,3,-3,0
202501,68575024,2,0,2,-2,0
202501,68575024,CA,0,4,-4,0
202501,68615000,2,141,948,-807,0.15
202501,68615000,3,178,107,71,1.66
202501,68615000,3R2,0,1,-1,0
202501,68615000,3S2,113,30,83,3.77
202501,68615000,3S3,72,22,50,3.27
202501,68615000,CA,0,37,-37,0
202501,68615000,V3,2,1,1,2
202501,68615013,2,1,0,1,NA
202501,68615013,3S3,14,0,14,NA
202501,68615013,CA,0,4,-4,0
202501,68615031,2,1,0,1,NA
202501,68615031,3,19,1,18,19
202501,68615031,3S3,0,3,-3,0
202501,68655000,2,1000,258,742,3.88
202501,68655000,2S3,0,3,-3,0
202501,68655000,3,80,439,-359,0.18
202501,68655000,3R2,1,0,1,NA
202501,68655000,3S1,2,1,1,2
202501,68655000,3S2,10,5,5,2
202501,68655000,3S3,208,149,59,1.4
202501,68655000,4,0,14,-14,0
202501,68655000,CA,3,113,-110,0.03
202501,68655000,V2,8,0,8,NA
202501,68655000,V3,52,15,37,3.47
202501,68655001,3S3,4,1,3,4
202501,68655008,3S3,1,0,1,NA
202501,68669000,2,0,28,-28,0
202501,68669000,3S3,0,2,-2,0
202501,68669000,CA,0,2,-2,0
202501,68673001,V2,0,2,-2,0
202501,68679000,2,145,962,-817,0.15
202501,68679000,2B1,0,2,-2,0
202501,68679000,2R3,0,1,-1,0
202501,68679000,2S2,1,1,0,1
202501,68679000,2S3,10,5,5,2
202501,68679000,3,4,43,-39,0.09
202501,68679000,3S2,3,15,-12,0.2
202501,68679000,3S2S3,0,1,-1,0
202501,68679000,3S3,235,460,-225,0.51
202501,68679000,CA,43,172,-129,0.25
202501,68679001,3S3,0,2,-2,0
202501,68679008,2,0,1,-1,0
202501,68679017,3S3,2,0,2,NA
202501,68684000,CA,1,0,1,NA
202501,68684005,2,0,1,-1,0
202501,68686000,2,0,7,-7,0
202501,68686000,CA,0,4,-4,0
202501,68689000,2,8,85,-77,0.09
202501,68689000,3,1,9,-8,0.11
202501,68689000,3S2,10,16,-6,0.62
202501,68689000,3S3,52,12,40,4.33
202501,68689000,CA,3,65,-62,0.05
202501,68689000,V3,0,5,-5,0
202501,68689012,2,5,6,-1,0.83
202501,68689012,3S2,1,0,1,NA
202501,68689012,3S3,3,4,-1,0.75
202501,68689012,CA,35,59,-24,0.59
202501,68689024,2,27,5,22,5.4
202501,68689024,3,9,0,9,NA
202501,68689024,3S2,3,0,3,NA
202501,68689024,3S3,149,10,139,14.9
202501,68689024,3S4,0,1,-1,0
202501,68705000,2,0,8,-8,0
202501,68705000,CA,0,1,-1,0
202501,68720000,2,0,29,-29,0
202501,68720000,CA,0,3,-3,0
202501,68745000,2,159,21,138,7.57
202501,68745000,3,0,81,-81,0
202501,68745000,3S2,3,0,3,NA
202501,68745000,3S3,113,11,102,10.27
202501,68745009,2,0,1,-1,0
202501,68755000,2,90,448,-358,0.2
202501,68755000,2S3,1,0,1,NA
202501,68755000,3,3,9,-6,0.33
202501,68755000,3S2,1,0,1,NA
202501,68755000,3S3,29,53,-24,0.55
202501,68755000,CA,30,144,-114,0.21
202501,68755000,V2,50,0,50,NA
202501,68770000,2,7,32,-25,0.22
202501,68770000,2S3,0,1,-1,0
202501,68770000,3,0,18,-18,0
202501,68770000,3S3,0,1,-1,0
202501,68770000,CA,0,6,-6,0
202501,68770000,V2,0,3,-3,0
202501,68770001,2,0,1,-1,0
202501,68770001,3,0,3,-3,0
202501,68770008,2,1,0,1,NA
202501,68773000,2,0,3,-3,0
202501,68773000,V2,0,2,-2,0
202501,68773003,2,1,0,1,NA
202501,68780000,2,1,1,0,1
202501,68780000,3,0,1,-1,0
202501,68780000,CA,0,2,-2,0
202501,68820000,2,2,57,-55,0.04
202501,68820000,3,0,2,-2,0
202501,68820000,3S3,1,2,-1,0.5
202501,68820000,CA,0,10,-10,0
202501,68820001,2,0,20,-20,0
202501,68820001,CA,0,9,-9,0
202501,68855000,2,3,55,-52,0.05
202501,68855000,3,2,0,2,NA
202501,68855000,3S3,4,1,3,4
202501,68855000,V2,0,5,-5,0
202501,68861000,2,3,181,-178,0.02
202501,68861000,3,1,4,-3,0.25
202501,68861000,3S2,0,1,-1,0
202501,68861000,3S3,4,25,-21,0.16
202501,68861000,CA,13,30,-17,0.43
202501,68861000,V2,0,5,-5,0
202501,68867000,2,0,2,-2,0
202501,68867000,CA,0,2,-2,0
202501,68872000,2,6,107,-101,0.06
202501,68872000,3S3,0,1,-1,0
202501,68872000,CA,1,7,-6,0.14
202501,68872000,V2,0,7,-7,0
202501,68895000,2,53,209,-156,0.25
202501,68895000,2R3,0,1,-1,0
202501,68895000,2S1,2,0,2,NA
202501,68895000,2S2,2,2,0,1
202501,68895000,2S3,1,1,0,1
202501,68895000,3,7,31,-24,0.23
202501,68895000,CA,27,45,-18,0.6
202501,68895000,V2,0,4,-4,0
202501,70001000,2,1354,3061,-1707,0.44
202501,70001000,2B2,0,24,-24,0
202501,70001000,2R2,2,12,-10,0.17
202501,70001000,2S2,7,74,-67,0.09
202501,70001000,2S3,2,25,-23,0.08
202501,70001000,3,17,250,-233,0.07
202501,70001000,3R3,0,1,-1,0
202501,70001000,3S2,126,365,-239,0.35
202501,70001000,3S3,115,592,-477,0.19
202501,70001000,4,0,1,-1,0
202501,70001000,CA,291,457,-166,0.64
202501,70001000,V3,5,0,5,NA
202501,70001001,2,0,6,-6,0
202501,70001002,2,0,8,-8,0
202501,70001003,2,2,0,2,NA
202501,70001005,2,0,2,-2,0
202501,70110000,2,5,24,-19,0.21
202501,70110000,2B2,0,1,-1,0
202501,70110000,3,0,3,-3,0
202501,70110000,3S3,0,7,-7,0
202501,70110000,CA,0,2,-2,0
202501,70124000,2,2,18,-16,0.11
202501,70124000,2R2,3,2,1,1.5
202501,70124000,2S2,1,0,1,NA
202501,70124000,2S3,1,0,1,NA
202501,70124000,3S1,9,1,8,9
202501,70124000,3S2,8,3,5,2.67
202501,70124000,3S3,13,8,5,1.62
202501,70124000,CA,0,1,-1,0
202501,70124000,V3,0,2,-2,0
202501,70124010,2,1,0,1,NA
202501,70204000,2,0,13,-13,0
202501,70204000,2S2,1,0,1,NA
202501,70204000,3,0,2,-2,0
202501,70215000,2,333,333,0,1
202501,70215000,2B2,0,2,-2,0
202501,70215000,2S2,4,2,2,2
202501,70215000,3,13,20,-7,0.65
202501,70215000,3S1,3,3,0,1
202501,70215000,3S2,10,14,-4,0.71
202501,70215000,3S3,336,501,-165,0.67
202501,70215000,4,0,2,-2,0
202501,70215000,CA,55,83,-28,0.66
202501,70221000,2,32,216,-184,0.15
202501,70221000,2B2,0,21,-21,0
202501,70221000,2S2,0,2,-2,0
202501,70221000,3,2,18,-16,0.11
202501,70221000,3S2,6,1,5,6
202501,70221000,3S3,4,10,-6,0.4
202501,70221000,CA,11,26,-15,0.42
202501,70230000,2,2,10,-8,0.2
202501,70230000,3S2,1,0,1,NA
202501,70230000,3S3,1,0,1,NA
202501,70230000,CA,0,6,-6,0
202501,70233000,2,1,17,-16,0.06
202501,70233000,2S3,1,0,1,NA
202501,70233000,3,0,7,-7,0
202501,70233000,3S2,1,3,-2,0.33
202501,70233000,3S3,12,39,-27,0.31
202501,70233000,CA,1,5,-4,0.2
202501,70233000,V3,1,0,1,NA
202501,70233013,2,1,0,1,NA
202501,70233013,CA,0,3,-3,0
202501,70235000,2,16,116,-100,0.14
202501,70235000,CA,0,4,-4,0
202501,70235008,3S3,0,57,-57,0
202501,70265000,2,3,71,-68,0.04
202501,70265000,2B2,0,1,-1,0
202501,70265000,2S3,0,4,-4,0
202501,70265000,3,0,23,-23,0
202501,70265000,3S2,1,1,0,1
202501,70265000,3S3,2,4,-2,0.5
202501,70265000,CA,0,13,-13,0
202501,70400000,2,2,47,-45,0.04
202501,70400000,2S1,2,0,2,NA
202501,70400000,2S2,3,0,3,NA
202501,70400000,2S3,1,4,-3,0.25
202501,70400000,3,4,7,-3,0.57
202501,70400000,3S1,1,6,-5,0.17
202501,70400000,3S2,6,11,-5,0.55
202501,70400000,3S3,6,18,-12,0.33
202501,70400000,CA,0,2,-2,0
202501,70418000,2,1,20,-19,0.05
202501,70418000,3,1,3,-2,0.33
202501,70418000,3S3,0,2,-2,0
202501,70418000,4,0,1,-1,0
202501,70418000,CA,1,4,-3,0.25
202501,70418002,3S3,0,1,-1,0
202501,70429000,2,11,58,-47,0.19
202501,70429000,2B2,0,1,-1,0
202501,70429000,2S3,1,8,-7,0.12
202501,70429000,3,7,22,-15,0.32
202501,70429000,3S2,1,1,0,1
202501,70429000,3S3,3,8,-5,0.38
202501,70429000,4,0,4,-4,0
202501,70429000,CA,1,7,-6,0.14
202501,70429015,2,0,1,-1,0
202501,70473000,2,2,9,-7,0.22
202501,70473000,3S2,0,8,-8,0
202501,70473000,3S3,0,1,-1,0
202501,70473000,CA,0,2,-2,0
202501,70473005,3S2,0,5,-5,0
202501,70508000,2,9,53,-44,0.17
202501,70508000,2B2,0,1,-1,0
202501,70508000,2R3,0,1,-1,0
202501,70508000,3,0,2,-2,0
202501,70508000,3S2,3,0,3,NA
202501,70508000,3S3,1,3,-2,0.33
202501,70508000,CA,1,7,-6,0.14
202501,70523000,2,30,26,4,1.15
202501,70523000,2S2,0,1,-1,0
202501,70523000,3,0,10,-10,0
202501,70523000,3R3,1,0,1,NA
202501,70523000,3S2,0,4,-4,0
202501,70523000,3S3,0,4,-4,0
202501,70670000,2,60,134,-74,0.45
202501,70670000,2R3,0,1,-1,0
202501,70670000,2S2,1,0,1,NA
202501,70670000,2S3,1,0,1,NA
202501,70670000,3,0,2,-2,0
202501,70670000,3S3,3,5,-2,0.6
202501,70670000,3S4,1,2,-1,0.5
202501,70670000,CA,19,25,-6,0.76
202501,70678000,2,7,31,-24,0.23
202501,70678000,3S2,0,2,-2,0
202501,70678000,3S3,0,1,-1,0
202501,70678000,CA,0,1,-1,0
202501,70702000,2,0,25,-25,0
202501,70702000,3,0,1,-1,0
202501,70702000,CA,0,2,-2,0
202501,70702004,2,0,4,-4,0
202501,70708000,2,78,227,-149,0.34
202501,70708000,2R2,9,4,5,2.25
202501,70708000,2S2,2,2,0,1
202501,70708000,2S3,2,16,-14,0.12
202501,70708000,3,8,12,-4,0.67
202501,70708000,3S1,0,1,-1,0
202501,70708000,3S2,10,12,-2,0.83
202501,70708000,3S3,26,112,-86,0.23
202501,70708000,3S4,0,2,-2,0
202501,70708000,4,1,0,1,NA
202501,70708000,CA,12,51,-39,0.24
202501,70708000,V3,0,4,-4,0
202501,70708003,2,49,10,39,4.9
202501,70708006,2R2,2,2,0,1
202501,70708006,3S3,0,10,-10,0
202501,70708017,2,0,2,-2,0
202501,70713000,2,112,168,-56,0.67
202501,70713000,2B2,0,1,-1,0
202501,70713000,2R2,0,2,-2,0
202501,70713000,2S2,4,0,4,NA
202501,70713000,2S3,3,0,3,NA
202501,70713000,3,1,32,-31,0.03
202501,70713000,3S2,3,0,3,NA
202501,70713000,3S3,1,4,-3,0.25
202501,70713000,CA,3,36,-33,0.08
202501,70713003,2,0,1,-1,0
202501,70713003,3S3,0,1,-1,0
202501,70713007,3S2,0,11,-11,0
202501,70713008,2R2,0,1,-1,0
202501,70713020,2,1,0,1,NA
202501,70717000,2,6,48,-42,0.12
202501,70717000,2B2,0,1,-1,0
202501,70717000,2S2,1,1,0,1
202501,70717000,2S3,0,4,-4,0
202501,70717000,3,17,4,13,4.25
202501,70717000,3S1,4,7,-3,0.57
202501,70717000,3S2,15,13,2,1.15
202501,70717000,3S3,59,34,25,1.74
202501,70717000,3S4,1,0,1,NA
202501,70717000,CA,1,5,-4,0.2
202501,70717000,V3,3,0,3,NA
202501,70717002,2,0,2,-2,0
202501,70742000,2,10,90,-80,0.11
202501,70742000,3S2,2,0,2,NA
202501,70742000,3S3,0,1,-1,0
202501,70742000,CA,2,26,-24,0.08
202501,70742010,2,0,1,-1,0
202501,70742014,CA,1,0,1,NA
202501,70771000,2,0,7,-7,0
202501,70771000,2S3,0,11,-11,0
202501,70771000,3,0,6,-6,0
202501,70771000,3S1,0,1,-1,0
202501,70771000,3S3,0,12,-12,0
202501,70771007,2,0,1,-1,0
202501,70771013,2,0,3,-3,0
202501,70771013,3S3,0,1,-1,0
202501,70771013,CA,0,3,-3,0
202501,70771018,2,0,2,-2,0
202501,70771026,2,0,2,-2,0
202501,70771026,2S3,0,1,-1,0
202501,70771026,3S3,0,8,-8,0
202501,70820000,2,7,161,-154,0.04
202501,70820000,2S2,0,1,-1,0
202501,70820000,3,1,22,-21,0.05
202501,70820000,3S2,0,17,-17,0
202501,70820000,3S3,3038,1651,1387,1.84
202501,70820000,CA,2,31,-29,0.06
202501,70820001,2,0,5,-5,0
202501,70820001,2S2,1,0,1,NA
202501,70820001,4,0,1,-1,0
202501,70820001,CA,0,1,-1,0
202501,70820008,2,0,1,-1,0
202501,70820008,2S3,0,5,-5,0
202501,70820008,3S2,0,63,-63,0
202501,70820008,3S3,0,523,-523,0
202501,70823000,2,739,68,671,10.87
202501,70823000,2B2,0,14,-14,0
202501,70823000,2S2,6,3,3,2
202501,70823000,2S3,1,3,-2,0.33
202501,70823000,3,348,23,325,15.13
202501,70823000,3S2,276,117,159,2.36
202501,70823000,3S3,511,203,308,2.52
202501,70823000,3S4,0,2,-2,0
202501,70823000,CA,1,19,-18,0.05
202501,70823000,V3,18,0,18,NA
202501,70823004,2,0,1,-1,0
202501,70823004,CA,0,1,-1,0
202501,70823005,2,0,1,-1,0
202501,70823006,2,0,1,-1,0
202501,73001000,2,4166,6076,-1910,0.69
202501,73001000,2B1,0,1,-1,0
202501,73001000,2R2,17,92,-75,0.18
202501,73001000,2R3,0,40,-40,0
202501,73001000,2S1,0,3,-3,0
202501,73001000,2S2,241,552,-311,0.44
202501,73001000,2S3,28,120,-92,0.23
202501,73001000,3,255,251,4,1.02
202501,73001000,3S2,527,620,-93,0.85
202501,73001000,3S2S3,1,0,1,NA
202501,73001000,3S3,3281,2352,929,1.39
202501,73001000,4,3,11,-8,0.27
202501,73001000,CA,1478,1672,-194,0.88
202501,73001000,V2,1,0,1,NA
202501,73001000,V3,569,7,562,81.29
202501,73001001,3S3,1,0,1,NA
202501,73001009,CA,0,2,-2,0
202501,73001015,2,1,0,1,NA
202501,73001031,2,0,3,-3,0
202501,73001032,2,0,1,-1,0
202501,73001032,3S3,1,10,-9,0.1
202501,73001032,CA,0,2,-2,0
202501,73001033,2,0,1,-1,0
202501,73001039,CA,1,0,1,NA
202501,73001056,CA,0,1,-1,0
202501,73024000,2,0,3,-3,0
202501,73024000,CA,13,16,-3,0.81
202501,73024004,2,0,6,-6,0
202501,73024004,3S2,0,6,-6,0
202501,73024004,3S3,0,3,-3,0
202501,73024004,CA,0,6,-6,0
202501,73026000,2,110,97,13,1.13
202501,73026000,2S2,0,1,-1,0
202501,73026000,2S3,0,5,-5,0
202501,73026000,3,0,1,-1,0
202501,73026000,3S2,2,13,-11,0.15
202501,73026000,3S3,14,3,11,4.67
202501,73026000,3S4,1,0,1,NA
202501,73026000,CA,12,13,-1,0.92
202501,73030000,2,24,29,-5,0.83
202501,73030000,2R2,1,0,1,NA
202501,73030000,3,1,7,-6,0.14
202501,73030000,3S2,0,2,-2,0
202501,73030000,3S3,14,9,5,1.56
202501,73030000,CA,3,8,-5,0.38
202501,73043000,2,2,23,-21,0.09
202501,73043000,3S2,0,1,-1,0
202501,73043000,CA,0,7,-7,0
202501,73055000,2,30,67,-37,0.45
202501,73055000,2S2,0,2,-2,0
202501,73055000,2S3,0,1,-1,0
202501,73055000,3,0,1,-1,0
202501,73055000,3S2,41,0,41,NA
202501,73055000,3S3,3,8,-5,0.38
202501,73055000,CA,1,8,-7,0.12
202501,73055004,2,2,4,-2,0.5
202501,73055004,3S2,0,1,-1,0
202501,73055004,CA,0,1,-1,0
202501,73067000,2,0,11,-11,0
202501,73067000,3,0,14,-14,0
202501,73067000,3S2,0,3,-3,0
202501,73067000,3S3,1,5,-4,0.2
202501,73067000,CA,26,27,-1,0.96
202501,73067007,2,0,8,-8,0
202501,73067007,3,0,2,-2,0
202501,73124000,2,70,104,-34,0.67
202501,73124000,2S3,1,0,1,NA
202501,73124000,3,0,1,-1,0
202501,73124000,3S2,0,1,-1,0
202501,73124000,3S3,1,1,0,1
202501,73124000,CA,5,37,-32,0.14
202501,73124000,V3,0,1,-1,0
202501,73124001,2,1,0,1,NA
202501,73148000,2,11,107,-96,0.1
202501,73148000,2R2,0,2,-2,0
202501,73148000,3,2,1,1,2
202501,73148000,3S2,2,2,0,1
202501,73148000,3S3,1,15,-14,0.07
202501,73148000,CA,3,56,-53,0.05
202501,73152000,2,1,11,-10,0.09
202501,73152000,3,0,1,-1,0
202501,73168000,2,94,326,-232,0.29
202501,73168000,2R2,0,6,-6,0
202501,73168000,3,201,39,162,5.15
202501,73168000,3S2,15,9,6,1.67
202501,73168000,3S3,165,67,98,2.46
202501,73168000,CA,33,140,-107,0.24
202501,73200000,2,349,21,328,16.62
202501,73200000,2S2,7,0,7,NA
202501,73200000,3,113,137,-24,0.82
202501,73200000,3S2,0,11,-11,0
202501,73200000,3S3,67,58,9,1.16
202501,73200000,CA,2,16,-14,0.12
202501,73200000,V3,0,518,-518,0
202501,73200001,2,131,5,126,26.2
202501,73200001,2S2,53,0,53,NA
202501,73200001,3,97,0,97,NA
202501,73200001,3S2,3,6,-3,0.5
202501,73200001,3S3,31,59,-28,0.53
202501,73200001,CA,0,2,-2,0
202501,73217000,2,1,44,-43,0.02
202501,73217000,3,0,3,-3,0
202501,73217000,3S2,1,3,-2,0.33
202501,73217000,3S3,2,4,-2,0.5
202501,73217000,3S4,2,0,2,NA
202501,73217000,CA,0,3,-3,0
202501,73217001,2,1,2,-1,0.5
202501,73217001,3S3,0,1,-1,0
202501,73217001,CA,0,1,-1,0
202501,73226000,2,1,30,-29,0.03
202501,73226000,3S2,0,4,-4,0
202501,73226000,CA,0,9,-9,0
202501,73226003,CA,0,1,-1,0
202501,73236000,2,2,35,-33,0.06
202501,73236000,3S2,0,1,-1,0
202501,73236000,CA,0,10,-10,0
202501,73268000,2,624,847,-223,0.74
202501,73268000,2R2,2,6,-4,0.33
202501,73268000,2S2,8,28,-20,0.29
202501,73268000,2S3,10,6,4,1.67
202501,73268000,3,53,10,43,5.3
202501,73268000,3S2,26,22,4,1.18
202501,73268000,3S3,930,312,618,2.98
202501,73268000,4,2,2,0,1
202501,73268000,CA,111,293,-182,0.38
202501,73268000,V3,0,1,-1,0
202501,73268001,2,10,6,4,1.67
202501,73268001,3,0,1,-1,0
202501,73268001,3S3,16,6,10,2.67
202501,73268001,CA,3,3,0,1
202501,73270000,2,0,6,-6,0
202501,73270000,3S2,0,1,-1,0
202501,73270000,CA,1,2,-1,0.5
202501,73270004,2,0,2,-2,0
202501,73270004,2S3,0,1,-1,0
202501,73270004,3S3,0,2,-2,0
202501,73275000,2,332,277,55,1.2
202501,73275000,2R2,0,1,-1,0
202501,73275000,2S2,0,3,-3,0
202501,73275000,2S3,0,6,-6,0
202501,73275000,3,22,6,16,3.67
202501,73275000,3S2,11,21,-10,0.52
202501,73275000,3S3,38,91,-53,0.42
202501,73275000,3S4,1,0,1,NA
202501,73275000,CA,21,112,-91,0.19
202501,73283000,2,31,308,-277,0.1
202501,73283000,2S2,0,1,-1,0
202501,73283000,3,0,4,-4,0
202501,73283000,3S2,0,2,-2,0
202501,73283000,3S3,3,86,-83,0.03
202501,73283000,CA,4,37,-33,0.11
202501,73283001,2,1,1,0,1
202501,73283003,CA,0,1,-1,0
202501,73319000,2,14,150,-136,0.09
202501,73319000,2R2,0,3,-3,0
202501,73319000,2S2,1,0,1,NA
202501,73319000,3,0,34,-34,0
202501,73319000,3S2,1,3,-2,0.33
202501,73319000,3S3,1,7,-6,0.14
202501,73319000,CA,3,27,-24,0.11
202501,73319008,3S3,0,1,-1,0
202501,73347000,2,1,16,-15,0.06
202501,73347000,3,0,2,-2,0
202501,73347000,3S3,0,1,-1,0
202501,73347000,CA,0,6,-6,0
202501,73347001,3S3,2,19,-17,0.11
202501,73347003,2,49,7,42,7
202501,73347003,3,3,0,3,NA
202501,73347003,3S3,42,43,-1,0.98
202501,73347005,2,5,6,-1,0.83
202501,73347005,3,2,0,2,NA
202501,73347005,3S3,0,1,-1,0
202501,73349000,2,16,275,-259,0.06
202501,73349000,2S2,18,20,-2,0.9
202501,73349000,2S3,17,17,0,1
202501,73349000,3,0,23,-23,0
202501,73349000,3S2,2,4,-2,0.5
202501,73349000,3S3,169,246,-77,0.69
202501,73349000,CA,5,72,-67,0.07
202501,73352000,2,5,28,-23,0.18
202501,73352000,3,1,1,0,1
202501,73352000,3S2,0,4,-4,0
202501,73352000,CA,0,16,-16,0
202501,73352001,2,0,1,-1,0
202501,73352002,2,1,0,1,NA
202501,73408000,2,10,143,-133,0.07
202501,73408000,2R2,2,2,0,1
202501,73408000,3,0,5,-5,0
202501,73408000,3S2,4,4,0,1
202501,73408000,3S3,35,61,-26,0.57
202501,73408000,CA,2,32,-30,0.06
202501,73408002,3S3,0,1,-1,0
202501,73411000,2,42,204,-162,0.21
202501,73411000,2S2,0,1,-1,0
202501,73411000,3,0,29,-29,0
202501,73411000,3S2,1,13,-12,0.08
202501,73411000,3S3,7,22,-15,0.32
202501,73411000,CA,6,54,-48,0.11
202501,73411000,V3,2,1,1,2
202501,73411009,2,0,6,-6,0
202501,73411009,3,0,3,-3,0
202501,73443000,2,362,381,-19,0.95
202501,73443000,2R2,0,1,-1,0
202501,73443000,2S2,5,29,-24,0.17
202501,73443000,2S3,3,4,-1,0.75
202501,73443000,3,56,18,38,3.11
202501,73443000,3S2,5,21,-16,0.24
202501,73443000,3S3,471,227,244,2.07
202501,73443000,CA,18,77,-59,0.23
202501,73443000,V3,0,2,-2,0
202501,73449000,2,53,491,-438,0.11
202501,73449000,2R2,0,2,-2,0
202501,73449000,2S2,4,1,3,4
202501,73449000,2S3,1,2,-1,0.5
202501,73449000,3,2,21,-19,0.1
202501,73449000,3S2,0,13,-13,0
202501,73449000,3S3,4,68,-64,0.06
202501,73449000,3S4,1,0,1,NA
202501,73449000,CA,15,249,-234,0.06
202501,73461000,2,4,17,-13,0.24
202501,73461000,CA,1,1,0,1
202501,73483000,2,26,128,-102,0.2
202501,73483000,3,0,18,-18,0
202501,73483000,3S2,0,6,-6,0
202501,73483000,3S3,0,3,-3,0
202501,73483000,CA,0,7,-7,0
202501,73483001,CA,0,2,-2,0
202501,73483002,2,1,0,1,NA
202501,73504000,2,3,63,-60,0.05
202501,73504000,2R2,0,7,-7,0
202501,73504000,2S2,0,1,-1,0
202501,73504000,3,65,20,45,3.25
202501,73504000,3S2,1,0,1,NA
202501,73504000,3S3,39,6,33,6.5
202501,73504000,CA,0,9,-9,0
202501,73520000,2,2,25,-23,0.08
202501,73520000,3S2,0,2,-2,0
202501,73520000,CA,3,2,1,1.5
202501,73547000,2,82,23,59,3.57
202501,73547000,2S1,0,1,-1,0
202501,73547000,2S2,0,1,-1,0
202501,73547000,2S3,0,1,-1,0
202501,73547000,3,2,1,1,2
202501,73547000,3S2,8,3,5,2.67
202501,73547000,3S3,104,12,92,8.67
202501,73547000,3S4,0,1,-1,0
202501,73547000,CA,0,15,-15,0
202501,73547002,2,12,1,11,12
202501,73547002,3S3,6,13,-7,0.46
202501,73547002,CA,13,0,13,NA
202501,73555000,2,17,71,-54,0.24
202501,73555000,3,9,3,6,3
202501,73555000,3S2,0,16,-16,0
202501,73555000,3S3,0,1,-1,0
202501,73555000,3S4,1,3,-2,0.33
202501,73555000,CA,9,22,-13,0.41
202501,73555001,2,1,1,0,1
202501,73555002,2,0,2,-2,0
202501,73555002,3,0,2,-2,0
202501,73563000,2,3,60,-57,0.05
202501,73563000,3,0,2,-2,0
202501,73563000,3S2,1,6,-5,0.17
202501,73563000,CA,0,4,-4,0
202501,73585000,2,20,89,-69,0.22
202501,73585000,2R2,0,4,-4,0
202501,73585000,2S2,1,0,1,NA
202501,73585000,2S3,0,1,-1,0
202501,73585000,3,38,19,19,2
202501,73585000,3S2,0,6,-6,0
202501,73585000,3S3,162,24,138,6.75
202501,73585000,CA,1,22,-21,0.05
202501,73616000,2,1,48,-47,0.02
202501,73616000,3,0,2,-2,0
202501,73616000,3S2,0,4,-4,0
202501,73616000,CA,0,8,-8,0
202501,73616001,2,2,1,1,2
202501,73622000,2,1,2,-1,0.5
202501,73622000,CA,24,28,-4,0.86
202501,73624000,2,8,92,-84,0.09
202501,73624000,3,0,2,-2,0
202501,73624000,3S2,0,4,-4,0
202501,73624000,CA,3,36,-33,0.08
202501,73671000,2,24,118,-94,0.2
202501,73671000,2R2,0,2,-2,0
202501,73671000,2S2,0,1,-1,0
202501,73671000,3,0,6,-6,0
202501,73671000,3S1,1,0,1,NA
202501,73671000,3S2,837,4,833,209.25
202501,73671000,3S3,577,125,452,4.62
202501,73671000,CA,4,28,-24,0.14
202501,73671000,V3,6,0,6,NA
202501,73675000,2,1,32,-31,0.03
202501,73675000,3S2,0,7,-7,0
202501,73675000,CA,0,2,-2,0
202501,73675002,CA,0,1,-1,0
202501,73678000,2,6,52,-46,0.12
202501,73678000,3S3,2,4,-2,0.5
202501,73678000,CA,0,12,-12,0
202501,73678004,2,2,3,-1,0.67
202501,73678004,2S2,0,1,-1,0
202501,73678004,2S3,0,1,-1,0
202501,73678004,3,0,15,-15,0
202501,73678004,3S2,2,0,2,NA
202501,73678004,3S3,17,2,15,8.5
202501,73678004,CA,1,0,1,NA
202501,73686000,2,1,11,-10,0.09
202501,73686000,CA,0,3,-3,0
202501,73770000,2,1,13,-12,0.08
202501,73770000,3,8,0,8,NA
202501,73770000,3S2,6,1,5,6
202501,73770000,3S3,2,0,2,NA
202501,73770000,4,7,0,7,NA
202501,73770000,CA,0,5,-5,0
202501,73770000,V2,6,0,6,NA
202501,73770000,V3,273,0,273,NA
202501,73770000,V4,39,0,39,NA
202501,73854000,2,2,1,1,2
202501,73854000,3S2,1,2,-1,0.5
202501,73854000,CA,0,4,-4,0
202501,73854000,V3,2,0,2,NA
202501,73861000,2,12,64,-52,0.19
202501,73861000,2S3,0,1,-1,0
202501,73861000,3,21,6,15,3.5
202501,73861000,3S2,0,1,-1,0
202501,73861000,3S3,116,54,62,2.15
202501,73861000,3S4,2,2,0,1
202501,73861000,CA,3,13,-10,0.23
202501,73870000,2,4,10,-6,0.4
202501,73870000,3S2,0,3,-3,0
202501,73873000,2,16,29,-13,0.55
202501,73873000,CA,11,12,-1,0.92
202501,76001000,2,13296,24688,-11392,0.54
202501,76001000,2B1,0,1,-1,0
202501,76001000,2B2,3,6,-3,0.5
202501,76001000,2R2,4,20,-16,0.2
202501,76001000,2S1,0,15,-15,0
202501,76001000,2S2,969,2408,-1439,0.4
202501,76001000,2S3,335,692,-357,0.48
202501,76001000,3,122,856,-734,0.14
202501,76001000,3S1,8,4,4,2
202501,76001000,3S2,2211,1728,483,1.28
202501,76001000,3S3,2696,5417,-2721,0.5
202501,76001000,3S4,4,3,1,1.33
202501,76001000,4,4,15,-11,0.27
202501,76001000,CA,4042,8858,-4816,0.46
202501,76001000,V2,110,0,110,NA
202501,76001000,V3,2,0,2,NA
202501,76001000,V4,0,1,-1,0
202501,76001001,3S3,0,1,-1,0
202501,76001001,CA,1,1,0,1
202501,76001003,2,1,0,1,NA
202501,76001013,2,0,279,-279,0
202501,76001013,CA,0,358,-358,0
202501,76001014,2,0,1,-1,0
202501,76001016,2,0,5,-5,0
202501,76001019,2,2,11,-9,0.18
202501,76001019,3S3,6,23,-17,0.26
202501,76020000,2,159,163,-4,0.98
202501,76020000,2S2,0,1,-1,0
202501,76020000,3,1,29,-28,0.03
202501,76020000,3S3,0,8,-8,0
202501,76020000,CA,0,20,-20,0
202501,76020003,2,0,1,-1,0
202501,76036000,2,137,148,-11,0.93
202501,76036000,2S2,0,2,-2,0
202501,76036000,2S3,2,3,-1,0.67
202501,76036000,3,1,34,-33,0.03
202501,76036000,3S3,18,55,-37,0.33
202501,76036000,4,0,2,-2,0
202501,76036000,CA,2,33,-31,0.06
202501,76036001,2,0,3,-3,0
202501,76041000,2,23,183,-160,0.13
202501,76041000,2R2,0,1,-1,0
202501,76041000,3,4,22,-18,0.18
202501,76041000,3S2,1,0,1,NA
202501,76041000,3S3,0,44,-44,0
202501,76041000,CA,0,61,-61,0
202501,76054000,2,10,13,-3,0.77
202501,76054000,3,1,10,-9,0.1
202501,76054000,CA,0,1,-1,0
202501,76054007,3S3,1,0,1,NA
202501,76100000,2,13,72,-59,0.18
202501,76100000,2S2,0,1,-1,0
202501,76100000,3S3,0,1,-1,0
202501,76100000,CA,2,11,-9,0.18
202501,76100004,2,0,2,-2,0
202501,76100004,3S3,0,10,-10,0
202501,76100007,2,0,1,-1,0
202501,76100009,2,0,1,-1,0
202501,76100010,2,2,1,1,2
202501,76100010,CA,1,0,1,NA
202501,76109000,2,5486,3202,2284,1.71
202501,76109000,2R2,2,0,2,NA
202501,76109000,2S1,19,47,-28,0.4
202501,76109000,2S2,13877,5371,8506,2.58
202501,76109000,2S3,4114,1912,2202,2.15
202501,76109000,3,143,55,88,2.6
202501,76109000,3S1,2,24,-22,0.08
202501,76109000,3S2,4296,2654,1642,1.62
202501,76109000,3S3,34344,11233,23111,3.06
202501,76109000,3S4,20,1,19,20
202501,76109000,4,44,20,24,2.2
202501,76109000,CA,1261,742,519,1.7
202501,76109000,V3,1,0,1,NA
202501,76109000,V4,7,0,7,NA
202501,76109006,2,0,4,-4,0
202501,76109006,3S3,0,12,-12,0
202501,76109006,CA,0,4,-4,0
202501,76109008,2,10,5,5,2
202501,76109008,2S3,1,0,1,NA
202501,76109008,3,1,0,1,NA
202501,76109008,3S3,10,0,10,NA
202501,76109008,CA,1,3,-2,0.33
202501,76109009,2,74,0,74,NA
202501,76109009,3S2,1,0,1,NA
202501,76109009,3S3,43,1,42,43
202501,76109009,CA,4,1,3,4
202501,76109015,2,46,1,45,46
202501,76109015,3S3,6,0,6,NA
202501,76109048,2,0,1,-1,0
202501,76109048,3S3,0,2,-2,0
202501,76109054,2,3,0,3,NA
202501,76109056,2,0,11,-11,0
202501,76109056,3S3,0,9,-9,0
202501,76109076,2,2,3,-1,0.67
202501,76109076,3S3,16,1,15,16
202501,76109078,2,0,2,-2,0
202501,76109078,2S2,0,1,-1,0
202501,76109078,3,0,1,-1,0
202501,76109078,3S3,22,4,18,5.5
202501,76111000,2,4582,3676,906,1.25
202501,76111000,2B2,0,1,-1,0
202501,76111000,2R2,9,0,9,NA
202501,76111000,2S1,0,1,-1,0
202501,76111000,2S2,61,74,-13,0.82
202501,76111000,2S3,32,41,-9,0.78
202501,76111000,3,802,103,699,7.79
202501,76111000,3S2,671,128,543,5.24
202501,76111000,3S3,2804,6308,-3504,0.44
202501,76111000,4,5,4,1,1.25
202501,76111000,CA,685,497,188,1.38
202501,76111000,V3,1,0,1,NA
202501,76111000,V4,0,1,-1,0
202501,76111006,2,1,0,1,NA
202501,76111020,2,2,2,0,1
202501,76111022,2,0,1,-1,0
202501,76111022,CA,0,1,-1,0
202501,76113000,2,186,529,-343,0.35
202501,76113000,2S2,9,45,-36,0.2
202501,76113000,2S3,7,14,-7,0.5
202501,76113000,3,23,21,2,1.1
202501,76113000,3S2,213,91,122,2.34
202501,76113000,3S3,269,321,-52,0.84
202501,76113000,4,1,0,1,NA
202501,76113000,CA,29,178,-149,0.16
202501,76113000,V3,0,2,-2,0
202501,76113004,3S2,0,4,-4,0
202501,76113013,2,0,8,-8,0
202501,76113016,3,1,0,1,NA
202501,76113016,3S2,0,1,-1,0
202501,76122000,2,19,222,-203,0.09
202501,76122000,2S2,0,2,-2,0
202501,76122000,2S3,1,0,1,NA
202501,76122000,3,0,2,-2,0
202501,76122000,3S2,0,2,-2,0
202501,76122000,3S3,2,9,-7,0.22
202501,76122000,CA,0,114,-114,0
202501,76126000,2,31,159,-128,0.19
202501,76126000,3,0,5,-5,0
202501,76126000,3S3,3,0,3,NA
202501,76126000,CA,0,115,-115,0
202501,76126003,2,0,1,-1,0
202501,76126006,2,0,7,-7,0
202501,76126013,2,1,14,-13,0.07
202501,76126013,3,1,16,-15,0.06
202501,76126013,3S2,0,3,-3,0
202501,76126013,3S3,0,2,-2,0
202501,76126019,2,1,0,1,NA
202501,76130000,2,1379,1534,-155,0.9
202501,76130000,2S2,20,38,-18,0.53
202501,76130000,2S3,6,12,-6,0.5
202501,76130000,3,33,126,-93,0.26
202501,76130000,3S2,155,166,-11,0.93
202501,76130000,3S3,1025,1208,-183,0.85
202501,76130000,CA,554,407,147,1.36
202501,76130000,V2,1,0,1,NA
202501,76130002,3S3,0,7,-7,0
202501,76130003,2,1,1,0,1
202501,76130004,2,1,4,-3,0.25
202501,76130006,2,0,1,-1,0
202501,76130007,2,3,2,1,1.5
202501,76130007,3,0,1,-1,0
202501,76130008,2,533,38,495,14.03
202501,76130008,2S1,0,1,-1,0
202501,76130008,2S3,7,0,7,NA
202501,76130008,3,14,37,-23,0.38
202501,76130008,3S1,0,7,-7,0
202501,76130008,3S2,30,17,13,1.76
202501,76130008,3S3,31,17,14,1.82
202501,76130008,4,0,1,-1,0
202501,76130008,CA,587,8,579,73.38
202501,76130009,2S3,1,0,1,NA
202501,76130009,3,1,0,1,NA
202501,76130009,3S3,25,0,25,NA
202501,76130016,2,1,1,0,1
202501,76130016,3S2,2,0,2,NA
202501,76130016,CA,0,11,-11,0
202501,76147000,2,2011,1979,32,1.02
202501,76147000,2R2,0,19,-19,0
202501,76147000,2S2,31,80,-49,0.39
202501,76147000,2S3,20,20,0,1
202501,76147000,3,81,181,-100,0.45
202501,76147000,3S2,88,65,23,1.35
202501,76147000,3S3,1156,1904,-748,0.61
202501,76147000,3S4,0,1,-1,0
202501,76147000,4,1,1,0,1
202501,76147000,CA,63,561,-498,0.11
202501,76147000,V2,1,0,1,NA
202501,76147000,V3,12,0,12,NA
202501,76147000,V4,1,0,1,NA
202501,76147001,2,0,1,-1,0
202501,76147002,2,1,2,-1,0.5
202501,76147010,2,210,187,23,1.12
202501,76147010,3,6,0,6,NA
202501,76147010,3S3,12,27,-15,0.44
202501,76147010,CA,30,0,30,NA
202501,76147010,V2,4,0,4,NA
202501,76233000,2,163,241,-78,0.68
202501,76233000,2S2,0,7,-7,0
202501,76233000,2S3,0,1,-1,0
202501,76233000,3S2,81,3,78,27
202501,76233000,3S3,143,60,83,2.38
202501,76233000,CA,2,153,-151,0.01
202501,76233000,V2,4,1,3,4
202501,76233002,CA,0,1,-1,0
202501,76233004,2,1,1,0,1
202501,76233005,2,1,0,1,NA
202501,76233009,2,0,5,-5,0
202501,76233011,2,0,7,-7,0
202501,76233011,CA,0,6,-6,0
202501,76233017,2,16,8,8,2
202501,76233017,2S2,3,6,-3,0.5
202501,76233017,2S3,4,0,4,NA
202501,76233017,3,2,1,1,2
202501,76233017,3S3,12,37,-25,0.32
202501,76233017,3S4,1,0,1,NA
202501,76233017,4,9,0,9,NA
202501,76233017,CA,1,2,-1,0.5
202501,76233025,2S3,1,0,1,NA
202501,76243000,2,3,6,-3,0.5
202501,76243000,CA,0,3,-3,0
202501,76243010,2,0,1,-1,0
202501,76243010,2S2,0,1,-1,0
202501,76246000,2,1,16,-15,0.06
202501,76246000,CA,0,25,-25,0
202501,76248000,2,463,490,-27,0.94
202501,76248000,2S2,0,4,-4,0
202501,76248000,2S3,0,6,-6,0
202501,76248000,3,3,26,-23,0.12
202501,76248000,3S1,0,1,-1,0
202501,76248000,3S2,106,43,63,2.47
202501,76248000,3S3,907,115,792,7.89
202501,76248000,CA,46,253,-207,0.18
202501,76248000,V2,12,0,12,NA
202501,76248001,2,0,2,-2,0
202501,76248005,3S3,18,1,17,18
202501,76248005,CA,0,2,-2,0
202501,76248009,2,2,6,-4,0.33
202501,76248009,3S3,0,6,-6,0
202501,76250000,2,49,77,-28,0.64
202501,76250000,3,0,34,-34,0
202501,76250000,CA,0,5,-5,0
202501,76250013,2,0,5,-5,0
202501,76275000,2,61,284,-223,0.21
202501,76275000,2S1,0,2,-2,0
202501,76275000,2S2,1,1,0,1
202501,76275000,3,5,24,-19,0.21
202501,76275000,3S1,0,2,-2,0
202501,76275000,3S2,7,0,7,NA
202501,76275000,3S3,231,13,218,17.77
202501,76275000,4,0,1,-1,0
202501,76275000,CA,6,224,-218,0.03
202501,76275000,V2,2,0,2,NA
202501,76275008,2,1,99,-98,0.01
202501,76275008,3,0,9,-9,0
202501,76275008,3S3,0,12,-12,0
202501,76275008,CA,0,9,-9,0
202501,76306000,2,1281,966,315,1.33
202501,76306000,2S1,0,7,-7,0
202501,76306000,2S2,46,8,38,5.75
202501,76306000,2S3,2,5,-3,0.4
202501,76306000,3,1,47,-46,0.02
202501,76306000,3S1,0,10,-10,0
202501,76306000,3S2,2,40,-38,0.05
202501,76306000,3S3,7,92,-85,0.08
202501,76306000,CA,42,134,-92,0.31
202501,76318000,2,175,290,-115,0.6
202501,76318000,2S1,1,0,1,NA
202501,76318000,2S2,6,12,-6,0.5
202501,76318000,2S3,0,1,-1,0
202501,76318000,3,8,13,-5,0.62
202501,76318000,3S2,14,46,-32,0.3
202501,76318000,3S3,390,47,343,8.3
202501,76318000,4,0,1,-1,0
202501,76318000,CA,6,149,-143,0.04
202501,76318004,3,0,1,-1,0
202501,76318004,V2,1,3,-2,0.33
202501,76318006,3S3,2,0,2,NA
202501,76318008,2,1,0,1,NA
202501,76318008,3S3,0,21,-21,0
202501,76318008,CA,1,3,-2,0.33
202501,76364000,2,763,2130,-1367,0.36
202501,76364000,2S1,0,6,-6,0
202501,76364000,2S2,3,46,-43,0.07
202501,76364000,2S3,1,13,-12,0.08
202501,76364000,3,51,85,-34,0.6
202501,76364000,3S1,0,8,-8,0
202501,76364000,3S2,19,174,-155,0.11
202501,76364000,3S2S3,0,1,-1,0
202501,76364000,3S3,91,377,-286,0.24
202501,76364000,3S4,0,1,-1,0
202501,76364000,CA,140,899,-759,0.16
202501,76364000,V4,1,2,-1,0.5
202501,76364004,2,0,3,-3,0
202501,76364006,2,1,1,0,1
202501,76364007,2,1,0,1,NA
202501,76364009,2,0,1,-1,0
202501,76364010,2,1,11,-10,0.09
202501,76364013,2,0,13,-13,0
202501,76364015,2,1,1,0,1
202501,76364021,3S2,1,1,0,1
202501,76377000,2,4,67,-63,0.06
202501,76377000,CA,1,26,-25,0.04
202501,76377004,CA,0,1,-1,0
202501,76400000,2,315,277,38,1.14
202501,76400000,2R2,1,0,1,NA
202501,76400000,2S2,1,9,-8,0.11
202501,76400000,2S3,1,0,1,NA
202501,76400000,3,14,49,-35,0.29
202501,76400000,3S2,27,4,23,6.75
202501,76400000,3S3,38,191,-153,0.2
202501,76400000,4,1,0,1,NA
202501,76400000,CA,1,56,-55,0.02
202501,76400005,2,1,0,1,NA
202501,76400007,2,30,50,-20,0.6
202501,76400007,3,0,2,-2,0
202501,76400007,3S3,3,29,-26,0.1
202501,76400007,CA,4,1,3,4
202501,76403000,2,135,100,35,1.35
202501,76403000,2R2,0,1,-1,0
202501,76403000,2S2,0,1,-1,0
202501,76403000,3,249,28,221,8.89
202501,76403000,3S2,22,0,22,NA
202501,76403000,3S3,22,2,20,11
202501,76403000,CA,1,20,-19,0.05
202501,76403007,2,0,8,-8,0
202501,76403007,3,0,6,-6,0
202501,76403007,3S3,0,6,-6,0
202501,76403007,CA,0,3,-3,0
202501,76403010,CA,0,2,-2,0
202501,76497000,2,15,65,-50,0.23
202501,76497000,3,1,42,-41,0.02
202501,76497000,3S2,0,2,-2,0
202501,76497000,3S3,0,7,-7,0
202501,76497000,CA,1,34,-33,0.03
202501,76520000,2,10363,4761,5602,2.18
202501,76520000,2B1,0,3,-3,0
202501,76520000,2B2,1,0,1,NA
202501,76520000,2R2,2,9,-7,0.22
202501,76520000,2S1,4,6,-2,0.67
202501,76520000,2S2,1216,2933,-1717,0.41
202501,76520000,2S3,331,379,-48,0.87
202501,76520000,3,242,220,22,1.1
202501,76520000,3S1,1,10,-9,0.1
202501,76520000,3S2,1215,1994,-779,0.61
202501,76520000,3S3,3649,3677,-28,0.99
202501,76520000,3S4,4,3,1,1.33
202501,76520000,4,7,3,4,2.33
202501,76520000,CA,1470,1442,28,1.02
202501,76520000,V2,0,128,-128,0
202501,76520001,2,0,3,-3,0
202501,76520002,2,44,2,42,22
202501,76520002,2S1,0,1,-1,0
202501,76520002,2S3,0,2,-2,0
202501,76520002,3,0,8,-8,0
202501,76520002,3S1,0,2,-2,0
202501,76520002,3S2,0,15,-15,0
202501,76520002,3S3,1,20,-19,0.05
202501,76520002,CA,0,2,-2,0
202501,76520005,2,0,2,-2,0
202501,76520009,CA,0,5,-5,0
202501,76520010,2,5,1,4,5
202501,76520010,CA,0,2,-2,0
202501,76520014,2,0,1,-1,0
202501,76520016,2,0,1,-1,0
202501,76520022,2,0,1,-1,0
202501,76520022,3S3,0,5,-5,0
202501,76520023,2,0,13,-13,0
202501,76520024,2,353,26,327,13.58
202501,76520024,2S2,669,556,113,1.2
202501,76520024,3S2,10,1,9,10
202501,76520024,CA,8,1,7,8
202501,76520026,2,119,71,48,1.68
202501,76520026,2S2,3,0,3,NA
202501,76520026,2S3,3,7,-4,0.43
202501,76520026,3,5,2,3,2.5
202501,76520026,3S2,4,10,-6,0.4
202501,76520026,3S3,16,44,-28,0.36
202501,76520026,CA,7,40,-33,0.17
202501,76520028,2,1,2,-1,0.5
202501,76520028,2S2,1,0,1,NA
202501,76520029,3S2,4,0,4,NA
202501,76520038,2,61,19,42,3.21
202501,76520038,3,1,3,-2,0.33
202501,76520038,3S2,2,4,-2,0.5
202501,76520038,3S3,4,41,-37,0.1
202501,76520038,CA,0,1,-1,0
202501,76563000,2,112,287,-175,0.39
202501,76563000,2S2,0,3,-3,0
202501,76563000,3,1,16,-15,0.06
202501,76563000,3S1,0,1,-1,0
202501,76563000,3S2,1,2,-1,0.5
202501,76563000,3S3,346,118,228,2.93
202501,76563000,3S4,0,1,-1,0
202501,76563000,4,1,0,1,NA
202501,76563000,CA,2,170,-168,0.01
202501,76563001,2,0,1,-1,0
202501,76606000,2,117,225,-108,0.52
202501,76606000,2S1,2,1,1,2
202501,76606000,2S2,0,1,-1,0
202501,76606000,3,3,8,-5,0.38
202501,76606000,3S1,0,1,-1,0
202501,76606000,3S2,0,2,-2,0
202501,76606000,3S3,0,6,-6,0
202501,76606000,CA,2,80,-78,0.03
202501,76616000,2,55,107,-52,0.51
202501,76616000,2S2,0,1,-1,0
202501,76616000,3,0,35,-35,0
202501,76616000,3S2,6,1,5,6
202501,76616000,3S3,300,13,287,23.08
202501,76616000,4,0,2,-2,0
202501,76616000,CA,0,38,-38,0
202501,76616000,V2,0,1,-1,0
202501,76616000,V3,0,2,-2,0
202501,76616009,2,0,13,-13,0
202501,76622000,2,64,370,-306,0.17
202501,76622000,2S2,0,3,-3,0
202501,76622000,2S3,0,2,-2,0
202501,76622000,3,8,30,-22,0.27
202501,76622000,3S2,1,7,-6,0.14
202501,76622000,3S3,20,53,-33,0.38
202501,76622000,4,2,0,2,NA
202501,76622000,CA,5,138,-133,0.04
202501,76622000,V3,0,1,-1,0
202501,76622005,2,154,1466,-1312,0.11
202501,76622005,2B1,0,1,-1,0
202501,76622005,2S1,49,0,49,NA
202501,76622005,2S2,14,0,14,NA
202501,76622005,2S3,14,0,14,NA
202501,76622005,3,333,1,332,333
202501,76622005,3S1,74,1,73,74
202501,76622005,3S2,228,11,217,20.73
202501,76622005,3S3,191,38,153,5.03
202501,76622005,CA,0,6,-6,0
202501,76670000,2,66,127,-61,0.52
202501,76670000,2S2,0,4,-4,0
202501,76670000,2S3,1,9,-8,0.11
202501,76670000,3,2,6,-4,0.33
202501,76670000,3S2,2,5,-3,0.4
202501,76670000,3S3,46,125,-79,0.37
202501,76670000,CA,0,16,-16,0
202501,76670004,2,1,0,1,NA
202501,76670007,2,7,8,-1,0.88
202501,76670007,3S2,0,1,-1,0
202501,76670007,3S3,0,3,-3,0
202501,76736000,2,14,331,-317,0.04
202501,76736000,3,0,4,-4,0
202501,76736000,3S2,16,1,15,16
202501,76736000,3S3,2,12,-10,0.17
202501,76736000,CA,2,182,-180,0.01
202501,76736004,2,1,1,0,1
202501,76736004,3S2,1,0,1,NA
202501,76736018,2,0,1,-1,0
202501,76823000,2,6,138,-132,0.04
202501,76823000,3S2,3,0,3,NA
202501,76823000,CA,3,56,-53,0.05
202501,76828000,2,33,132,-99,0.25
202501,76828000,3,1,11,-10,0.09
202501,76828000,3S2,0,1,-1,0
202501,76828000,CA,0,49,-49,0
202501,76828017,CA,0,2,-2,0
202501,76834000,2,868,2866,-1998,0.3
202501,76834000,2B1,0,1,-1,0
202501,76834000,2B2,0,1,-1,0
202501,76834000,2S1,0,6,-6,0
202501,76834000,2S2,21,91,-70,0.23
202501,76834000,2S3,16,41,-25,0.39
202501,76834000,3,47,82,-35,0.57
202501,76834000,3S1,0,10,-10,0
202501,76834000,3S2,67,46,21,1.46
202501,76834000,3S3,796,1049,-253,0.76
202501,76834000,4,0,3,-3,0
202501,76834000,CA,590,800,-210,0.74
202501,76834002,3S3,0,3,-3,0
202501,76834010,2,0,11,-11,0
202501,76834010,CA,0,3,-3,0
202501,76845000,2,0,37,-37,0
202501,76845000,3,0,1,-1,0
202501,76845000,CA,0,30,-30,0
202501,76863000,2,4,24,-20,0.17
202501,76863000,CA,0,53,-53,0
202501,76863007,2,0,1,-1,0
202501,76869000,2,28,93,-65,0.3
202501,76869000,2S3,2,0,2,NA
202501,76869000,3,8,1,7,8
202501,76869000,3S2,2,2,0,1
202501,76869000,3S3,26,259,-233,0.1
202501,76869000,CA,1,54,-53,0.02
202501,76869000,V2,7,0,7,NA
202501,76869006,3S3,0,3,-3,0
202501,76890000,2,806,245,561,3.29
202501,76890000,2S1,0,11,-11,0
202501,76890000,2S2,2047,2862,-815,0.72
202501,76890000,2S3,321,386,-65,0.83
202501,76890000,3,74,81,-7,0.91
202501,76890000,3S1,0,13,-13,0
202501,76890000,3S2,15,312,-297,0.05
202501,76890000,3S3,577,1095,-518,0.53
202501,76890000,3S4,1,0,1,NA
202501,76890000,4,14,1,13,14
202501,76890000,CA,3,65,-62,0.05
202501,76890000,V4,1,0,1,NA
202501,76890002,2,1,2,-1,0.5
202501,76890006,2,36,4,32,9
202501,76890006,2S2,2,2,0,1
202501,76890006,3,6,0,6,NA
202501,76890006,3S2,0,1,-1,0
202501,76890006,3S3,24,3,21,8
202501,76892000,2,33264,6890,26374,4.83
202501,76892000,2B1,0,6,-6,0
202501,76892000,2B2,0,5,-5,0
202501,76892000,2R2,2,4,-2,0.5
202501,76892000,2R3,15,14,1,1.07
202501,76892000,2S1,2,22,-20,0.09
202501,76892000,2S2,1598,2256,-658,0.71
202501,76892000,2S3,619,648,-29,0.96
202501,76892000,3,1327,167,1160,7.95
202501,76892000,3S1,0,11,-11,0
202501,76892000,3S2,2774,2549,225,1.09
202501,76892000,3S3,8161,9389,-1228,0.87
202501,76892000,3S4,14,4,10,3.5
202501,76892000,4,23,19,4,1.21
202501,76892000,CA,10107,1045,9062,9.67
202501,76892000,V2,1,0,1,NA
202501,76892000,V3,3,0,3,NA
202501,76892000,V4,2,6,-4,0.33
202501,76892002,2,1,17,-16,0.06
202501,76892002,CA,0,4,-4,0
202501,76892004,2,110,118,-8,0.93
202501,76892004,2S2,1,2,-1,0.5
202501,76892004,2S3,3,3,0,1
202501,76892004,3,0,3,-3,0
202501,76892004,3S2,10,0,10,NA
202501,76892004,3S3,27,13,14,2.08
202501,76892004,CA,3,5,-2,0.6
202501,76892005,2,57,2,55,28.5
202501,76892005,3,6,0,6,NA
202501,76892005,3S2,1,2,-1,0.5
202501,76892005,3S3,49,20,29,2.45
202501,76892008,2,124,1,123,124
202501,76892008,2S2,1,0,1,NA
202501,76892008,3,7,0,7,NA
202501,76892008,3S2,1,0,1,NA
202501,76892008,3S3,43,1,42,43
202501,76892010,2,1,1,0,1
202501,76892010,3S3,0,3,-3,0
202501,76892010,CA,0,1,-1,0
202501,76892012,2,0,2,-2,0
202501,76892017,2,295,0,295,NA
202501,76892017,3S2,1,0,1,NA
202501,76892017,3S3,3,50,-47,0.06
202501,76892017,CA,147,0,147,NA
202501,76895000,2,42,475,-433,0.09
202501,76895000,2R2,0,15,-15,0
202501,76895000,2S2,6,14,-8,0.43
202501,76895000,2S3,7,8,-1,0.88
202501,76895000,3,8,7,1,1.14
202501,76895000,3S2,77,32,45,2.41
202501,76895000,3S2S3,0,1,-1,0
202501,76895000,3S3,518,117,401,4.43
202501,76895000,4,0,2,-2,0
202501,76895000,CA,4,158,-154,0.03
202501,76895002,2,175,229,-54,0.76
202501,76895002,2S2,24,13,11,1.85
202501,76895002,2S3,10,4,6,2.5
202501,76895002,3,7,0,7,NA
202501,76895002,3S2,78,20,58,3.9
202501,76895002,3S3,240,208,32,1.15
202501,76895002,3S4,0,2,-2,0
202501,76895002,4,1,0,1,NA
202501,76895002,CA,2,271,-269,0.01
202501,76895003,3S3,0,7,-7,0
202501,76895007,2,0,1,-1,0
202501,81001000,2,231,2029,-1798,0.11
202501,81001000,2S2,0,7,-7,0
202501,81001000,3,31,40,-9,0.78
202501,81001000,3S1,1,0,1,NA
202501,81001000,3S2,6,7,-1,0.86
202501,81001000,3S3,53,402,-349,0.13
202501,81001000,3S4,1,1,0,1
202501,81001000,4,0,2,-2,0
202501,81001000,CA,14,59,-45,0.24
202501,81001000,V3,3,107,-104,0.03
202501,81001003,2,0,2,-2,0
202501,81065000,2,19,167,-148,0.11
202501,81065000,2S2,1,0,1,NA
202501,81065000,3,0,22,-22,0
202501,81065000,3S2,3,4,-1,0.75
202501,81065000,3S3,7,24,-17,0.29
202501,81065000,CA,0,15,-15,0
202501,81065000,V2,0,1,-1,0
202501,81065000,V3,12,87,-75,0.14
202501,81065008,2,1,5,-4,0.2
202501,81065009,2,0,1,-1,0
202501,81065009,CA,0,1,-1,0
202501,81065017,2,0,8,-8,0
202501,81065020,2,0,1,-1,0
202501,81065020,2S3,1,0,1,NA
202501,81065020,CA,0,1,-1,0
202501,81220000,2,0,4,-4,0
202501,81220000,3,0,2,-2,0
202501,81220000,3S3,0,4,-4,0
202501,81300000,2,5,88,-83,0.06
202501,81300000,3,0,3,-3,0
202501,81300000,3S3,18,15,3,1.2
202501,81300000,CA,0,2,-2,0
202501,81300002,2,0,1,-1,0
202501,81591000,2,0,5,-5,0
202501,81591000,3,0,1,-1,0
202501,81736000,2,167,903,-736,0.18
202501,81736000,2S1,2,0,2,NA
202501,81736000,2S2,1,6,-5,0.17
202501,81736000,2S3,0,1,-1,0
202501,81736000,3,119,13,106,9.15
202501,81736000,3S1,2,4,-2,0.5
202501,81736000,3S2,14,3,11,4.67
202501,81736000,3S3,83,141,-58,0.59
202501,81736000,4,8,0,8,NA
202501,81736000,CA,4,24,-20,0.17
202501,81736000,V2,3,0,3,NA
202501,81736000,V3,197,0,197,NA
202501,81736008,2,0,3,-3,0
202501,81794000,2,127,500,-373,0.25
202501,81794000,2S2,3,2,1,1.5
202501,81794000,2S3,0,1,-1,0
202501,81794000,3,4,28,-24,0.14
202501,81794000,3S1,2,1,1,2
202501,81794000,3S2,34,13,21,2.62
202501,81794000,3S3,1360,145,1215,9.38
202501,81794000,CA,3,47,-44,0.06
202501,81794000,V2,4,0,4,NA
202501,81794000,V3,46,0,46,NA
202501,81794004,2,1,1,0,1
202501,81794004,3S3,3,1,2,3
202501,81794006,2,1,3,-2,0.33
202501,81794006,3S3,0,1,-1,0
202501,85001000,2,1122,2864,-1742,0.39
202501,85001000,2R2,0,2,-2,0
202501,85001000,2S1,3,3,0,1
202501,85001000,2S2,85,216,-131,0.39
202501,85001000,2S3,77,89,-12,0.87
202501,85001000,3,192,231,-39,0.83
202501,85001000,3S1,8,1,7,8
202501,85001000,3S2,463,996,-533,0.46
202501,85001000,3S3,3380,3235,145,1.04
202501,85001000,3S4,13,8,5,1.62
202501,85001000,4,2,2,0,1
202501,85001000,4S2,4,1,3,4
202501,85001000,CA,315,631,-316,0.5
202501,85001000,V2,134,0,134,NA
202501,85001000,V3,922,26,896,35.46
202501,85001000,V4,0,1,-1,0
202501,85001001,2,4,5,-1,0.8
202501,85001001,3,1,0,1,NA
202501,85001001,3S1,1,0,1,NA
202501,85001001,3S2,6,3,3,2
202501,85001001,3S3,53,22,31,2.41
202501,85001001,CA,0,1,-1,0
202501,85001002,2,6,7,-1,0.86
202501,85001002,2S2,4,0,4,NA
202501,85001002,2S3,3,2,1,1.5
202501,85001002,3,3,0,3,NA
202501,85001002,3S2,7,16,-9,0.44
202501,85001002,3S3,49,192,-143,0.26
202501,85001002,CA,1,0,1,NA
202501,85001002,V3,46,0,46,NA
202501,85001003,2,2,12,-10,0.17
202501,85001003,2S2,10,1,9,10
202501,85001003,2S3,7,3,4,2.33
202501,85001003,3,1,1,0,1
202501,85001003,3S2,24,1,23,24
202501,85001003,3S3,63,6,57,10.5
202501,85001003,CA,1,1,0,1
202501,85001006,2,0,1,-1,0
202501,85001006,2S3,1,0,1,NA
202501,85001006,3S2,0,1,-1,0
202501,85001007,3S3,5,0,5,NA
202501,85001009,2,0,1,-1,0
202501,85010000,2,148,200,-52,0.74
202501,85010000,2S1,6,0,6,NA
202501,85010000,2S2,20,5,15,4
202501,85010000,2S3,3,6,-3,0.5
202501,85010000,3,201,94,107,2.14
202501,85010000,3S1,12,0,12,NA
202501,85010000,3S2,322,1107,-785,0.29
202501,85010000,3S3,991,780,211,1.27
202501,85010000,3S4,5,2,3,2.5
202501,85010000,4,0,1,-1,0
202501,85010000,CA,5,52,-47,0.1
202501,85010000,V2,3,29,-26,0.1
202501,85010000,V3,17,648,-631,0.03
202501,85010000,V4,4,8,-4,0.5
202501,85010001,3S2,17,1,16,17
202501,85010001,3S3,226,16,210,14.12
202501,85010001,CA,0,2,-2,0
202501,85010005,2,0,3,-3,0
202501,85010005,3S3,0,4,-4,0
202501,85010005,V3,0,2,-2,0
202501,85010010,3S3,8,0,8,NA
202501,85015000,2,0,1,-1,0
202501,85015000,3,0,1,-1,0
202501,85015000,3S2,0,1,-1,0
202501,85125000,2,15,73,-58,0.21
202501,85125000,2S2,1,2,-1,0.5
202501,85125000,3,0,4,-4,0
202501,85125000,3S2,1,23,-22,0.04
202501,85125000,3S3,7,40,-33,0.17
202501,85125000,CA,0,4,-4,0
202501,85125000,V2,0,4,-4,0
202501,85125000,V3,2,53,-51,0.04
202501,85139000,2,10,111,-101,0.09
202501,85139000,2S2,0,5,-5,0
202501,85139000,2S3,2,1,1,2
202501,85139000,3,1,28,-27,0.04
202501,85139000,3S2,67,94,-27,0.71
202501,85139000,3S3,416,322,94,1.29
202501,85139000,CA,3,48,-45,0.06
202501,85139000,V2,0,25,-25,0
202501,85139000,V3,5,87,-82,0.06
202501,85139003,3S3,1,0,1,NA
202501,85139005,3S3,1,0,1,NA
202501,85162000,2,21,73,-52,0.29
202501,85162000,2S2,2,2,0,1
202501,85162000,2S3,1,1,0,1
202501,85162000,3,0,18,-18,0
202501,85162000,3S2,1,627,-626,0
202501,85162000,3S3,12,2086,-2074,0.01
202501,85162000,CA,3,32,-29,0.09
202501,85162000,V3,4,3,1,1.33
202501,85162004,3S3,0,54,-54,0
202501,85225000,2,4,20,-16,0.2
202501,85225000,2S2,2,0,2,NA
202501,85225000,2S3,1,0,1,NA
202501,85225000,3,7,0,7,NA
202501,85225000,3S2,2,0,2,NA
202501,85225000,3S3,118,6,112,19.67
202501,85225000,CA,0,4,-4,0
202501,85225000,V3,68,0,68,NA
202501,85225006,3S2,1,1,0,1
202501,85225009,2,5,3,2,1.67
202501,85225009,2S2,0,2,-2,0
202501,85225009,2S3,0,5,-5,0
202501,85225009,3S3,0,1,-1,0
202501,85225009,CA,4,1,3,4
202501,85225016,2,1,0,1,NA
202501,85225016,3S2,1,0,1,NA
202501,85230000,2,31,156,-125,0.2
202501,85230000,2S2,6,12,-6,0.5
202501,85230000,2S3,15,16,-1,0.94
202501,85230000,3,9,105,-96,0.09
202501,85230000,3S2,422,17,405,24.82
202501,85230000,3S3,1215,136,1079,8.93
202501,85230000,3S4,0,1,-1,0
202501,85230000,4S2,0,1,-1,0
202501,85230000,CA,4,20,-16,0.2
202501,85230000,V2,11,115,-104,0.1
202501,85230000,V3,70,862,-792,0.08
202501,85230003,2,0,1,-1,0
202501,85230003,2S2,1,1,0,1
202501,85230003,3S2,275,0,275,NA
202501,85230003,3S3,136,1,135,136
202501,85230006,3S3,15,0,15,NA
202501,85250000,2,70,348,-278,0.2
202501,85250000,2S2,0,10,-10,0
202501,85250000,2S3,0,6,-6,0
202501,85250000,3,5,17,-12,0.29
202501,85250000,3S1,0,1,-1,0
202501,85250000,3S2,201,27,174,7.44
202501,85250000,3S3,320,175,145,1.83
202501,85250000,CA,4,57,-53,0.07
202501,85250000,V2,1,0,1,NA
202501,85250000,V3,43,2,41,21.5
202501,85250001,3S3,6,0,6,NA
202501,85250002,3S2,7,0,7,NA
202501,85250002,3S3,1,0,1,NA
202501,85250002,4S2,0,1,-1,0
202501,85250003,3S2,1,0,1,NA
202501,85250003,3S3,1,0,1,NA
202501,85250005,2,0,1,-1,0
202501,85250006,3S3,1,0,1,NA
202501,85263000,2,28,77,-49,0.36
202501,85263000,2S1,1,2,-1,0.5
202501,85263000,2S2,1,0,1,NA
202501,85263000,2S3,1,0,1,NA
202501,85263000,3,2,8,-6,0.25
202501,85263000,3S2,8,15,-7,0.53
202501,85263000,3S3,224,75,149,2.99
202501,85263000,4S2,1,1,0,1
202501,85263000,CA,4,8,-4,0.5
202501,85263000,V2,0,2,-2,0
202501,85263000,V3,3,63,-60,0.05
202501,85300000,2S3,0,1,-1,0
202501,85300000,3,0,3,-3,0
202501,85300000,CA,1,3,-2,0.33
202501,85300001,2S3,0,2,-2,0
202501,85300001,3,0,1,-1,0
202501,85300001,3S2,0,1,-1,0
202501,85300001,CA,0,27,-27,0
202501,85315000,2,0,7,-7,0
202501,85315000,3S2,0,1,-1,0
202501,85315000,3S3,0,4,-4,0
202501,85325000,2,11,38,-27,0.29
202501,85325000,2S1,0,6,-6,0
202501,85325000,2S2,3,12,-9,0.25
202501,85325000,2S3,1,1,0,1
202501,85325000,3,2,10,-8,0.2
202501,85325000,3S1,0,12,-12,0
202501,85325000,3S2,20,12,8,1.67
202501,85325000,3S3,242,82,160,2.95
202501,85325000,3S4,3,3,0,1
202501,85325000,CA,0,3,-3,0
202501,85325000,V3,0,1,-1,0
202501,85325002,3S3,3,0,3,NA
202501,85400000,2,0,3,-3,0
202501,85400000,CA,0,38,-38,0
202501,85410000,2,63,200,-137,0.32
202501,85410000,2S2,20,12,8,1.67
202501,85410000,2S3,7,5,2,1.4
202501,85410000,3,32,117,-85,0.27
202501,85410000,3S2,225,1666,-1441,0.14
202501,85410000,3S3,1040,4176,-3136,0.25
202501,85410000,3S4,1,2,-1,0.5
202501,85410000,4,0,9,-9,0
202501,85410000,CA,8,62,-54,0.13
202501,85410000,V2,22,0,22,NA
202501,85410000,V3,74,0,74,NA
202501,85410001,3S2,0,1,-1,0
202501,85410001,3S3,0,264,-264,0
202501,85410002,3S2,0,3,-3,0
202501,85410002,3S3,0,2,-2,0
202501,85410004,2S3,0,1,-1,0
202501,85410005,3S2,0,1,-1,0
202501,85410005,3S3,0,24,-24,0
202501,85430000,2,8,70,-62,0.11
202501,85430000,2S2,2,0,2,NA
202501,85430000,3,0,11,-11,0
202501,85430000,3S2,3,8,-5,0.38
202501,85430000,3S3,13,16,-3,0.81
202501,85430000,CA,2,9,-7,0.22
202501,85430000,V3,0,116,-116,0
202501,85430001,V3,0,7,-7,0
202501,85430006,3S3,0,1,-1,0
202501,85440000,2,78,375,-297,0.21
202501,85440000,2B2,0,7,-7,0
202501,85440000,2S1,1,0,1,NA
202501,85440000,2S2,21,29,-8,0.72
202501,85440000,2S3,26,34,-8,0.76
202501,85440000,3,53,109,-56,0.49
202501,85440000,3S1,1,0,1,NA
202501,85440000,3S2,485,31,454,15.65
202501,85440000,3S3,454,338,116,1.34
202501,85440000,3S4,4,1,3,4
202501,85440000,CA,21,101,-80,0.21
202501,85440000,V2,5,0,5,NA
202501,85440000,V3,400,1,399,400
202501,85440001,2,6,2,4,3
202501,85440001,2S2,1,0,1,NA
202501,85440001,2S3,1,0,1,NA
202501,85440001,3,1,0,1,NA
202501,85440001,3S3,2,5,-3,0.4
202501,85440001,CA,1,1,0,1
202501,85440002,3S3,3,3,0,1
202501,86001000,2,182,378,-196,0.48
202501,86001000,2R2,0,7,-7,0
202501,86001000,2S2,0,37,-37,0
202501,86001000,2S3,0,6,-6,0
202501,86001000,3,64,12,52,5.33
202501,86001000,3S2,1,2,-1,0.5
202501,86001000,3S3,14,176,-162,0.08
202501,86001000,CA,91,114,-23,0.8
202501,86001000,V2,4,4,0,1
202501,86001004,3,20,3,17,6.67
202501,86219000,2,0,5,-5,0
202501,86320000,2,69,141,-72,0.49
202501,86320000,2R2,0,5,-5,0
202501,86320000,2S2,0,2,-2,0
202501,86320000,2S3,0,3,-3,0
202501,86320000,3,147,14,133,10.5
202501,86320000,3S1,0,1,-1,0
202501,86320000,3S2,12,222,-210,0.05
202501,86320000,3S3,100,383,-283,0.26
202501,86320000,3S4,0,1,-1,0
202501,86320000,CA,1,39,-38,0.03
202501,86320000,V2,0,1,-1,0
202501,86320008,2,0,1,-1,0
202501,86568000,2,110,553,-443,0.2
202501,86568000,2B1,0,1,-1,0
202501,86568000,2R2,0,7,-7,0
202501,86568000,2S2,8,11,-3,0.73
202501,86568000,2S3,11,9,2,1.22
202501,86568000,3,7,130,-123,0.05
202501,86568000,3S1,3,5,-2,0.6
202501,86568000,3S2,271,86,185,3.15
202501,86568000,3S3,693,685,8,1.01
202501,86568000,3S4,1,14,-13,0.07
202501,86568000,CA,27,84,-57,0.32
202501,86568000,V2,0,11,-11,0
202501,86568000,V3,0,10,-10,0
202501,86568009,3S3,0,3,-3,0
202501,86568012,2,0,2,-2,0
202501,86568013,2,2,39,-37,0.05
202501,86568013,3,0,1,-1,0
202501,86568013,3S3,20,7,13,2.86
202501,86568013,CA,0,12,-12,0
202501,86568016,2,0,9,-9,0
202501,86568016,3S2,5,0,5,NA
202501,86568016,3S3,2,0,2,NA
202501,86568017,2,0,1,-1,0
202501,86568017,3S2,5,0,5,NA
202501,86568017,3S3,26,0,26,NA
202501,86568019,2,1,2,-1,0.5
202501,86568019,3S2,1,1,0,1
202501,86568019,3S3,3,0,3,NA
202501,86568019,3S4,2,0,2,NA
202501,86568019,CA,5,0,5,NA
202501,86568021,3S2,1,0,1,NA
202501,86568021,3S3,2,0,2,NA
202501,86568026,2,2,2,0,1
202501,86568026,3S2,6,1,5,6
202501,86568026,3S3,17,4,13,4.25
202501,86568026,3S4,1,3,-2,0.33
202501,86568026,CA,1,0,1,NA
202501,86569000,2,1,24,-23,0.04
202501,86569000,3,51,22,29,2.32
202501,86569000,3S3,1,6,-5,0.17
202501,86569000,CA,1,24,-23,0.04
202501,86569000,V2,11,0,11,NA
202501,86569000,V3,10,0,10,NA
202501,86571000,2,0,19,-19,0
202501,86571000,3,0,1,-1,0
202501,86571000,3S3,0,3,-3,0
202501,86571000,CA,0,8,-8,0
202501,86571000,V2,1,1,0,1
202501,86573000,2,0,10,-10,0
202501,86573007,2,0,1,-1,0
202501,86749000,2,17,63,-46,0.27
202501,86749000,3,0,1,-1,0
202501,86749000,3S3,1,7,-6,0.14
202501,86749000,4,1,4,-3,0.25
202501,86749000,CA,2,16,-14,0.12
202501,86749003,2,0,5,-5,0
202501,86755000,2,0,27,-27,0
202501,86755000,2S2,0,2,-2,0
202501,86755000,3S2,0,1,-1,0
202501,86755000,3S3,0,5,-5,0
202501,86755000,CA,0,27,-27,0
202501,86755000,V2,0,1,-1,0
202501,86757000,2,1,63,-62,0.02
202501,86757000,2S2,2,0,2,NA
202501,86757000,2S3,0,1,-1,0
202501,86757000,3,2,140,-138,0.01
202501,86757000,3S2,0,66,-66,0
202501,86757000,3S3,3,862,-859,0
202501,86757000,CA,0,26,-26,0
202501,86757001,2,0,9,-9,0
202501,86757001,3S3,1,0,1,NA
202501,86760000,2,0,2,-2,0
202501,86760000,3S3,0,1,-1,0
202501,86760000,CA,0,11,-11,0
202501,86865000,2,25,403,-378,0.06
202501,86865000,2S2,1,2,-1,0.5
202501,86865000,3,7,9,-2,0.78
202501,86865000,3S2,0,1,-1,0
202501,86865000,3S3,6,45,-39,0.13
202501,86865000,CA,3,13,-10,0.23
202501,86865017,2,0,2,-2,0
202501,86865017,CA,0,18,-18,0
202501,86865021,2,0,1,-1,0
202501,86865021,3S3,0,1,-1,0
202501,86885000,2,16,127,-111,0.13
202501,86885000,2S2,1,2,-1,0.5
202501,86885000,2S3,1,1,0,1
202501,86885000,3,20,143,-123,0.14
202501,86885000,3S1,4,2,2,2
202501,86885000,3S2,88,10,78,8.8
202501,86885000,3S3,681,101,580,6.74
202501,86885000,3S4,12,3,9,4
202501,86885000,CA,22,41,-19,0.54
202501,86885001,3,60,8,52,7.5
202501,86885001,3S2,4,0,4,NA
202501,86885001,3S3,41,0,41,NA
202501,86885010,2,0,1,-1,0
202501,86885010,3,0,1,-1,0
202501,88001000,3S3,1,0,1,NA
202501,91001000,2,0,36,-36,0
202501,91001000,3S3,0,8,-8,0
202501,91001000,CA,0,1,-1,0
202501,91460000,2,0,5,-5,0
202501,94001000,2,0,17,-17,0
202501,94001000,3,0,4,-4,0
202501,94001000,3S2,0,7,-7,0
202501,94001000,3S3,0,31,-31,0
202501,94001000,CA,0,2,-2,0
202501,94343000,2,0,2,-2,0
202501,94884000,2,1,0,1,NA
202501,94884000,2S3,0,2,-2,0
202501,95001000,2,117,1229,-1112,0.1
202501,95001000,2B1,0,1,-1,0
202501,95001000,2B2,0,2,-2,0
202501,95001000,2S2,3,6,-3,0.5
202501,95001000,2S3,0,5,-5,0
202501,95001000,3,2,49,-47,0.04
202501,95001000,3S2,0,10,-10,0
202501,95001000,3S3,2,328,-326,0.01
202501,95001000,4,0,2,-2,0
202501,95001000,CA,19,260,-241,0.07
202501,95001000,V2,0,2,-2,0
202501,95001000,V3,0,9,-9,0
202501,95001010,2,0,1,-1,0
202501,95001013,2,0,1,-1,0
202501,95001013,CA,0,1,-1,0
202501,95015000,2,1,30,-29,0.03
202501,95015000,2S2,1,0,1,NA
202501,95015000,3S2,1,1,0,1
202501,95015000,3S3,0,13,-13,0
202501,95015000,CA,0,2,-2,0
202501,95025000,2,1,19,-18,0.05
202501,95025000,3,0,1,-1,0
202501,95025000,3S3,0,6,-6,0
202501,95025001,2,0,2,-2,0
202501,95025003,3S3,0,1,-1,0
202501,97001000,2,0,20,-20,0
202501,97001000,3,0,2,-2,0
202501,97001000,3S3,0,3,-3,0
202501,97001000,CA,0,3,-3,0
202501,97161000,2,0,1,-1,0
202501,97161000,3,0,1,-1,0
202501,99001000,2,15,55,-40,0.27
202501,99001000,3,3,22,-19,0.14
202501,99001000,3S2,0,17,-17,0
202501,99001000,3S3,0,101,-101,0
202501,99001000,CA,0,8,-8,0
202501,99001001,3S3,3,0,3,NA
202501,99001002,3,1,0,1,NA
202501,99524000,2,3,57,-54,0.05
202501,99524000,3,1,10,-9,0.1
202501,99524000,3S3,4,0,4,NA
202501,99524000,CA,0,6,-6,0
202501,99524001,2,0,1,-1,0
202501,99624000,2,0,54,-54,0
202501,99624000,3,4,3,1,1.33
202501,99624000,3S2,1,0,1,NA
202501,99624000,3S3,22,0,22,NA
202501,99624000,CA,0,1,-1,0
202501,99624000,V2,0,1,-1,0
202501,99773000,2,1,17,-16,0.06
202501,99773000,2S3,1,0,1,NA
202501,99773000,3,1,22,-21,0.05
202501,99773000,3S2,2,1,1,2
202501,99773000,3S3,26,8,18,3.25
202501,99773000,CA,1,0,1,NA
202501,99773000,V3,2,0,2,NA
202501,99773001,2,0,2,-2,0
202501,99773002,2,0,1,-1,0
202501,99773002,2S3,0,1,-1,0
202501,99773002,3S3,11,15,-4,0.73
202501,99773003,2,0,1,-1,0
202501,99773004,3S2,0,8,-8,0
202502,5001000,2,27464,34435,-6971,0.8
202502,5001000,2B1,0,6,-6,0
202502,5001000,2B2,0,8,-8,0
202502,5001000,2R2,2,18,-16,0.11
202502,5001000,2R3,2,72,-70,0.03
202502,5001000,2S1,2,11,-9,0.18
202502,5001000,2S2,1215,2698,-1483,0.45
202502,5001000,2S3,395,1246,-851,0.32
202502,5001000,3,1719,911,808,1.89
202502,5001000,3S1,2,4,-2,0.5
202502,5001000,3S2,2013,2543,-530,0.79
202502,5001000,3S3,3640,7912,-4272,0.46
202502,5001000,3S4,4,2,2,2
202502,5001000,4,12,100,-88,0.12
202502,5001000,CA,9184,15748,-6564,0.58
202502,5001000,V2,35,0,35,NA
202502,5001000,V3,48,446,-398,0.11
202502,5001001,2,4,40,-36,0.1
202502,5001001,2R2,0,1,-1,0
202502,5001001,3,0,1,-1,0
202502,5001001,CA,0,30,-30,0
202502,5001002,2,10,46,-36,0.22
202502,5001002,2S2,3,2,1,1.5
202502,5001002,2S3,0,1,-1,0
202502,5001002,3,0,4,-4,0
202502,5001002,3S2,1,1,0,1
202502,5001002,3S3,2,3,-1,0.67
202502,5001002,CA,1,7,-6,0.14
202502,5001003,2,7,30,-23,0.23
202502,5001003,3,2,0,2,NA
202502,5001003,3S3,5,5,0,1
202502,5001003,CA,0,5,-5,0
202502,5001004,2,7,23,-16,0.3
202502,5001004,2S2,0,1,-1,0
202502,5001004,3,1,0,1,NA
202502,5001004,3S2,0,1,-1,0
202502,5001004,CA,1,3,-2,0.33
202502,5001010,2,0,7,-7,0
202502,5001010,3S3,2,0,2,NA
202502,5002000,2,91,69,22,1.32
202502,5002000,2S2,0,11,-11,0
202502,5002000,3,7,26,-19,0.27
202502,5002000,3S2,1,1,0,1
202502,5002000,CA,0,10,-10,0
202502,5002000,V2,205,0,205,NA
202502,5002000,V3,0,3,-3,0
202502,5002010,2,0,35,-35,0
202502,5002010,3,0,14,-14,0
202502,5004000,2,3,11,-8,0.27
202502,5004000,3,0,2,-2,0
202502,5004000,3S3,26,0,26,NA
202502,5021000,2,3,19,-16,0.16
202502,5021000,3,0,3,-3,0
202502,5021000,3S2,1,3,-2,0.33
202502,5021000,3S3,18,2,16,9
202502,5021000,CA,0,21,-21,0
202502,5030000,2,111,551,-440,0.2
202502,5030000,2S2,0,3,-3,0
202502,5030000,2S3,1,2,-1,0.5
202502,5030000,3,15,50,-35,0.3
202502,5030000,3S2,16,19,-3,0.84
202502,5030000,3S3,750,166,584,4.52
202502,5030000,CA,7,129,-122,0.05
202502,5030000,V2,0,2,-2,0
202502,5030000,V3,259,0,259,NA
202502,5030011,3S3,48,0,48,NA
202502,5031000,2,7,82,-75,0.09
202502,5031000,2S2,0,13,-13,0
202502,5031000,3,29,12,17,2.42
202502,5031000,3S2,3,5,-2,0.6
202502,5031000,3S3,4,1,3,4
202502,5031000,3S4,0,1,-1,0
202502,5031000,4,2,0,2,NA
202502,5031000,CA,1,40,-39,0.03
202502,5031000,V3,165,2,163,82.5
202502,5031000,V4,17,0,17,NA
202502,5031009,3S2,0,1,-1,0
202502,5034000,2,53,178,-125,0.3
202502,5034000,3,1,20,-19,0.05
202502,5034000,3S2,2,1,1,2
202502,5034000,3S3,36,67,-31,0.54
202502,5034000,CA,2,61,-59,0.03
202502,5034000,V2,0,3,-3,0
202502,5034005,2,0,1,-1,0
202502,5034005,3S3,0,1,-1,0
202502,5034006,2,7,1,6,7
202502,5034007,2,4,1,3,4
202502,5034007,3S3,0,1,-1,0
202502,5034009,2,1,0,1,NA
202502,5036000,2,15,15,0,1
202502,5036000,3,1,4,-3,0.25
202502,5036000,CA,0,6,-6,0
202502,5036000,V2,3,0,3,NA
202502,5036000,V3,48,0,48,NA
202502,5038000,2,9,34,-25,0.26
202502,5038000,3,1,30,-29,0.03
202502,5038000,3S2,0,1,-1,0
202502,5038000,3S3,0,1,-1,0
202502,5038000,4,7,0,7,NA
202502,5038000,CA,0,9,-9,0
202502,5038008,2,4,7,-3,0.57
202502,5038008,3,0,2,-2,0
202502,5038008,3S3,7,16,-9,0.44
202502,5038008,CA,0,1,-1,0
202502,5040000,2,3,65,-62,0.05
202502,5040000,3,1,4,-3,0.25
202502,5040000,3S2,1,1,0,1
202502,5040000,3S3,0,4,-4,0
202502,5040000,CA,0,39,-39,0
202502,5040004,2,2,4,-2,0.5
202502,5040004,3S3,0,1,-1,0
202502,5042000,2,37,277,-240,0.13
202502,5042000,2S3,0,2,-2,0
202502,5042000,3,5,40,-35,0.12
202502,5042000,3S1,1,0,1,NA
202502,5042000,3S2,2,10,-8,0.2
202502,5042000,3S3,22,114,-92,0.19
202502,5042000,CA,7,100,-93,0.07
202502,5042000,V3,0,2,-2,0
202502,5042001,CA,0,3,-3,0
202502,5044000,2,3,13,-10,0.23
202502,5044000,3,3,12,-9,0.25
202502,5044000,3S3,23,0,23,NA
202502,5044000,CA,0,2,-2,0
202502,5044001,2,1,1,0,1
202502,5044001,3,1,1,0,1
202502,5045000,2,402,1586,-1184,0.25
202502,5045000,2B2,0,14,-14,0
202502,5045000,2R2,1,7,-6,0.14
202502,5045000,2S2,9,41,-32,0.22
202502,5045000,2S3,4,9,-5,0.44
202502,5045000,3,36,125,-89,0.29
202502,5045000,3S2,123,71,52,1.73
202502,5045000,3S3,706,714,-8,0.99
202502,5045000,3S4,1,6,-5,0.17
202502,5045000,4,1,6,-5,0.17
202502,5045000,CA,171,306,-135,0.56
202502,5051000,2,41,136,-95,0.3
202502,5051000,2B2,0,1,-1,0
202502,5051000,2S2,4,1,3,4
202502,5051000,2S3,1,1,0,1
202502,5051000,3,6,9,-3,0.67
202502,5051000,3S2,4,1,3,4
202502,5051000,3S3,7,31,-24,0.23
202502,5051000,4,0,2,-2,0
202502,5051000,CA,2,50,-48,0.04
202502,5055000,2,1,17,-16,0.06
202502,5055000,3,0,2,-2,0
202502,5055000,CA,0,4,-4,0
202502,5059000,2,15,126,-111,0.12
202502,5059000,2R3,0,25,-25,0
202502,5059000,2S2,0,7,-7,0
202502,5059000,2S3,1,2,-1,0.5
202502,5059000,3,0,6,-6,0
202502,5059000,3S2,0,1,-1,0
202502,5059000,3S3,1,7,-6,0.14
202502,5059000,CA,1,23,-22,0.04
202502,5059002,2,0,1,-1,0
202502,5079000,2,1807,1121,686,1.61
202502,5079000,2B1,4,0,4,NA
202502,5079000,2R2,4,0,4,NA
202502,5079000,2R3,0,2,-2,0
202502,5079000,2S2,383,105,278,3.65
202502,5079000,2S3,31,43,-12,0.72
202502,5079000,3,248,117,131,2.12
202502,5079000,3S2,122,168,-46,0.73
202502,5079000,3S3,1021,856,165,1.19
202502,5079000,3S4,0,1,-1,0
202502,5079000,4,4,2,2,2
202502,5079000,CA,103,531,-428,0.19
202502,5079000,V3,0,5,-5,0
202502,5079001,2,20,3,17,6.67
202502,5079001,2S2,1,0,1,NA
202502,5079001,2S3,5,0,5,NA
202502,5079001,3,0,1,-1,0
202502,5079001,3S3,4,3,1,1.33
202502,5079001,CA,17,9,8,1.89
202502,5086000,2,49,18,31,2.72
202502,5086000,2S2,0,3,-3,0
202502,5086000,3,0,14,-14,0
202502,5086000,CA,0,20,-20,0
202502,5086000,V3,0,7,-7,0
202502,5088000,2,2219,3703,-1484,0.6
202502,5088000,2R2,0,1,-1,0
202502,5088000,2R3,0,14,-14,0
202502,5088000,2S2,55,181,-126,0.3
202502,5088000,2S3,25,75,-50,0.33
202502,5088000,3,208,288,-80,0.72
202502,5088000,3S2,34,150,-116,0.23
202502,5088000,3S3,1832,2567,-735,0.71
202502,5088000,4,63,34,29,1.85
202502,5088000,CA,2327,1506,821,1.55
202502,5088000,V2,1,2,-1,0.5
202502,5088000,V3,320,106,214,3.02
202502,5088012,2,0,4,-4,0
202502,5088012,2S2,0,1,-1,0
202502,5088012,2S3,0,1,-1,0
202502,5088012,3S3,1,1,0,1
202502,5088012,CA,0,1,-1,0
202502,5088013,2,36,4,32,9
202502,5088013,3,9,3,6,3
202502,5088013,3S2,1,0,1,NA
202502,5088013,4,29,0,29,NA
202502,5088018,V3,0,68,-68,0
202502,5091000,2,14,13,1,1.08
202502,5091000,3,0,10,-10,0
202502,5091000,3S3,0,4,-4,0
202502,5091000,4,0,2,-2,0
202502,5091000,CA,0,9,-9,0
202502,5093000,2,0,18,-18,0
202502,5093000,3S3,8,16,-8,0.5
202502,5093000,CA,0,3,-3,0
202502,5093000,V3,0,2,-2,0
202502,5093001,2,1,1,0,1
202502,5093001,3,6,3,3,2
202502,5101000,2,108,181,-73,0.6
202502,5101000,2S3,0,1,-1,0
202502,5101000,3,2,4,-2,0.5
202502,5101000,3S2,2,2,0,1
202502,5101000,3S3,18,49,-31,0.37
202502,5101000,4,0,1,-1,0
202502,5101000,CA,82,52,30,1.58
202502,5101000,V2,1,0,1,NA
202502,5107000,2,3,10,-7,0.3
202502,5107000,3,1,1,0,1
202502,5107000,3S2,2,5,-3,0.4
202502,5107000,CA,0,11,-11,0
202502,5113000,2,7,94,-87,0.07
202502,5113000,2S3,0,1,-1,0
202502,5113000,3,3,33,-30,0.09
202502,5113000,3S2,2,66,-64,0.03
202502,5113000,3S3,58,28,30,2.07
202502,5113000,CA,1,10,-9,0.1
202502,5120000,2,37,10,27,3.7
202502,5120000,2S2,1,0,1,NA
202502,5120000,2S3,1,0,1,NA
202502,5120000,3,0,1,-1,0
202502,5120000,3S2,1,4,-3,0.25
202502,5120000,3S3,4,4,0,1
202502,5120000,CA,0,9,-9,0
202502,5120002,3S2,6,3,3,2
202502,5120002,3S3,0,1,-1,0
202502,5120003,3S3,0,1,-1,0
202502,5120004,2,1,47,-46,0.02
202502,5120004,2S2,1,0,1,NA
202502,5120004,3,0,2,-2,0
202502,5120004,3S3,1,1,0,1
202502,5120004,CA,0,75,-75,0
202502,5120006,2,0,1,-1,0
202502,5120010,3S2,1,0,1,NA
202502,5125000,2,0,11,-11,0
202502,5125000,3,10,8,2,1.25
202502,5125000,3S3,0,1,-1,0
202502,5125000,CA,0,19,-19,0
202502,5129000,2,2332,2129,203,1.1
202502,5129000,2R2,0,8,-8,0
202502,5129000,2R3,0,2,-2,0
202502,5129000,2S2,256,388,-132,0.66
202502,5129000,2S3,106,171,-65,0.62
202502,5129000,3,82,169,-87,0.49
202502,5129000,3S1,10,2,8,5
202502,5129000,3S2,182,124,58,1.47
202502,5129000,3S3,934,376,558,2.48
202502,5129000,3S4,1,2,-1,0.5
202502,5129000,4,14,0,14,NA
202502,5129000,CA,1554,474,1080,3.28
202502,5129000,V2,33,0,33,NA
202502,5129000,V3,7,25,-18,0.28
202502,5129004,2,0,2,-2,0
202502,5129005,3S2,4,14,-10,0.29
202502,5134000,2,1,50,-49,0.02
202502,5134000,CA,0,1,-1,0
202502,5138000,2,14,70,-56,0.2
202502,5138000,2S2,1,0,1,NA
202502,5138000,3,11,8,3,1.38
202502,5138000,3S2,9,4,5,2.25
202502,5138000,3S3,21,20,1,1.05
202502,5138000,3S4,1,1,0,1
202502,5138000,4,0,3,-3,0
202502,5138000,CA,0,6,-6,0
202502,5138006,2,0,1,-1,0
202502,5138006,3,0,1,-1,0
202502,5142000,2,1,17,-16,0.06
202502,5142000,3,5,5,0,1
202502,5142000,3S2,1,0,1,NA
202502,5142000,3S3,1,0,1,NA
202502,5142000,CA,0,7,-7,0
202502,5142000,V2,0,1,-1,0
202502,5142000,V3,2,0,2,NA
202502,5142003,2,0,7,-7,0
202502,5142003,3S3,0,1,-1,0
202502,5142003,CA,0,1,-1,0
202502,5142006,2,2,86,-84,0.02
202502,5142006,3S3,0,10,-10,0
202502,5145000,2,9,10,-1,0.9
202502,5145000,3,5,12,-7,0.42
202502,5145000,3S2,1,1,0,1
202502,5145000,CA,1,20,-19,0.05
202502,5145002,2,0,5,-5,0
202502,5147000,2,82,288,-206,0.28
202502,5147000,2B2,0,4,-4,0
202502,5147000,2R2,3,1,2,3
202502,5147000,2S2,0,1,-1,0
202502,5147000,2S3,2,1,1,2
202502,5147000,3,12,24,-12,0.5
202502,5147000,3S2,7,10,-3,0.7
202502,5147000,3S3,78,373,-295,0.21
202502,5147000,CA,47,53,-6,0.89
202502,5147004,2,2,0,2,NA
202502,5147004,2S3,1,0,1,NA
202502,5147004,3S2,3,0,3,NA
202502,5147004,3S3,17,0,17,NA
202502,5148000,2,1018,837,181,1.22
202502,5148000,2R2,0,5,-5,0
202502,5148000,2S2,68,45,23,1.51
202502,5148000,2S3,26,9,17,2.89
202502,5148000,3,9,33,-24,0.27
202502,5148000,3S2,36,16,20,2.25
202502,5148000,3S3,32,103,-71,0.31
202502,5148000,CA,5,336,-331,0.01
202502,5148003,3S2,1,0,1,NA
202502,5148005,2R3,0,1,-1,0
202502,5148005,2S3,0,3,-3,0
202502,5150000,2,42,28,14,1.5
202502,5150000,3,1,5,-4,0.2
202502,5150000,3S3,0,1,-1,0
202502,5150000,CA,0,3,-3,0
202502,5150000,V3,0,11,-11,0
202502,5154000,2,160,1022,-862,0.16
202502,5154000,2B2,0,11,-11,0
202502,5154000,2R2,0,5,-5,0
202502,5154000,2S2,1,11,-10,0.09
202502,5154000,2S3,3,18,-15,0.17
202502,5154000,3,8,82,-74,0.1
202502,5154000,3S2,20,38,-18,0.53
202502,5154000,3S3,107,598,-491,0.18
202502,5154000,CA,29,210,-181,0.14
202502,5154006,2,0,1,-1,0
202502,5154007,2,0,2,-2,0
202502,5154009,3S3,0,1,-1,0
202502,5154012,3S2,0,1,-1,0
202502,5154015,3S3,28,10,18,2.8
202502,5154023,3S2,5,2,3,2.5
202502,5154023,3S3,4,3,1,1.33
202502,5172000,2,211,283,-72,0.75
202502,5172000,2B2,0,10,-10,0
202502,5172000,2R2,0,5,-5,0
202502,5172000,2S2,2,3,-1,0.67
202502,5172000,2S3,2,1,1,2
202502,5172000,3,3,49,-46,0.06
202502,5172000,3S2,7,11,-4,0.64
202502,5172000,3S3,123,160,-37,0.77
202502,5172000,4,1,0,1,NA
202502,5172000,CA,8,111,-103,0.07
202502,5172003,2S3,0,1,-1,0
202502,5190000,2,12,42,-30,0.29
202502,5190000,2S2,0,1,-1,0
202502,5190000,2S3,1,0,1,NA
202502,5190000,3,2,10,-8,0.2
202502,5190000,3S2,4,1,3,4
202502,5190000,3S3,9,22,-13,0.41
202502,5190000,3S4,0,1,-1,0
202502,5190000,CA,2,47,-45,0.04
202502,5197000,2,6,43,-37,0.14
202502,5197000,2S2,0,5,-5,0
202502,5197000,3,1,2,-1,0.5
202502,5197000,3S3,0,4,-4,0
202502,5197000,CA,1,35,-34,0.03
202502,5197000,V3,0,2,-2,0
202502,5206000,2,2,38,-36,0.05
202502,5206000,3,1,5,-4,0.2
202502,5206000,3S3,1,0,1,NA
202502,5209000,2,15,37,-22,0.41
202502,5209000,3,7,9,-2,0.78
202502,5209000,3S2,1,0,1,NA
202502,5209000,3S3,15,36,-21,0.42
202502,5209000,CA,0,16,-16,0
202502,5209005,2,0,1,-1,0
202502,5212000,2,1529,1357,172,1.13
202502,5212000,2B1,1,0,1,NA
202502,5212000,2R2,1,0,1,NA
202502,5212000,2R3,0,7,-7,0
202502,5212000,2S2,607,223,384,2.72
202502,5212000,2S3,97,67,30,1.45
202502,5212000,3,21,65,-44,0.32
202502,5212000,3S1,2,0,2,NA
202502,5212000,3S2,184,194,-10,0.95
202502,5212000,3S3,423,340,83,1.24
202502,5212000,3S4,1,0,1,NA
202502,5212000,4,2,22,-20,0.09
202502,5212000,CA,449,764,-315,0.59
202502,5212000,V2,1,5,-4,0.2
202502,5234000,2,5,60,-55,0.08
202502,5234000,3,3,24,-21,0.12
202502,5234000,3S2,3,1,2,3
202502,5234000,3S3,3,74,-71,0.04
202502,5234000,CA,1,11,-10,0.09
202502,5234000,V3,0,3,-3,0
202502,5234009,2,1,6,-5,0.17
202502,5234009,3S2,1,0,1,NA
202502,5234009,CA,0,1,-1,0
202502,5234010,3,0,10,-10,0
202502,5234010,V3,0,1,-1,0
202502,5237000,2,173,329,-156,0.53
202502,5237000,2S2,1,2,-1,0.5
202502,5237000,2S3,0,3,-3,0
202502,5237000,3,3,91,-88,0.03
202502,5237000,3S2,4,5,-1,0.8
202502,5237000,3S3,4,136,-132,0.03
202502,5237000,CA,1,31,-30,0.03
202502,5237000,V3,0,81,-81,0
202502,5237001,2,1,1,0,1
202502,5240000,2,0,3,-3,0
202502,5240000,3,0,2,-2,0
202502,5240000,4,1,0,1,NA
202502,5240000,CA,1,7,-6,0.14
202502,5240000,V3,0,2,-2,0
202502,5240001,2,0,1,-1,0
202502,5240001,4,1,0,1,NA
202502,5240003,2,3,11,-8,0.27
202502,5240003,V3,0,3,-3,0
202502,5240007,2,0,1,-1,0
202502,5240007,CA,0,2,-2,0
202502,5250000,2,15,208,-193,0.07
202502,5250000,2S2,0,6,-6,0
202502,5250000,3,0,27,-27,0
202502,5250000,3S2,4,11,-7,0.36
202502,5250000,3S3,7,101,-94,0.07
202502,5250000,4,0,1,-1,0
202502,5250000,CA,3,30,-27,0.1
202502,5250000,V3,0,2,-2,0
202502,5250002,3S2,0,2,-2,0
202502,5250004,3S3,3,0,3,NA
202502,5264000,2,184,328,-144,0.56
202502,5264000,2S2,1,20,-19,0.05
202502,5264000,2S3,0,4,-4,0
202502,5264000,3,4,26,-22,0.15
202502,5264000,3S2,29,10,19,2.9
202502,5264000,3S3,26,128,-102,0.2
202502,5264000,CA,4,69,-65,0.06
202502,5264000,V2,0,4,-4,0
202502,5264000,V3,0,6,-6,0
202502,5266000,2,8147,3452,4695,2.36
202502,5266000,2R2,39,1,38,39
202502,5266000,2R3,0,6,-6,0
202502,5266000,2S1,0,4,-4,0
202502,5266000,2S2,1706,440,1266,3.88
202502,5266000,2S3,492,170,322,2.89
202502,5266000,3,80,170,-90,0.47
202502,5266000,3S2,179,225,-46,0.8
202502,5266000,3S3,461,1146,-685,0.4
202502,5266000,4,0,5,-5,0
202502,5266000,CA,1569,1493,76,1.05
202502,5266001,2,11,117,-106,0.09
202502,5266001,3S3,0,1,-1,0
202502,5266001,CA,0,16,-16,0
202502,5282000,2,48,128,-80,0.38
202502,5282000,2S2,0,14,-14,0
202502,5282000,3,11,6,5,1.83
202502,5282000,3S3,1,2,-1,0.5
202502,5282000,4,6,0,6,NA
202502,5282000,CA,0,29,-29,0
202502,5282000,V2,0,2,-2,0
202502,5282004,2,1,0,1,NA
202502,5282004,2S3,1,0,1,NA
202502,5282004,3,0,3,-3,0
202502,5282004,3S2,6,0,6,NA
202502,5282004,3S3,3,0,3,NA
202502,5282005,2,0,1,-1,0
202502,5282005,CA,0,1,-1,0
202502,5284000,2,9,95,-86,0.09
202502,5284000,3,1,12,-11,0.08
202502,5284000,3S2,1,2,-1,0.5
202502,5284000,3S3,4,26,-22,0.15
202502,5284000,CA,1,44,-43,0.02
202502,5284000,V3,0,3,-3,0
202502,5284006,2,0,3,-3,0
202502,5306000,2,6,28,-22,0.21
202502,5306000,3,2,2,0,1
202502,5306000,3S3,0,4,-4,0
202502,5306000,3S4,1,0,1,NA
202502,5306000,CA,0,6,-6,0
202502,5306001,3,0,1,-1,0
202502,5306002,2,0,1,-1,0
202502,5308000,2,7454,2838,4616,2.63
202502,5308000,2R2,7,9,-2,0.78
202502,5308000,2R3,0,5,-5,0
202502,5308000,2S2,161,585,-424,0.28
202502,5308000,2S3,93,178,-85,0.52
202502,5308000,3,588,143,445,4.11
202502,5308000,3S1,1,1,0,1
202502,5308000,3S2,259,358,-99,0.72
202502,5308000,3S3,2067,2827,-760,0.73
202502,5308000,3S4,0,1,-1,0
202502,5308000,4,44,10,34,4.4
202502,5308000,CA,2740,636,2104,4.31
202502,5308000,V2,6,7,-1,0.86
202502,5308000,V3,288,209,79,1.38
202502,5308000,V4,0,61,-61,0
202502,5308002,3S3,3,0,3,NA
202502,5308012,2,0,1,-1,0
202502,5310000,2,65,27,38,2.41
202502,5310000,3,1,9,-8,0.11
202502,5310000,3S3,0,8,-8,0
202502,5310000,CA,26,30,-4,0.87
202502,5310000,V3,0,1,-1,0
202502,5310003,2,1261,343,918,3.68
202502,5310003,2R3,0,8,-8,0
202502,5310003,2S2,16,55,-39,0.29
202502,5310003,2S3,23,71,-48,0.32
202502,5310003,3,16,3,13,5.33
202502,5310003,3S2,1,3,-2,0.33
202502,5310003,3S3,10,83,-73,0.12
202502,5310003,4,3,3,0,1
202502,5310003,CA,240,26,214,9.23
202502,5313000,2,3,21,-18,0.14
202502,5313000,2S2,0,17,-17,0
202502,5313000,3,1,2,-1,0.5
202502,5313000,3S3,10,1,9,10
202502,5313000,CA,0,44,-44,0
202502,5315000,2,4,25,-21,0.16
202502,5315000,3,2,2,0,1
202502,5315000,3S2,2,0,2,NA
202502,5315000,CA,0,7,-7,0
202502,5318000,2,6217,2540,3677,2.45
202502,5318000,2R2,0,12,-12,0
202502,5318000,2R3,0,4,-4,0
202502,5318000,2S1,2,0,2,NA
202502,5318000,2S2,182,291,-109,0.63
202502,5318000,2S3,52,98,-46,0.53
202502,5318000,3,249,157,92,1.59
202502,5318000,3S2,184,167,17,1.1
202502,5318000,3S3,1184,798,386,1.48
202502,5318000,CA,828,614,214,1.35
202502,5318000,V2,0,227,-227,0
202502,5318000,V3,0,126,-126,0
202502,5318000,V4,0,9,-9,0
202502,5318003,2,457,0,457,NA
202502,5318003,2S1,11,0,11,NA
202502,5318003,2S2,51,0,51,NA
202502,5318003,2S3,5,0,5,NA
202502,5318003,3,0,1,-1,0
202502,5318003,3S2,13,0,13,NA
202502,5318003,3S3,229,0,229,NA
202502,5321000,2,6,97,-91,0.06
202502,5321000,2S2,1,22,-21,0.05
202502,5321000,3,1,4,-3,0.25
202502,5321000,3S2,0,1,-1,0
202502,5321000,3S3,0,5,-5,0
202502,5321000,CA,1,63,-62,0.02
202502,5321000,V3,0,2,-2,0
202502,5347000,2,3,21,-18,0.14
202502,5347000,3,3,13,-10,0.23
202502,5347000,CA,0,5,-5,0
202502,5353000,2,0,52,-52,0
202502,5353000,3,0,3,-3,0
202502,5353000,3S3,0,14,-14,0
202502,5353000,CA,1,10,-9,0.1
202502,5360000,2,13363,7120,6243,1.88
202502,5360000,2B1,0,3,-3,0
202502,5360000,2R2,5,1,4,5
202502,5360000,2R3,0,16,-16,0
202502,5360000,2S1,38,11,27,3.45
202502,5360000,2S2,382,413,-31,0.92
202502,5360000,2S3,125,302,-177,0.41
202502,5360000,3,351,417,-66,0.84
202502,5360000,3S2,153,266,-113,0.58
202502,5360000,3S3,1831,4527,-2696,0.4
202502,5360000,3S4,2,0,2,NA
202502,5360000,4,3,24,-21,0.12
202502,5360000,CA,4491,1768,2723,2.54
202502,5360001,2,1,1,0,1
202502,5360001,2S1,0,1,-1,0
202502,5360001,2S2,0,3,-3,0
202502,5360001,2S3,2,2,0,1
202502,5360001,3S2,1,1,0,1
202502,5360001,3S3,1,1,0,1
202502,5360003,2,0,3,-3,0
202502,5360006,2,0,31,-31,0
202502,5360006,CA,0,32,-32,0
202502,5361000,2,35,56,-21,0.62
202502,5361000,2S2,0,2,-2,0
202502,5361000,2S3,0,2,-2,0
202502,5361000,3,5,10,-5,0.5
202502,5361000,3S2,1,13,-12,0.08
202502,5361000,3S3,9,14,-5,0.64
202502,5361000,4,1,0,1,NA
202502,5361000,CA,2,35,-33,0.06
202502,5361000,V3,4,0,4,NA
202502,5364000,2,29,201,-172,0.14
202502,5364000,3,13,23,-10,0.57
202502,5364000,3S2,8,1,7,8
202502,5364000,3S3,111,57,54,1.95
202502,5364000,CA,0,73,-73,0
202502,5368000,2,19,32,-13,0.59
202502,5368000,2S2,0,24,-24,0
202502,5368000,3,2,5,-3,0.4
202502,5368000,3S3,23,7,16,3.29
202502,5368000,CA,1,42,-41,0.02
202502,5368007,3S3,0,4,-4,0
202502,5376000,2,1438,1670,-232,0.86
202502,5376000,2S2,18,32,-14,0.56
202502,5376000,2S3,9,8,1,1.12
202502,5376000,3,36,51,-15,0.71
202502,5376000,3S1,1,2,-1,0.5
202502,5376000,3S2,9,13,-4,0.69
202502,5376000,3S3,48,183,-135,0.26
202502,5376000,CA,37,400,-363,0.09
202502,5376003,2,0,1,-1,0
202502,5380000,2,10638,2869,7769,3.71
202502,5380000,2B1,1,3,-2,0.33
202502,5380000,2R2,46,0,46,NA
202502,5380000,2S1,0,3,-3,0
202502,5380000,2S2,467,516,-49,0.91
202502,5380000,2S3,55,130,-75,0.42
202502,5380000,3,47,114,-67,0.41
202502,5380000,3S1,1,0,1,NA
202502,5380000,3S2,253,349,-96,0.72
202502,5380000,3S3,478,1087,-609,0.44
202502,5380000,4,1,3,-2,0.33
202502,5380000,CA,5301,1046,4255,5.07
202502,5380000,V3,13,50,-37,0.26
202502,5380001,2,13,35,-22,0.37
202502,5380001,2S2,0,1,-1,0
202502,5380001,2S3,0,20,-20,0
202502,5380001,3S2,1,0,1,NA
202502,5380001,CA,1,5,-4,0.2
202502,5380005,2,127,52,75,2.44
202502,5380005,2S2,4,6,-2,0.67
202502,5380005,2S3,8,3,5,2.67
202502,5380005,3,12,2,10,6
202502,5380005,3S2,5,3,2,1.67
202502,5380005,3S3,36,26,10,1.38
202502,5380005,CA,0,4,-4,0
202502,5380010,3S3,0,3,-3,0
202502,5390000,2,54,50,4,1.08
202502,5390000,2S2,1,0,1,NA
202502,5390000,3,1,5,-4,0.2
202502,5390000,3S2,4,3,1,1.33
202502,5390000,3S3,3,17,-14,0.18
202502,5390000,CA,3,38,-35,0.08
202502,5400000,2,180,308,-128,0.58
202502,5400000,2S2,2,0,2,NA
202502,5400000,2S3,0,2,-2,0
202502,5400000,3,31,13,18,2.38
202502,5400000,3S2,7,2,5,3.5
202502,5400000,3S3,147,91,56,1.62
202502,5400000,4,5,0,5,NA
202502,5400000,CA,5,202,-197,0.02
202502,5400000,V3,164,5,159,32.8
202502,5400000,V4,11,0,11,NA
202502,5400001,2,1,5,-4,0.2
202502,5400001,3,0,1,-1,0
202502,5400002,2,0,6,-6,0
202502,5411000,2,13,28,-15,0.46
202502,5411000,3,4,9,-5,0.44
202502,5411000,3S3,1,0,1,NA
202502,5411000,4,1,1,0,1
202502,5411000,CA,0,11,-11,0
202502,5411000,V2,0,1,-1,0
202502,5411001,2,0,8,-8,0
202502,5411007,2,1,0,1,NA
202502,5411007,CA,0,1,-1,0
202502,5411008,2,0,5,-5,0
202502,5411008,2S2,1,0,1,NA
202502,5411008,3,1,0,1,NA
202502,5411008,3S3,4,3,1,1.33
202502,5425000,2,35,56,-21,0.62
202502,5425000,2S2,0,1,-1,0
202502,5425000,2S3,0,5,-5,0
202502,5425000,3,4,48,-44,0.08
202502,5425000,3S2,2,18,-16,0.11
202502,5425000,3S3,11,4,7,2.75
202502,5425000,4,0,18,-18,0
202502,5425000,CA,2,10,-8,0.2
202502,5425000,V3,0,6,-6,0
202502,5425001,2,0,2,-2,0
202502,5425003,2,1,0,1,NA
202502,5425005,2,6,3,3,2
202502,5425005,3,1,3,-2,0.33
202502,5425005,3S2,1,1,0,1
202502,5425005,3S3,81,2,79,40.5
202502,5425005,CA,0,1,-1,0
202502,5440000,2,1876,1086,790,1.73
202502,5440000,2R2,0,13,-13,0
202502,5440000,2R3,0,2,-2,0
202502,5440000,2S2,2,9,-7,0.22
202502,5440000,2S3,2,12,-10,0.17
202502,5440000,3,52,43,9,1.21
202502,5440000,3S2,33,36,-3,0.92
202502,5440000,3S3,70,736,-666,0.1
202502,5440000,4,0,10,-10,0
202502,5440000,CA,124,381,-257,0.33
202502,5440000,V3,6,26,-20,0.23
202502,5467000,2,5,6,-1,0.83
202502,5467000,2S2,0,6,-6,0
202502,5467000,3,1,3,-2,0.33
202502,5467000,CA,0,14,-14,0
202502,5480000,2,2,74,-72,0.03
202502,5480000,2S2,1,0,1,NA
202502,5480000,3,2,9,-7,0.22
202502,5480000,3S2,1,4,-3,0.25
202502,5480000,3S3,5,44,-39,0.11
202502,5480000,CA,0,16,-16,0
202502,5480004,2,0,3,-3,0
202502,5480006,3,1,1,0,1
202502,5483000,2,1,32,-31,0.03
202502,5483000,3,0,7,-7,0
202502,5483000,3S2,0,3,-3,0
202502,5483000,CA,1,9,-8,0.11
202502,5483001,2,0,2,-2,0
202502,5483012,2,0,2,-2,0
202502,5490000,2,51,273,-222,0.19
202502,5490000,2R2,0,1,-1,0
202502,5490000,2S3,1,1,0,1
202502,5490000,3,4,25,-21,0.16
202502,5490000,3S2,2,4,-2,0.5
202502,5490000,3S3,3,11,-8,0.27
202502,5490000,CA,0,49,-49,0
202502,5490001,2,0,2,-2,0
202502,5490003,2,0,1,-1,0
202502,5490005,2,0,2,-2,0
202502,5495000,2,9,72,-63,0.12
202502,5495000,2B2,0,3,-3,0
202502,5495000,2R2,0,1,-1,0
202502,5495000,2S2,0,2,-2,0
202502,5495000,3,0,7,-7,0
202502,5495000,3S2,1,4,-3,0.25
202502,5495000,3S3,2,11,-9,0.18
202502,5495000,CA,0,7,-7,0
202502,5501000,2,0,2,-2,0
202502,5501000,3S3,0,4,-4,0
202502,5501002,2,0,2,-2,0
202502,5501002,CA,0,1,-1,0
202502,5541000,2,5,74,-69,0.07
202502,5541000,2S2,0,26,-26,0
202502,5541000,3,1,1,0,1
202502,5541000,3S2,0,1,-1,0
202502,5541000,CA,1,36,-35,0.03
202502,5541001,2,5,34,-29,0.15
202502,5541001,3,0,4,-4,0
202502,5541001,3S3,0,2,-2,0
202502,5541001,CA,0,12,-12,0
202502,5543000,2,7,9,-2,0.78
202502,5543000,3,1,2,-1,0.5
202502,5576000,2,14,5,9,2.8
202502,5576000,3,1,1,0,1
202502,5576000,3S3,0,2,-2,0
202502,5576000,CA,0,9,-9,0
202502,5579000,2,79,299,-220,0.26
202502,5579000,2S2,0,1,-1,0
202502,5579000,3,12,84,-72,0.14
202502,5579000,3S2,6,6,0,1
202502,5579000,3S3,167,104,63,1.61
202502,5579000,3S4,1,0,1,NA
202502,5579000,CA,103,106,-3,0.97
202502,5579000,V2,0,1,-1,0
202502,5579000,V3,0,6,-6,0
202502,5579005,2,0,4,-4,0
202502,5585000,2,3,72,-69,0.04
202502,5585000,3,3,6,-3,0.5
202502,5585000,3S2,6,0,6,NA
202502,5585000,3S3,146,13,133,11.23
202502,5585000,4,0,1,-1,0
202502,5585000,CA,2,29,-27,0.07
202502,5585000,V3,1,2,-1,0.5
202502,5585003,2,0,8,-8,0
202502,5585003,3S2,2,0,2,NA
202502,5585003,3S3,64,6,58,10.67
202502,5585003,CA,1,22,-21,0.05
202502,5585003,V3,0,1,-1,0
202502,5585004,2,98,34,64,2.88
202502,5585004,2S2,1,0,1,NA
202502,5585004,3,2,1,1,2
202502,5585004,CA,2,11,-9,0.18
202502,5591000,2,11,114,-103,0.1
202502,5591000,2S2,0,2,-2,0
202502,5591000,2S3,4,1,3,4
202502,5591000,3,20,36,-16,0.56
202502,5591000,3S2,7,14,-7,0.5
202502,5591000,3S3,620,203,417,3.05
202502,5591000,3S4,0,1,-1,0
202502,5591000,CA,3,50,-47,0.06
202502,5591000,V3,0,16,-16,0
202502,5591000,V4,2,4,-2,0.5
202502,5591002,2,0,2,-2,0
202502,5591002,3S3,1,0,1,NA
202502,5591004,2,44,51,-7,0.86
202502,5591004,2S2,1,1,0,1
202502,5591004,2S3,0,2,-2,0
202502,5591004,3,13,12,1,1.08
202502,5591004,3S2,7,1,6,7
202502,5591004,3S3,266,47,219,5.66
202502,5591004,3S4,1,0,1,NA
202502,5591004,4,9,0,9,NA
202502,5591004,CA,13,51,-38,0.25
202502,5591004,V3,2,7,-5,0.29
202502,5591004,V4,0,2,-2,0
202502,5604000,2,17,86,-69,0.2
202502,5604000,2S2,0,1,-1,0
202502,5604000,3,2,95,-93,0.02
202502,5604000,3S2,3,10,-7,0.3
202502,5604000,3S3,8,43,-35,0.19
202502,5604000,CA,1,31,-30,0.03
202502,5604000,V3,0,17,-17,0
202502,5604001,3S2,0,2,-2,0
202502,5604003,2,0,2,-2,0
202502,5604005,3,0,9,-9,0
202502,5604005,3S2,0,20,-20,0
202502,5604005,3S3,0,2,-2,0
202502,5604005,V3,0,1,-1,0
202502,5607000,2,200,532,-332,0.38
202502,5607000,2R2,0,9,-9,0
202502,5607000,2S2,2,0,2,NA
202502,5607000,2S3,0,2,-2,0
202502,5607000,3,10,20,-10,0.5
202502,5607000,3S2,10,4,6,2.5
202502,5607000,3S3,22,57,-35,0.39
202502,5607000,CA,2,215,-213,0.01
202502,5607003,3S3,1,0,1,NA
202502,5607004,2,3,3,0,1
202502,5607004,CA,1,0,1,NA
202502,5607008,2,1,1,0,1
202502,5607008,CA,0,4,-4,0
202502,5615000,2,6802,6886,-84,0.99
202502,5615000,2B1,1,0,1,NA
202502,5615000,2R2,6,7,-1,0.86
202502,5615000,2R3,1,6,-5,0.17
202502,5615000,2S2,570,471,99,1.21
202502,5615000,2S3,209,231,-22,0.9
202502,5615000,3,186,197,-11,0.94
202502,5615000,3S1,1,1,0,1
202502,5615000,3S2,381,505,-124,0.75
202502,5615000,3S3,911,2674,-1763,0.34
202502,5615000,3S4,0,3,-3,0
202502,5615000,4,2,4,-2,0.5
202502,5615000,CA,2385,2435,-50,0.98
202502,5615000,V3,0,9,-9,0
202502,5615001,2,0,1,-1,0
202502,5615010,2,9,15,-6,0.6
202502,5615010,CA,2,11,-9,0.18
202502,5615012,3S3,0,1,-1,0
202502,5628000,2,3,9,-6,0.33
202502,5628000,3,3,3,0,1
202502,5628000,3S3,0,1,-1,0
202502,5628000,CA,0,17,-17,0
202502,5628000,V2,0,2,-2,0
202502,5628001,2,4,2,2,2
202502,5628001,3,0,1,-1,0
202502,5628001,3S3,0,1,-1,0
202502,5628002,2,0,1,-1,0
202502,5628002,V2,0,1,-1,0
202502,5631000,2,4468,2407,2061,1.86
202502,5631000,2R3,0,5,-5,0
202502,5631000,2S1,0,2,-2,0
202502,5631000,2S2,55,100,-45,0.55
202502,5631000,2S3,43,107,-64,0.4
202502,5631000,3,410,293,117,1.4
202502,5631000,3S2,181,330,-149,0.55
202502,5631000,3S3,487,751,-264,0.65
202502,5631000,3S4,1,0,1,NA
202502,5631000,4,6,18,-12,0.33
202502,5631000,CA,2350,864,1486,2.72
202502,5631000,V2,0,11,-11,0
202502,5631000,V3,7,134,-127,0.05
202502,5631000,V4,0,4,-4,0
202502,5631002,3S2,0,1,-1,0
202502,5631008,2,0,1,-1,0
202502,5642000,2,4,36,-32,0.11
202502,5642000,2S2,0,2,-2,0
202502,5642000,3,4,16,-12,0.25
202502,5642000,3S2,1,1,0,1
202502,5642000,3S3,32,54,-22,0.59
202502,5642000,CA,1,16,-15,0.06
202502,5647000,2,5,17,-12,0.29
202502,5647000,3,1,20,-19,0.05
202502,5647000,3S2,0,6,-6,0
202502,5647000,3S3,0,9,-9,0
202502,5647000,4,1,0,1,NA
202502,5647000,CA,0,4,-4,0
202502,5649000,2,6,96,-90,0.06
202502,5649000,2S2,0,11,-11,0
202502,5649000,3,0,15,-15,0
202502,5649000,3S2,0,1,-1,0
202502,5649000,3S3,0,1,-1,0
202502,5649000,CA,0,69,-69,0
202502,5649000,V3,0,7,-7,0
202502,5649001,3S2,1,0,1,NA
202502,5649001,CA,0,9,-9,0
202502,5649012,2,0,3,-3,0
202502,5649012,3S3,1,0,1,NA
202502,5649012,CA,0,1,-1,0
202502,5652000,2,0,5,-5,0
202502,5652000,3,0,6,-6,0
202502,5652000,3S2,2,0,2,NA
202502,5652000,3S3,334,180,154,1.86
202502,5652000,CA,0,3,-3,0
202502,5652000,V3,0,1,-1,0
202502,5652010,2,1,1,0,1
202502,5652010,3,5,0,5,NA
202502,5652010,3S2,7,0,7,NA
202502,5652010,3S3,144,4,140,36
202502,5652010,CA,0,1,-1,0
202502,5652010,V3,6,0,6,NA
202502,5656000,2,12,112,-100,0.11
202502,5656000,2S2,1,1,0,1
202502,5656000,3,2,7,-5,0.29
202502,5656000,3S3,4,7,-3,0.57
202502,5656000,CA,0,50,-50,0
202502,5656000,V2,0,11,-11,0
202502,5658000,2,0,21,-21,0
202502,5658000,3,0,2,-2,0
202502,5658000,3S2,0,2,-2,0
202502,5658000,3S3,0,21,-21,0
202502,5658000,CA,0,2,-2,0
202502,5659000,2,12,44,-32,0.27
202502,5659000,3,4,14,-10,0.29
202502,5659000,3S2,57,0,57,NA
202502,5659000,3S3,13,19,-6,0.68
202502,5659000,CA,0,8,-8,0
202502,5659001,3,1,0,1,NA
202502,5660000,2,9,21,-12,0.43
202502,5660000,2S2,0,10,-10,0
202502,5660000,3,0,9,-9,0
202502,5660000,3S3,0,2,-2,0
202502,5660000,CA,2,63,-61,0.03
202502,5660000,V3,0,6,-6,0
202502,5660006,CA,0,1,-1,0
202502,5660012,2,0,4,-4,0
202502,5660012,2S2,9,9,0,1
202502,5660012,3S3,5,0,5,NA
202502,5660013,2,0,1,-1,0
202502,5660013,CA,0,7,-7,0
202502,5664000,2,144,618,-474,0.23
202502,5664000,2R2,0,3,-3,0
202502,5664000,2S2,0,3,-3,0
202502,5664000,2S3,0,3,-3,0
202502,5664000,3,36,59,-23,0.61
202502,5664000,3S2,169,72,97,2.35
202502,5664000,3S3,399,468,-69,0.85
202502,5664000,CA,4,102,-98,0.04
202502,5664005,2,0,8,-8,0
202502,5664005,3,0,2,-2,0
202502,5664005,3S3,0,15,-15,0
202502,5665000,2,23,119,-96,0.19
202502,5665000,2S2,0,2,-2,0
202502,5665000,3,0,25,-25,0
202502,5665000,3S2,1,3,-2,0.33
202502,5665000,CA,2,13,-11,0.15
202502,5667000,2,5,76,-71,0.07
202502,5667000,2S2,0,12,-12,0
202502,5667000,3,1,1,0,1
202502,5667000,3S3,0,1,-1,0
202502,5667000,CA,1,29,-28,0.03
202502,5670000,2,9,40,-31,0.22
202502,5670000,2S3,0,1,-1,0
202502,5670000,3,1,8,-7,0.12
202502,5670000,3S3,13,0,13,NA
202502,5670000,CA,0,18,-18,0
202502,5670003,2,69,1,68,69
202502,5670003,3,1,0,1,NA
202502,5670003,3S3,1,0,1,NA
202502,5670003,CA,1,0,1,NA
202502,5674000,2,21,122,-101,0.17
202502,5674000,2S2,0,1,-1,0
202502,5674000,3,2,6,-4,0.33
202502,5674000,3S3,0,2,-2,0
202502,5674000,CA,1,42,-41,0.02
202502,5679000,2,13,33,-20,0.39
202502,5679000,2S2,2,0,2,NA
202502,5679000,3S2,7,5,2,1.4
202502,5679000,3S3,6,1,5,6
202502,5679000,CA,1,38,-37,0.03
202502,5679000,V2,0,2,-2,0
202502,5679001,2,0,1,-1,0
202502,5679002,3S4,2,0,2,NA
202502,5679004,2,1,1,0,1
202502,5686000,2,502,754,-252,0.67
202502,5686000,2S2,0,1,-1,0
202502,5686000,2S3,0,2,-2,0
202502,5686000,3,14,97,-83,0.14
202502,5686000,3S2,75,27,48,2.78
202502,5686000,3S3,353,509,-156,0.69
202502,5686000,CA,3,93,-90,0.03
202502,5686000,V3,0,63,-63,0
202502,5686001,2,0,16,-16,0
202502,5686001,3,2,6,-4,0.33
202502,5686004,2,2,2,0,1
202502,5686006,2,0,1,-1,0
202502,5686010,CA,1,0,1,NA
202502,5686011,2,0,4,-4,0
202502,5686011,2R2,0,8,-8,0
202502,5686011,3S3,16,4,12,4
202502,5690000,2,196,81,115,2.42
202502,5690000,3,5,29,-24,0.17
202502,5690000,3S2,1,0,1,NA
202502,5690000,3S3,27,6,21,4.5
202502,5690000,CA,3,8,-5,0.38
202502,5690000,V3,0,1,-1,0
202502,5690001,2,35,4,31,8.75
202502,5690001,CA,0,1,-1,0
202502,5690004,2,0,26,-26,0
202502,5690004,CA,0,1,-1,0
202502,5690005,2,0,1,-1,0
202502,5690010,2,2,4,-2,0.5
202502,5690010,3,0,2,-2,0
202502,5690010,3S3,0,1,-1,0
202502,5690010,CA,0,1,-1,0
202502,5697000,2,62,476,-414,0.13
202502,5697000,2S3,0,2,-2,0
202502,5697000,3,5,35,-30,0.14
202502,5697000,3S2,3,1,2,3
202502,5697000,3S3,53,125,-72,0.42
202502,5697000,CA,3,237,-234,0.01
202502,5697000,V3,0,1,-1,0
202502,5736000,2,13,482,-469,0.03
202502,5736000,2S2,0,2,-2,0
202502,5736000,2S3,0,1,-1,0
202502,5736000,3,0,72,-72,0
202502,5736000,3S2,1,7,-6,0.14
202502,5736000,3S3,13,31,-18,0.42
202502,5736000,4,0,2,-2,0
202502,5736000,CA,0,127,-127,0
202502,5736000,V3,1,15,-14,0.07
202502,5736002,3S2,0,5,-5,0
202502,5736002,3S3,0,4,-4,0
202502,5756000,2,179,260,-81,0.69
202502,5756000,2S2,1,1,0,1
202502,5756000,3,221,24,197,9.21
202502,5756000,3S2,513,6,507,85.5
202502,5756000,3S3,1552,341,1211,4.55
202502,5756000,3S4,0,2,-2,0
202502,5756000,4,1,0,1,NA
202502,5756000,CA,1,91,-90,0.01
202502,5756000,V3,88,6,82,14.67
202502,5756005,2,0,2,-2,0
202502,5756005,CA,1,3,-2,0.33
202502,5756030,2,1,4,-3,0.25
202502,5756030,3,1,0,1,NA
202502,5756030,3S3,9,0,9,NA
202502,5756030,CA,0,1,-1,0
202502,5756030,V3,0,1,-1,0
202502,5756033,2,31,1,30,31
202502,5756033,3,149,4,145,37.25
202502,5756033,3S2,239,6,233,39.83
202502,5756033,3S3,2336,502,1834,4.65
202502,5756033,V3,62,1,61,62
202502,5761000,2,11,52,-41,0.21
202502,5761000,3,5,4,1,1.25
202502,5761000,3S2,0,1,-1,0
202502,5761000,3S3,2,2,0,1
202502,5761000,CA,0,33,-33,0
202502,5761000,V2,0,1,-1,0
202502,5761002,2,1,0,1,NA
202502,5761002,2S2,4,0,4,NA
202502,5761002,2S3,6,5,1,1.2
202502,5789000,2,149,130,19,1.15
202502,5789000,2S2,0,23,-23,0
202502,5789000,3,1,10,-9,0.1
202502,5789000,3S3,3,1,2,3
202502,5789000,CA,2,30,-28,0.07
202502,5789000,V2,0,2,-2,0
202502,5789001,3,0,1,-1,0
202502,5789001,3S3,0,2,-2,0
202502,5789002,2,0,3,-3,0
202502,5790000,2,13,78,-65,0.17
202502,5790000,2B2,0,8,-8,0
202502,5790000,2R2,0,1,-1,0
202502,5790000,3,7,7,0,1
202502,5790000,3S2,2,4,-2,0.5
202502,5790000,3S3,2,11,-9,0.18
202502,5790000,3S4,0,3,-3,0
202502,5790000,CA,5,15,-10,0.33
202502,5790003,2,0,1,-1,0
202502,5790003,2S2,2,0,2,NA
202502,5790003,3S2,2,0,2,NA
202502,5790003,3S3,1,0,1,NA
202502,5792000,2,2,9,-7,0.22
202502,5792000,2S2,0,1,-1,0
202502,5792000,3S2,0,4,-4,0
202502,5792000,3S3,0,5,-5,0
202502,5792000,CA,0,14,-14,0
202502,5809000,2,90,62,28,1.45
202502,5809000,2S2,0,7,-7,0
202502,5809000,3,2,22,-20,0.09
202502,5809000,3S3,189,0,189,NA
202502,5809000,CA,0,28,-28,0
202502,5809000,V2,0,1,-1,0
202502,5809004,2,1,0,1,NA
202502,5819000,2,5,15,-10,0.33
202502,5819000,3,5,13,-8,0.38
202502,5819000,3S2,0,36,-36,0
202502,5819000,3S3,0,20,-20,0
202502,5819000,4,0,4,-4,0
202502,5819000,CA,0,2,-2,0
202502,5819000,V3,0,3,-3,0
202502,5819002,3S2,0,5,-5,0
202502,5837000,2,58,680,-622,0.09
202502,5837000,2B2,0,3,-3,0
202502,5837000,2S2,13,33,-20,0.39
202502,5837000,2S3,1,8,-7,0.12
202502,5837000,3,9,60,-51,0.15
202502,5837000,3S2,56,17,39,3.29
202502,5837000,3S3,67,713,-646,0.09
202502,5837000,3S4,1,0,1,NA
202502,5837000,4,0,1,-1,0
202502,5837000,CA,1,137,-136,0.01
202502,5837001,2,8,17,-9,0.47
202502,5837001,3,0,5,-5,0
202502,5837001,3S3,0,5,-5,0
202502,5837001,CA,0,1,-1,0
202502,5837002,2,1,5,-4,0.2
202502,5837002,2S3,2,2,0,1
202502,5837002,3,0,8,-8,0
202502,5837002,3S2,0,108,-108,0
202502,5837002,3S3,0,119,-119,0
202502,5837003,2,0,1,-1,0
202502,5837008,2,0,2,-2,0
202502,5837008,3S3,0,5,-5,0
202502,5842000,2,1,35,-34,0.03
202502,5842000,3,0,2,-2,0
202502,5842000,3S2,1,0,1,NA
202502,5842000,3S3,1,5,-4,0.2
202502,5842000,CA,0,25,-25,0
202502,5847000,2,77,161,-84,0.48
202502,5847000,3,1,11,-10,0.09
202502,5847000,3S2,4,1,3,4
202502,5847000,3S3,5,48,-43,0.1
202502,5847000,CA,1,73,-72,0.01
202502,5847000,V2,0,1,-1,0
202502,5854000,2,5,12,-7,0.42
202502,5854000,2S3,1,0,1,NA
202502,5854000,3,0,1,-1,0
202502,5854000,3S2,0,3,-3,0
202502,5854000,3S3,1,7,-6,0.14
202502,5854000,CA,0,4,-4,0
202502,5854002,2,3,2,1,1.5
202502,5854002,3,1,1,0,1
202502,5854002,3S2,0,2,-2,0
202502,5854002,3S3,0,1,-1,0
202502,5856000,2,12,26,-14,0.46
202502,5856000,2S2,0,2,-2,0
202502,5856000,2S3,0,1,-1,0
202502,5856000,3,12,7,5,1.71
202502,5856000,3S2,1,2,-1,0.5
202502,5856000,3S3,0,4,-4,0
202502,5856000,CA,0,19,-19,0
202502,5856000,V3,65,0,65,NA
202502,5856000,V4,24,0,24,NA
202502,5858000,2,30,97,-67,0.31
202502,5858000,2S2,0,1,-1,0
202502,5858000,3,3,29,-26,0.1
202502,5858000,3S2,13,45,-32,0.29
202502,5858000,3S3,19,55,-36,0.35
202502,5858000,3S4,1,0,1,NA
202502,5858000,CA,1,33,-32,0.03
202502,5858000,V3,0,2,-2,0
202502,5861000,2,0,49,-49,0
202502,5861000,2S2,0,6,-6,0
202502,5861000,3,0,8,-8,0
202502,5861000,3S3,0,1,-1,0
202502,5861000,3S4,1,1,0,1
202502,5861000,CA,1,40,-39,0.03
202502,5861000,V2,0,2,-2,0
202502,5861002,2,6,12,-6,0.5
202502,5861002,3S2,1,3,-2,0.33
202502,5861002,3S3,13,28,-15,0.46
202502,5861002,3S4,0,1,-1,0
202502,5861002,4,23,0,23,NA
202502,5861002,CA,1,10,-9,0.1
202502,5861002,V2,1,0,1,NA
202502,5873006,2S2,1,0,1,NA
202502,5873006,3S3,0,2,-2,0
202502,5885000,2,1,14,-13,0.07
202502,5885000,2S2,0,5,-5,0
202502,5885000,3,2,9,-7,0.22
202502,5885000,3S3,29,1,28,29
202502,5885000,3S4,1,0,1,NA
202502,5885000,CA,0,2,-2,0
202502,5885000,V3,0,5,-5,0
202502,5887000,2,165,447,-282,0.37
202502,5887000,2S2,0,2,-2,0
202502,5887000,2S3,0,1,-1,0
202502,5887000,3,119,17,102,7
202502,5887000,3S2,69,33,36,2.09
202502,5887000,3S3,313,408,-95,0.77
202502,5887000,4,1,0,1,NA
202502,5887000,CA,8,122,-114,0.07
202502,5887000,V2,1,0,1,NA
202502,5887007,2,31,11,20,2.82
202502,5887007,2R2,0,2,-2,0
202502,5887007,3,2,4,-2,0.5
202502,5887007,3S2,0,1,-1,0
202502,5887007,3S3,8,19,-11,0.42
202502,5887007,4,1,0,1,NA
202502,5887007,CA,0,1,-1,0
202502,5890000,2,175,98,77,1.79
202502,5890000,3,1,36,-35,0.03
202502,5890000,3S3,1,66,-65,0.02
202502,5890000,CA,0,40,-40,0
202502,5890000,V2,0,1,-1,0
202502,5890000,V3,0,12,-12,0
202502,5890001,2,0,1,-1,0
202502,5893000,2,55,106,-51,0.52
202502,5893000,2S2,0,6,-6,0
202502,5893000,2S3,1,9,-8,0.11
202502,5893000,3,1,5,-4,0.2
202502,5893000,3S1,1,0,1,NA
202502,5893000,3S2,3,3,0,1
202502,5893000,3S3,24,39,-15,0.62
202502,5893000,3S3S2,3,2,1,1.5
202502,5893000,3S4,3,1,2,3
202502,5893000,4,1,0,1,NA
202502,5893000,CA,28,61,-33,0.46
202502,5893000,V3,0,5,-5,0
202502,5893001,3S3,0,2,-2,0
202502,5893001,V3,0,4,-4,0
202502,5893003,2,11,0,11,NA
202502,5893003,CA,0,5,-5,0
202502,5893005,2,0,1,-1,0
202502,5895000,2,4,118,-114,0.03
202502,5895000,2B2,0,8,-8,0
202502,5895000,2R2,0,1,-1,0
202502,5895000,2S2,0,1,-1,0
202502,5895000,3,0,10,-10,0
202502,5895000,3S2,2,10,-8,0.2
202502,5895000,3S3,0,71,-71,0
202502,5895000,CA,1,27,-26,0.04
202502,8001000,2,21100,21630,-530,0.98
202502,8001000,2B1,20,19,1,1.05
202502,8001000,2B2,15,5,10,3
202502,8001000,2R2,62,53,9,1.17
202502,8001000,2R3,1,5,-4,0.2
202502,8001000,2S1,31,11,20,2.82
202502,8001000,2S2,982,2182,-1200,0.45
202502,8001000,2S3,684,1496,-812,0.46
202502,8001000,3,619,893,-274,0.69
202502,8001000,3S1,5,9,-4,0.56
202502,8001000,3S2,1584,2387,-803,0.66
202502,8001000,3S2S3,2,0,2,NA
202502,8001000,3S3,16298,14557,1741,1.12
202502,8001000,3S4,16,12,4,1.33
202502,8001000,4,56,8,48,7
202502,8001000,CA,5372,5088,284,1.06
202502,8001000,V2,34,36,-2,0.94
202502,8001000,V3,83,87,-4,0.95
202502,8001000,V4,11,2,9,5.5
202502,8001001,2,248,43,205,5.77
202502,8001001,2S2,7,2,5,3.5
202502,8001001,2S3,61,35,26,1.74
202502,8001001,3,8,2,6,4
202502,8001001,3S2,35,61,-26,0.57
202502,8001001,3S3,110,232,-122,0.47
202502,8001001,CA,1,5,-4,0.2
202502,8001002,2S2,0,1,-1,0
202502,8001002,3,0,1,-1,0
202502,8001002,3S3,0,3,-3,0
202502,8001002,CA,0,2,-2,0
202502,8001004,2,0,11,-11,0
202502,8001004,3,0,1,-1,0
202502,8001004,3S3,1,13,-12,0.08
202502,8001004,CA,0,1,-1,0
202502,8078000,2,1072,433,639,2.48
202502,8078000,2S2,452,8,444,56.5
202502,8078000,2S3,65,7,58,9.29
202502,8078000,3,495,13,482,38.08
202502,8078000,3S1,0,2,-2,0
202502,8078000,3S2,8,11,-3,0.73
202502,8078000,3S3,1169,621,548,1.88
202502,8078000,CA,2,149,-147,0.01
202502,8078000,V2,6,8,-2,0.75
202502,8078000,V3,1,0,1,NA
202502,8078001,2,88,97,-9,0.91
202502,8078001,3,0,7,-7,0
202502,8078001,3S2,1,0,1,NA
202502,8078001,3S3,1,1,0,1
202502,8078001,CA,1,3,-2,0.33
202502,8078002,CA,0,1,-1,0
202502,8078003,2,0,14,-14,0
202502,8137000,2,0,44,-44,0
202502,8137000,3,0,1,-1,0
202502,8137000,CA,3,35,-32,0.09
202502,8137001,2,1,0,1,NA
202502,8141000,2,16,50,-34,0.32
202502,8141000,2S2,11,69,-58,0.16
202502,8141000,2S3,0,5,-5,0
202502,8141000,3,9,5,4,1.8
202502,8141000,3S2,1,1,0,1
202502,8141000,3S3,4,11,-7,0.36
202502,8141000,CA,0,22,-22,0
202502,8141001,2,0,1,-1,0
202502,8141001,CA,0,10,-10,0
202502,8296000,2,8762,2261,6501,3.88
202502,8296000,2B1,1,1,0,1
202502,8296000,2R2,227,10,217,22.7
202502,8296000,2R3,0,2,-2,0
202502,8296000,2S2,220,451,-231,0.49
202502,8296000,2S3,96,188,-92,0.51
202502,8296000,3,297,139,158,2.14
202502,8296000,3S1,3,2,1,1.5
202502,8296000,3S2,235,343,-108,0.69
202502,8296000,3S3,2073,2213,-140,0.94
202502,8296000,3S4,1,2,-1,0.5
202502,8296000,4,2,0,2,NA
202502,8296000,CA,2272,465,1807,4.89
202502,8296000,V2,0,2,-2,0
202502,8296000,V3,0,67,-67,0
202502,8296000,V4,0,3,-3,0
202502,8296001,2,0,36,-36,0
202502,8372000,2,2,148,-146,0.01
202502,8372000,3,0,1,-1,0
202502,8372000,3S2,2,2,0,1
202502,8372000,3S3,3,36,-33,0.08
202502,8372000,3S4,0,35,-35,0
202502,8372000,CA,0,70,-70,0
202502,8372003,3S3,0,1,-1,0
202502,8372004,2,5,8,-3,0.62
202502,8372004,2S2,0,2,-2,0
202502,8372004,3S3,0,1,-1,0
202502,8372004,CA,2,20,-18,0.1
202502,8372006,2,1,0,1,NA
202502,8421000,2,14,247,-233,0.06
202502,8421000,2S2,0,3,-3,0
202502,8421000,2S3,4,1,3,4
202502,8421000,3,0,1,-1,0
202502,8421000,3S2,8,9,-1,0.89
202502,8421000,3S3,175,6,169,29.17
202502,8421000,CA,1,78,-77,0.01
202502,8421000,V3,5,0,5,NA
202502,8421001,2,21,8,13,2.62
202502,8421001,2S2,0,2,-2,0
202502,8421001,3S3,3,4,-1,0.75
202502,8421001,CA,0,1,-1,0
202502,8421003,2S2,0,1,-1,0
202502,8421003,3S2,1,1,0,1
202502,8421005,CA,0,1,-1,0
202502,8433000,2,13683,2055,11628,6.66
202502,8433000,2B1,1,2,-1,0.5
202502,8433000,2R2,4,0,4,NA
202502,8433000,2S2,164,321,-157,0.51
202502,8433000,2S3,144,208,-64,0.69
202502,8433000,3,148,123,25,1.2
202502,8433000,3S1,0,1,-1,0
202502,8433000,3S2,262,290,-28,0.9
202502,8433000,3S3,2866,2250,616,1.27
202502,8433000,3S4,2,2,0,1
202502,8433000,CA,1969,543,1426,3.63
202502,8433000,V3,6,6,0,1
202502,8433001,2,68,150,-82,0.45
202502,8433001,3,1,26,-25,0.04
202502,8433001,3S2,2,4,-2,0.5
202502,8433001,3S3,7,29,-22,0.24
202502,8433001,CA,0,5,-5,0
202502,8433004,3S3,0,9,-9,0
202502,8436000,2,7,69,-62,0.1
202502,8436000,3S2,0,1,-1,0
202502,8436000,CA,0,54,-54,0
202502,8520000,2,60,270,-210,0.22
202502,8520000,2S2,17,93,-76,0.18
202502,8520000,2S3,28,42,-14,0.67
202502,8520000,3,1,2,-1,0.5
202502,8520000,3S2,10,4,6,2.5
202502,8520000,3S3,1471,1176,295,1.25
202502,8520000,3S4,0,2,-2,0
202502,8520000,CA,1,95,-94,0.01
202502,8520000,V2,4,0,4,NA
202502,8520000,V3,46,0,46,NA
202502,8520000,V4,11,0,11,NA
202502,8549000,2,2,23,-21,0.09
202502,8549000,3,0,18,-18,0
202502,8549000,CA,0,42,-42,0
202502,8549002,2,1,4,-3,0.25
202502,8549002,2S2,1,1,0,1
202502,8549002,2S3,0,2,-2,0
202502,8549002,CA,0,1,-1,0
202502,8549003,2S2,1,0,1,NA
202502,8549003,2S3,4,0,4,NA
202502,8549003,3S3,1,1,0,1
202502,8558000,2,28,207,-179,0.14
202502,8558000,3,0,57,-57,0
202502,8558000,3S2,1,0,1,NA
202502,8558000,3S3,1,0,1,NA
202502,8558000,CA,0,22,-22,0
202502,8558001,2,0,11,-11,0
202502,8558001,3,0,8,-8,0
202502,8558001,CA,0,1,-1,0
202502,8560000,2,27,152,-125,0.18
202502,8560000,2S2,2,3,-1,0.67
202502,8560000,2S3,6,62,-56,0.1
202502,8560000,3,11,17,-6,0.65
202502,8560000,3S2,5,12,-7,0.42
202502,8560000,3S3,19,60,-41,0.32
202502,8560000,CA,3,64,-61,0.05
202502,8560002,2,3,0,3,NA
202502,8560002,CA,0,2,-2,0
202502,8560003,2,1,14,-13,0.07
202502,8560003,3,1,1,0,1
202502,8560003,3S2,0,1,-1,0
202502,8560003,CA,1,4,-3,0.25
202502,8560004,2,0,3,-3,0
202502,8560004,3S3,1,1,0,1
202502,8560004,CA,1,0,1,NA
202502,8573000,2,92,1150,-1058,0.08
202502,8573000,2B2,0,2,-2,0
202502,8573000,2S1,0,1,-1,0
202502,8573000,2S2,0,107,-107,0
202502,8573000,2S3,0,11,-11,0
202502,8573000,3,1,83,-82,0.01
202502,8573000,3S2,3,109,-106,0.03
202502,8573000,3S3,14,250,-236,0.06
202502,8573000,3S4,0,2,-2,0
202502,8573000,CA,114,757,-643,0.15
202502,8573000,V2,2,0,2,NA
202502,8573000,V3,11,0,11,NA
202502,8573002,2,1,7,-6,0.14
202502,8573002,CA,1,0,1,NA
202502,8573003,2,0,1,-1,0
202502,8573003,CA,0,1,-1,0
202502,8573007,2,0,2,-2,0
202502,8606000,2,8,57,-49,0.14
202502,8606000,2S2,1,1,0,1
202502,8606000,3,2,2,0,1
202502,8606000,3S2,8,1,7,8
202502,8606000,3S3,11,19,-8,0.58
202502,8606000,CA,0,41,-41,0
202502,8606004,2,0,3,-3,0
202502,8606004,3S3,0,1,-1,0
202502,8634000,2,526,471,55,1.12
202502,8634000,2S2,3,10,-7,0.3
202502,8634000,2S3,20,5,15,4
202502,8634000,3,162,6,156,27
202502,8634000,3S1,1,0,1,NA
202502,8634000,3S2,24,20,4,1.2
202502,8634000,3S3,269,357,-88,0.75
202502,8634000,CA,3,89,-86,0.03
202502,8634000,V2,0,1,-1,0
202502,8634000,V3,2,36,-34,0.06
202502,8638000,2,98,760,-662,0.13
202502,8638000,2S2,0,21,-21,0
202502,8638000,2S3,0,3,-3,0
202502,8638000,3,5,35,-30,0.14
202502,8638000,3S2,4,41,-37,0.1
202502,8638000,3S2S3,1,0,1,NA
202502,8638000,3S3,77,165,-88,0.47
202502,8638000,3S4,0,2,-2,0
202502,8638000,CA,11,227,-216,0.05
202502,8638000,V2,10,2,8,5
202502,8638001,2,0,6,-6,0
202502,8638001,3,1,0,1,NA
202502,8638002,2,15,32,-17,0.47
202502,8638002,3S2,3,0,3,NA
202502,8638002,3S3,1,0,1,NA
202502,8638002,CA,0,3,-3,0
202502,8638004,2,1,4,-3,0.25
202502,8638004,3S2,0,1,-1,0
202502,8638004,3S3,0,1,-1,0
202502,8638004,CA,0,7,-7,0
202502,8638005,2,1,0,1,NA
202502,8638006,2,0,6,-6,0
202502,8638006,2S3,0,3,-3,0
202502,8638010,2,0,1,-1,0
202502,8675000,2,8,34,-26,0.24
202502,8675000,3S3,0,1,-1,0
202502,8675000,CA,0,16,-16,0
202502,8685000,2,31,160,-129,0.19
202502,8685000,2S2,4,0,4,NA
202502,8685000,3,0,23,-23,0
202502,8685000,3S2,1,17,-16,0.06
202502,8685000,3S3,143,27,116,5.3
202502,8685000,CA,3,79,-76,0.04
202502,8685000,V2,2,0,2,NA
202502,8758000,2,4545,3381,1164,1.34
202502,8758000,2B1,3,0,3,NA
202502,8758000,2R2,7,2,5,3.5
202502,8758000,2R3,0,1,-1,0
202502,8758000,2S1,0,15,-15,0
202502,8758000,2S2,39,128,-89,0.3
202502,8758000,2S3,100,145,-45,0.69
202502,8758000,3,152,104,48,1.46
202502,8758000,3S1,1,5,-4,0.2
202502,8758000,3S2,160,273,-113,0.59
202502,8758000,3S3,927,992,-65,0.93
202502,8758000,CA,2687,1010,1677,2.66
202502,8758000,V2,0,63,-63,0
202502,8758000,V3,42,209,-167,0.2
202502,8758000,V4,0,40,-40,0
202502,8770000,2,3,63,-60,0.05
202502,8770000,CA,0,19,-19,0
202502,8770000,V3R3,0,1,-1,0
202502,8832000,2,10,94,-84,0.11
202502,8832000,2S2,10,11,-1,0.91
202502,8832000,2S3,32,13,19,2.46
202502,8832000,3,1,1,0,1
202502,8832000,3S2,4,9,-5,0.44
202502,8832000,3S3,52,70,-18,0.74
202502,8832000,3S4,3,0,3,NA
202502,8832000,CA,3,63,-60,0.05
202502,8832000,V2,0,2,-2,0
202502,8832001,2,1,0,1,NA
202502,8832002,2,0,1,-1,0
202502,8832010,3S3,1,0,1,NA
202502,8849000,2,2,24,-22,0.08
202502,8849000,3S2,0,3,-3,0
202502,8849000,CA,0,26,-26,0
202502,11001000,2,66160,73355,-7195,0.9
202502,11001000,2B1,16,0,16,NA
202502,11001000,2B2,5,6,-1,0.83
202502,11001000,2R2,84,67,17,1.25
202502,11001000,2R3,304,110,194,2.76
202502,11001000,2S1,55,48,7,1.15
202502,11001000,2S2,6363,6738,-375,0.94
202502,11001000,2S3,2864,2371,493,1.21
202502,11001000,3,1197,2769,-1572,0.43
202502,11001000,3R3,18,0,18,NA
202502,11001000,3S1,21,14,7,1.5
202502,11001000,3S2,3619,6959,-3340,0.52
202502,11001000,3S2S3,0,3,-3,0
202502,11001000,3S3,9868,21397,-11529,0.46
202502,11001000,3S4,38,54,-16,0.7
202502,11001000,4,31,107,-76,0.29
202502,11001000,CA,21059,40494,-19435,0.52
202502,11001000,V2,113,90,23,1.26
202502,11001000,V3,387,547,-160,0.71
202502,11001000,V3R3,0,2,-2,0
202502,11001000,V4,28,40,-12,0.7
202502,11001001,2,100,75,25,1.33
202502,11001001,2S2,2,4,-2,0.5
202502,11001001,3S2,0,1,-1,0
202502,11001001,3S3,6,32,-26,0.19
202502,11001002,2,0,6,-6,0
202502,11001005,2,0,3,-3,0
202502,11001005,CA,1,1,0,1
202502,11001005,V2,0,3,-3,0
202502,11001006,2,8,14,-6,0.57
202502,11001006,2S2,3,4,-1,0.75
202502,11001006,2S3,1,0,1,NA
202502,11001006,3,1,1,0,1
202502,11001006,3S3,0,8,-8,0
202502,11001006,CA,2,1,1,2
202502,11001008,2S3,0,1,-1,0
202502,13001000,2,10837,12593,-1756,0.86
202502,13001000,2B1,13,9,4,1.44
202502,13001000,2B2,32,4,28,8
202502,13001000,2R2,54,42,12,1.29
202502,13001000,2R3,2,1,1,2
202502,13001000,2S1,42,19,23,2.21
202502,13001000,2S2,6060,4215,1845,1.44
202502,13001000,2S3,2551,2462,89,1.04
202502,13001000,3,1137,253,884,4.49
202502,13001000,3S1,69,52,17,1.33
202502,13001000,3S2,3863,2669,1194,1.45
202502,13001000,3S3,17126,14772,2354,1.16
202502,13001000,3S4,82,32,50,2.56
202502,13001000,4,33,21,12,1.57
202502,13001000,CA,2111,3331,-1220,0.63
202502,13001000,V2,3,27,-24,0.11
202502,13001000,V3,34,8,26,4.25
202502,13001000,V4,0,2,-2,0
202502,13001001,2,2,2,0,1
202502,13001001,3S3,1,1,0,1
202502,13001001,3S4,1,0,1,NA
202502,13001001,CA,1,0,1,NA
202502,13001002,2,0,1,-1,0
202502,13001002,3,1,1,0,1
202502,13001002,3S2,0,2,-2,0
202502,13001002,3S3,12,2,10,6
202502,13001003,2,9,39,-30,0.23
202502,13001003,2S2,0,2,-2,0
202502,13001003,2S3,0,2,-2,0
202502,13001003,3,0,7,-7,0
202502,13001003,3S2,1,0,1,NA
202502,13001003,3S3,6,4,2,1.5
202502,13001003,CA,5,10,-5,0.5
202502,13001004,2,47,66,-19,0.71
202502,13001004,2S2,3,0,3,NA
202502,13001004,2S3,3,2,1,1.5
202502,13001004,3,2,2,0,1
202502,13001004,3S3,6,12,-6,0.5
202502,13001004,3S4,8,0,8,NA
202502,13001004,CA,2,12,-10,0.17
202502,13001004,V2,6,0,6,NA
202502,13001008,2,0,1,-1,0
202502,13001008,2S3,0,1,-1,0
202502,13001009,2,92,23,69,4
202502,13001009,2B1,3,0,3,NA
202502,13001009,2R2,1,0,1,NA
202502,13001009,2S1,2,0,2,NA
202502,13001009,2S2,134,6,128,22.33
202502,13001009,2S3,11,5,6,2.2
202502,13001009,3,6,0,6,NA
202502,13001009,3S2,22,8,14,2.75
202502,13001009,3S3,98,58,40,1.69
202502,13001009,3S4,4,2,2,2
202502,13001009,CA,1,24,-23,0.04
202502,13001010,2,22,22,0,1
202502,13001010,3,1,3,-2,0.33
202502,13001010,3S2,0,1,-1,0
202502,13001010,3S3,3,2,1,1.5
202502,13001010,CA,2,22,-20,0.09
202502,13001012,2,0,6,-6,0
202502,13001012,3S2,1,1,0,1
202502,13001015,2,0,10,-10,0
202502,13001015,2S2,0,2,-2,0
202502,13001015,3,0,1,-1,0
202502,13001015,3S2,0,2,-2,0
202502,13001015,3S3,3,10,-7,0.3
202502,13001019,2,7,15,-8,0.47
202502,13001019,3,1,1,0,1
202502,13001019,3S3,1,2,-1,0.5
202502,13001019,CA,2,1,1,2
202502,13001020,2,3,7,-4,0.43
202502,13001020,CA,0,9,-9,0
202502,13001025,3S2,4,6,-2,0.67
202502,13001025,3S3,4,6,-2,0.67
202502,13001028,2S3,11,0,11,NA
202502,13001028,3S3,339,0,339,NA
202502,13001029,2,17,120,-103,0.14
202502,13001029,2S2,0,2,-2,0
202502,13001029,3,0,3,-3,0
202502,13001029,3S2,1,19,-18,0.05
202502,13001029,3S3,6,11,-5,0.55
202502,13001029,3S4,1,0,1,NA
202502,13001029,CA,1,5,-4,0.2
202502,13006000,2,13,12,1,1.08
202502,13006000,3,0,8,-8,0
202502,13006000,3S2,1,0,1,NA
202502,13006000,3S3,0,2,-2,0
202502,13006000,CA,0,1,-1,0
202502,13006008,2,0,2,-2,0
202502,13006008,3S4,1,0,1,NA
202502,13006033,3,0,6,-6,0
202502,13030000,2,1,2,-1,0.5
202502,13030000,4,0,1,-1,0
202502,13042000,2,2,24,-22,0.08
202502,13042000,2S3,0,1,-1,0
202502,13042000,3,0,1,-1,0
202502,13042000,3S3,0,10,-10,0
202502,13042000,CA,0,3,-3,0
202502,13052000,2,300,610,-310,0.49
202502,13052000,2R2,0,2,-2,0
202502,13052000,2S2,2,17,-15,0.12
202502,13052000,2S3,3,84,-81,0.04
202502,13052000,3,281,58,223,4.84
202502,13052000,3S2,132,70,62,1.89
202502,13052000,3S3,60,357,-297,0.17
202502,13052000,3S4,3,1,2,3
202502,13052000,CA,523,181,342,2.89
202502,13052000,V2,3,0,3,NA
202502,13052001,2,2,1,1,2
202502,13052001,3S3,1,2,-1,0.5
202502,13052001,3S4,0,2,-2,0
202502,13052002,2,40,40,0,1
202502,13052002,2S2,21,0,21,NA
202502,13052002,2S3,7,0,7,NA
202502,13052002,3,5,4,1,1.25
202502,13052002,3S2,42,0,42,NA
202502,13052002,3S3,26,2,24,13
202502,13052002,CA,9,3,6,3
202502,13052003,2,1,1,0,1
202502,13052003,3,0,2,-2,0
202502,13052003,3S3,1,1,0,1
202502,13052004,2,21,0,21,NA
202502,13052004,2S2,2,0,2,NA
202502,13052004,2S3,11,0,11,NA
202502,13052004,3,0,143,-143,0
202502,13052004,3S2,0,1,-1,0
202502,13052004,3S3,0,2,-2,0
202502,13062000,2,0,29,-29,0
202502,13062000,2S2,0,2,-2,0
202502,13062000,2S3,0,1,-1,0
202502,13062000,3,2,0,2,NA
202502,13062000,3S2,0,3,-3,0
202502,13062000,3S3,0,2,-2,0
202502,13062000,CA,0,35,-35,0
202502,13074000,2,13,6,7,2.17
202502,13074000,2S2,1,0,1,NA
202502,13074000,3,1,13,-12,0.08
202502,13074000,3S2,0,2,-2,0
202502,13074000,CA,0,3,-3,0
202502,13140000,2,10,147,-137,0.07
202502,13140000,3,0,4,-4,0
202502,13140000,3S3,0,5,-5,0
202502,13140000,3S4,1,0,1,NA
202502,13140000,CA,0,114,-114,0
202502,13140004,2,1,2,-1,0.5
202502,13160000,2,3,43,-40,0.07
202502,13160000,2S2,1,4,-3,0.25
202502,13160000,2S3,2,1,1,2
202502,13160000,3,0,6,-6,0
202502,13160000,3S2,1,0,1,NA
202502,13160000,3S2S3,1,0,1,NA
202502,13160000,3S3,14,6,8,2.33
202502,13160000,3S3S2,1,0,1,NA
202502,13160000,CA,1,8,-7,0.12
202502,13160000,V3,0,1,-1,0
202502,13188000,2,5,3,2,1.67
202502,13188000,3,0,8,-8,0
202502,13188000,3S3,5,0,5,NA
202502,13188000,CA,1,2,-1,0.5
202502,13212000,2,4,10,-6,0.4
202502,13212000,3,0,3,-3,0
202502,13212000,3S2,2,1,1,2
202502,13212000,3S3,0,3,-3,0
202502,13212000,CA,0,3,-3,0
202502,13212003,3,0,2,-2,0
202502,13212005,2,0,3,-3,0
202502,13212005,CA,0,1,-1,0
202502,13212009,2,1,1,0,1
202502,13212009,3,0,1,-1,0
202502,13212009,3S3,0,1,-1,0
202502,13222000,2,9,32,-23,0.28
202502,13222000,2S2,5,2,3,2.5
202502,13222000,2S3,2,2,0,1
202502,13222000,3,0,1,-1,0
202502,13222000,3S2,5,4,1,1.25
202502,13222000,3S3,65,71,-6,0.92
202502,13222000,3S4,2,0,2,NA
202502,13222000,CA,1,17,-16,0.06
202502,13244000,2,56,240,-184,0.23
202502,13244000,2S2,0,8,-8,0
202502,13244000,2S3,0,1,-1,0
202502,13244000,3,2,16,-14,0.12
202502,13244000,3S2,0,1,-1,0
202502,13244000,3S3,40,30,10,1.33
202502,13244000,4,0,1,-1,0
202502,13244000,CA,20,108,-88,0.19
202502,13244001,2,0,1,-1,0
202502,13244005,2,0,2,-2,0
202502,13244014,2S3,0,2,-2,0
202502,13244018,2,0,1,-1,0
202502,13248000,2,1,4,-3,0.25
202502,13248000,3S3,2,2,0,1
202502,13268000,2,3,0,3,NA
202502,13300000,2,2,3,-1,0.67
202502,13300000,3,0,13,-13,0
202502,13300000,3S2,1,1,0,1
202502,13300000,3S3,1,20,-19,0.05
202502,13300000,3S4,1,1,0,1
202502,13300004,3,0,1,-1,0
202502,13430000,2,232,780,-548,0.3
202502,13430000,2B2,0,15,-15,0
202502,13430000,2R2,0,7,-7,0
202502,13430000,2S2,4,15,-11,0.27
202502,13430000,2S3,2,10,-8,0.2
202502,13430000,3,76,102,-26,0.75
202502,13430000,3S2,3,12,-9,0.25
202502,13430000,3S3,67,283,-216,0.24
202502,13430000,3S4,0,1,-1,0
202502,13430000,4,0,1,-1,0
202502,13430000,CA,5,125,-120,0.04
202502,13430006,3S2,0,1,-1,0
202502,13430006,3S3,1,0,1,NA
202502,13430011,2,1,0,1,NA
202502,13430017,2,0,4,-4,0
202502,13430017,3S3,0,18,-18,0
202502,13430017,CA,1,13,-12,0.08
202502,13430023,2,0,2,-2,0
202502,13430032,2,2,4,-2,0.5
202502,13430032,CA,2,0,2,NA
202502,13430048,2,0,1,-1,0
202502,13433000,2,69,51,18,1.35
202502,13433000,3,0,11,-11,0
202502,13433000,3S2,1,0,1,NA
202502,13433000,3S3,0,15,-15,0
202502,13433000,CA,0,7,-7,0
202502,13433000,V2,3,0,3,NA
202502,13433003,2,5,8,-3,0.62
202502,13433003,3S2,3,1,2,3
202502,13433003,3S3,1,0,1,NA
202502,13433003,CA,5,1,4,5
202502,13433004,2,0,1,-1,0
202502,13440000,2,9,0,9,NA
202502,13440000,3,0,2,-2,0
202502,13440000,CA,1,1,0,1
202502,13440007,3,0,1,-1,0
202502,13440007,CA,0,1,-1,0
202502,13440021,2,0,1,-1,0
202502,13442000,2,11,157,-146,0.07
202502,13442000,2B2,0,2,-2,0
202502,13442000,2S2,0,1,-1,0
202502,13442000,3,0,8,-8,0
202502,13442000,3S2,1,1,0,1
202502,13442000,3S3,96,58,38,1.66
202502,13442000,CA,3,73,-70,0.04
202502,13442017,CA,0,1,-1,0
202502,13458000,2,0,1,-1,0
202502,13458000,3,0,19,-19,0
202502,13458000,3S2,0,2,-2,0
202502,13458000,3S3,0,3,-3,0
202502,13458000,CA,1,0,1,NA
202502,13468000,2,44,275,-231,0.16
202502,13468000,2R2,0,16,-16,0
202502,13468000,3,7,23,-16,0.3
202502,13468000,3S2,1,1,0,1
202502,13468000,3S3,2,25,-23,0.08
202502,13468000,CA,3,56,-53,0.05
202502,13468023,CA,0,4,-4,0
202502,13468024,2,1,32,-31,0.03
202502,13468024,2S3,0,2,-2,0
202502,13468028,2,0,23,-23,0
202502,13468040,2,0,1,-1,0
202502,13473000,2,18,5,13,3.6
202502,13473000,3,0,2,-2,0
202502,13473000,3S2,3,2,1,1.5
202502,13473000,3S3,1,2,-1,0.5
202502,13473000,CA,0,6,-6,0
202502,13490000,2,2,11,-9,0.18
202502,13490000,3,2,1,1,2
202502,13490000,3S2,0,6,-6,0
202502,13490000,3S3,0,3,-3,0
202502,13549000,2,2,0,2,NA
202502,13549001,2,0,2,-2,0
202502,13549001,3,0,1,-1,0
202502,13549015,2,0,1,-1,0
202502,13580000,2,1,5,-4,0.2
202502,13580000,3,0,5,-5,0
202502,13580000,3S2,3,0,3,NA
202502,13580000,3S3,47,19,28,2.47
202502,13580000,CA,0,1,-1,0
202502,13580000,V3,0,1,-1,0
202502,13580005,2,1,0,1,NA
202502,13580005,CA,0,1,-1,0
202502,13600000,2,2,8,-6,0.25
202502,13600000,3S2,0,1,-1,0
202502,13600000,3S3,2,9,-7,0.22
202502,13600000,CA,0,4,-4,0
202502,13600001,2,1,4,-3,0.25
202502,13600001,3,0,6,-6,0
202502,13600001,3S3,5,0,5,NA
202502,13600001,CA,0,2,-2,0
202502,13600001,V3,0,2,-2,0
202502,13620000,2,2,6,-4,0.33
202502,13620000,CA,1,2,-1,0.5
202502,13647000,2,4,19,-15,0.21
202502,13647000,3S2,1,0,1,NA
202502,13647000,3S3,1,0,1,NA
202502,13647000,CA,0,7,-7,0
202502,13647002,3S2,1,1,0,1
202502,13647002,3S3,0,1,-1,0
202502,13650000,2,12,2,10,6
202502,13650000,2S2,3,0,3,NA
202502,13650000,3S2,2,0,2,NA
202502,13650000,CA,0,2,-2,0
202502,13650005,2,0,2,-2,0
202502,13650005,3S3,2,0,2,NA
202502,13654000,2,6,44,-38,0.14
202502,13654000,3S1,1,0,1,NA
202502,13654000,3S2,1,0,1,NA
202502,13654000,3S3,3,14,-11,0.21
202502,13654000,CA,2,4,-2,0.5
202502,13655000,2,1,0,1,NA
202502,13655000,3,0,14,-14,0
202502,13657000,2,15,105,-90,0.14
202502,13657000,2B2,0,1,-1,0
202502,13657000,2S2,2,2,0,1
202502,13657000,2S3,0,1,-1,0
202502,13657000,3,0,4,-4,0
202502,13657000,3S2,0,1,-1,0
202502,13657000,3S3,0,47,-47,0
202502,13657000,4,0,1,-1,0
202502,13657000,CA,1,14,-13,0.07
202502,13657003,3S3,1,0,1,NA
202502,13657005,2,0,1,-1,0
202502,13657005,3,0,1,-1,0
202502,13667000,2,8,37,-29,0.22
202502,13667000,3,3,25,-22,0.12
202502,13667002,3,0,1,-1,0
202502,13670000,2,12,112,-100,0.11
202502,13670000,3,2,26,-24,0.08
202502,13670000,3S2,1,1,0,1
202502,13670000,3S3,84,51,33,1.65
202502,13670000,CA,0,11,-11,0
202502,13670000,V3,0,2,-2,0
202502,13670004,2,0,1,-1,0
202502,13673000,2,68,89,-21,0.76
202502,13673000,2S2,11,2,9,5.5
202502,13673000,2S3,10,2,8,5
202502,13673000,3,0,1,-1,0
202502,13673000,3S2,1,0,1,NA
202502,13673000,3S3,3,1,2,3
202502,13673000,CA,1,22,-21,0.05
202502,13673003,2,4,7,-3,0.57
202502,13673003,3S3,6,0,6,NA
202502,13673003,CA,7,10,-3,0.7
202502,13673005,2,1,3,-2,0.33
202502,13673005,3S3,0,1,-1,0
202502,13683000,2,35,238,-203,0.15
202502,13683000,2R2,0,2,-2,0
202502,13683000,3,2,2,0,1
202502,13683000,3S3,5,3,2,1.67
202502,13683000,CA,2,14,-12,0.14
202502,13683000,V2,3,0,3,NA
202502,13688000,2,13,265,-252,0.05
202502,13688000,3,0,40,-40,0
202502,13688000,3S2,0,4,-4,0
202502,13688000,3S3,1,91,-90,0.01
202502,13688000,CA,23,52,-29,0.44
202502,13688000,V2,0,2,-2,0
202502,13688000,V3,0,9,-9,0
202502,13688007,3,0,2,-2,0
202502,13744000,2,3,14,-11,0.21
202502,13744000,3,0,2,-2,0
202502,13744000,3S3,0,8,-8,0
202502,13744000,CA,0,1,-1,0
202502,13744000,V3,0,1,-1,0
202502,13744007,V3,0,1,-1,0
202502,13760000,2,2,10,-8,0.2
202502,13760000,CA,16,30,-14,0.53
202502,13760000,V2,1,0,1,NA
202502,13780000,2,4,15,-11,0.27
202502,13780000,3,0,2,-2,0
202502,13780000,3S2,0,1,-1,0
202502,13780000,3S3,0,6,-6,0
202502,13780023,CA,0,1,-1,0
202502,13810000,2,1,2,-1,0.5
202502,13810000,3,0,8,-8,0
202502,13810000,3S2,0,1,-1,0
202502,13810011,3,0,4,-4,0
202502,13836000,2,322,1246,-924,0.26
202502,13836000,2S1,1,0,1,NA
202502,13836000,2S2,70,40,30,1.75
202502,13836000,2S3,36,92,-56,0.39
202502,13836000,3,10,75,-65,0.13
202502,13836000,3S2,215,147,68,1.46
202502,13836000,3S3,613,542,71,1.13
202502,13836000,3S4,2,3,-1,0.67
202502,13836000,4,0,1,-1,0
202502,13836000,CA,26,410,-384,0.06
202502,13836000,V2,9,0,9,NA
202502,13836000,V3,1,0,1,NA
202502,13836003,3,1,0,1,NA
202502,13836003,3S3,0,11,-11,0
202502,13838000,2,113,119,-6,0.95
202502,13838000,2R2,0,2,-2,0
202502,13838000,2S2,101,9,92,11.22
202502,13838000,2S3,37,12,25,3.08
202502,13838000,3,3,1,2,3
202502,13838000,3S2,342,233,109,1.47
202502,13838000,3S3,146,78,68,1.87
202502,13838000,3S4,3,8,-5,0.38
202502,13838000,CA,14,20,-6,0.7
202502,13838001,2,8,9,-1,0.89
202502,13838001,3,2,1,1,2
202502,13873000,2,7,37,-30,0.19
202502,13873000,2S2,0,2,-2,0
202502,13873000,3S3,2,3,-1,0.67
202502,13873000,CA,1,28,-27,0.04
202502,13873000,V2,1,0,1,NA
202502,13873001,CA,0,1,-1,0
202502,13873002,2,0,1,-1,0
202502,13894000,2,35,62,-27,0.56
202502,13894000,3S3,43,11,32,3.91
202502,13894000,CA,1,5,-4,0.2
202502,15001000,2,1368,3039,-1671,0.45
202502,15001000,2R2,0,7,-7,0
202502,15001000,2R3,0,10,-10,0
202502,15001000,2S2,16,108,-92,0.15
202502,15001000,2S3,5,27,-22,0.19
202502,15001000,3,12,170,-158,0.07
202502,15001000,3S2,100,187,-87,0.53
202502,15001000,3S3,319,828,-509,0.39
202502,15001000,CA,1062,1237,-175,0.86
202502,15001000,V2,3,1,2,3
202502,15001000,V3,0,253,-253,0
202502,15001007,2,0,10,-10,0
202502,15001007,2S2,0,3,-3,0
202502,15001007,2S3,0,4,-4,0
202502,15001007,3,0,1,-1,0
202502,15001007,3S3,0,1,-1,0
202502,15022000,2,0,2,-2,0
202502,15047000,2,2,25,-23,0.08
202502,15047000,3S2,0,1,-1,0
202502,15047000,3S3,1,5,-4,0.2
202502,15047000,CA,20,45,-25,0.44
202502,15047007,3S2,1,1,0,1
202502,15047010,2,0,14,-14,0
202502,15051000,2,1,32,-31,0.03
202502,15051000,3,1,0,1,NA
202502,15051000,3S2,0,2,-2,0
202502,15051000,3S3,9,1,8,9
202502,15051000,4,30,0,30,NA
202502,15051000,CA,0,8,-8,0
202502,15051000,V3,105,0,105,NA
202502,15051000,V4,185,0,185,NA
202502,15087000,2,8,51,-43,0.16
202502,15087000,3,1,0,1,NA
202502,15087000,3S2,22,0,22,NA
202502,15087000,3S3,0,18,-18,0
202502,15087000,3S4,1,0,1,NA
202502,15087000,CA,0,14,-14,0
202502,15090000,2,0,1,-1,0
202502,15092000,CA,0,2,-2,0
202502,15097000,2,0,13,-13,0
202502,15097000,CA,0,1,-1,0
202502,15104000,2,2,36,-34,0.06
202502,15104000,3,1,0,1,NA
202502,15104000,3S2,1,0,1,NA
202502,15104000,3S3,29,7,22,4.14
202502,15104000,4,1,0,1,NA
202502,15104000,CA,0,14,-14,0
202502,15106000,2,1,4,-3,0.25
202502,15106000,3,1,1,0,1
202502,15106000,3S3,5,0,5,NA
202502,15106000,CA,0,3,-3,0
202502,15109000,2,0,7,-7,0
202502,15109000,CA,0,2,-2,0
202502,15109001,2,0,3,-3,0
202502,15109001,CA,0,2,-2,0
202502,15109002,2,0,4,-4,0
202502,15109002,3,0,1,-1,0
202502,15131000,2,0,3,-3,0
202502,15131000,3S3,0,1,-1,0
202502,15131000,CA,0,2,-2,0
202502,15135000,2,0,7,-7,0
202502,15135000,CA,0,3,-3,0
202502,15162000,2,6,6,0,1
202502,15162000,CA,0,1,-1,0
202502,15172000,2,0,9,-9,0
202502,15172000,CA,0,1,-1,0
202502,15176000,2,52,710,-658,0.07
202502,15176000,2S3,0,2,-2,0
202502,15176000,3,1,13,-12,0.08
202502,15176000,3S2,0,5,-5,0
202502,15176000,3S3,120,294,-174,0.41
202502,15176000,CA,14,304,-290,0.05
202502,15176000,V2,0,2,-2,0
202502,15180000,2,0,9,-9,0
202502,15180000,CA,0,6,-6,0
202502,15183000,2,0,9,-9,0
202502,15183000,CA,0,24,-24,0
202502,15185000,2,0,10,-10,0
202502,15185000,3S2,2,0,2,NA
202502,15185000,3S3,4,2,2,2
202502,15185000,CA,0,5,-5,0
202502,15185000,V2,0,3,-3,0
202502,15187000,2,1,6,-5,0.17
202502,15187000,CA,0,5,-5,0
202502,15189000,2,5,2,3,2.5
202502,15189000,3S3,0,1,-1,0
202502,15189000,CA,0,4,-4,0
202502,15204000,2,1,27,-26,0.04
202502,15204000,2S2,0,1,-1,0
202502,15204000,3S2,0,1,-1,0
202502,15204000,3S3,0,2,-2,0
202502,15204000,CA,0,15,-15,0
202502,15212000,2,0,5,-5,0
202502,15215000,2,1,2,-1,0.5
202502,15215000,2S2,0,1,-1,0
202502,15215000,3,1,2,-1,0.5
202502,15215000,3S2,1,0,1,NA
202502,15215000,3S3,185,1,184,185
202502,15215000,V3,1,1,0,1
202502,15218000,3S3,20,0,20,NA
202502,15223000,2,1,13,-12,0.08
202502,15224000,2,0,2,-2,0
202502,15224000,3,0,1,-1,0
202502,15224000,CA,0,3,-3,0
202502,15226000,2,0,1,-1,0
202502,15226000,CA,0,1,-1,0
202502,15232000,CA,0,2,-2,0
202502,15236000,2,0,4,-4,0
202502,15236000,3,0,3,-3,0
202502,15236000,CA,0,1,-1,0
202502,15238000,2,1238,1639,-401,0.76
202502,15238000,2R2,0,11,-11,0
202502,15238000,2R3,0,17,-17,0
202502,15238000,2S2,7,40,-33,0.17
202502,15238000,2S3,1,21,-20,0.05
202502,15238000,3,93,61,32,1.52
202502,15238000,3S1,0,1,-1,0
202502,15238000,3S2,30,99,-69,0.3
202502,15238000,3S3,523,694,-171,0.75
202502,15238000,3S4,1,1,0,1
202502,15238000,4,0,1,-1,0
202502,15238000,CA,531,576,-45,0.92
202502,15238000,V2,6,0,6,NA
202502,15238000,V3,0,2,-2,0
202502,15238002,2,0,1,-1,0
202502,15238011,2,0,28,-28,0
202502,15238012,3,0,1,-1,0
202502,15238012,3S2,0,1,-1,0
202502,15238012,3S3,0,1,-1,0
202502,15244000,2,1,16,-15,0.06
202502,15244000,3S2,0,1,-1,0
202502,15244000,CA,0,3,-3,0
202502,15248000,2,0,3,-3,0
202502,15248000,CA,13,15,-2,0.87
202502,15248004,2,0,2,-2,0
202502,15272000,2,0,5,-5,0
202502,15272000,3S2,0,2,-2,0
202502,15272000,3S3,0,1,-1,0
202502,15272000,CA,0,5,-5,0
202502,15276000,2,0,2,-2,0
202502,15293000,2,0,5,-5,0
202502,15293000,CA,0,3,-3,0
202502,15296000,2,0,6,-6,0
202502,15296000,3,1,0,1,NA
202502,15296000,3S3,1,0,1,NA
202502,15296000,CA,0,2,-2,0
202502,15299000,2,37,186,-149,0.2
202502,15299000,2S2,1,0,1,NA
202502,15299000,3,1,10,-9,0.1
202502,15299000,CA,22,54,-32,0.41
202502,15299000,V3,0,1,-1,0
202502,15317000,2,0,2,-2,0
202502,15322000,2,15,150,-135,0.1
202502,15322000,2R3,0,1,-1,0
202502,15322000,3,2,9,-7,0.22
202502,15322000,CA,2,15,-13,0.13
202502,15322008,2,0,7,-7,0
202502,15322008,2S2,0,1,-1,0
202502,15322008,3,0,5,-5,0
202502,15322008,CA,0,6,-6,0
202502,15325000,2,0,14,-14,0
202502,15325000,CA,0,1,-1,0
202502,15332000,2,1,6,-5,0.17
202502,15332005,3S3,0,1,-1,0
202502,15362000,2,0,11,-11,0
202502,15362000,3S3,0,1,-1,0
202502,15362000,CA,0,4,-4,0
202502,15367000,2,1,4,-3,0.25
202502,15367000,3S2,1,2,-1,0.5
202502,15367000,3S3,1,4,-3,0.25
202502,15367000,CA,0,1,-1,0
202502,15368000,2,0,2,-2,0
202502,15377000,2,0,5,-5,0
202502,15377000,3S2,1,2,-1,0.5
202502,15377000,3S3,0,5,-5,0
202502,15377000,CA,0,1,-1,0
202502,15380000,2,0,54,-54,0
202502,15380000,CA,0,1,-1,0
202502,15401000,2,0,4,-4,0
202502,15401000,CA,0,1,-1,0
202502,15403000,2,0,6,-6,0
202502,15407000,2,18,264,-246,0.07
202502,15407000,3,4,24,-20,0.17
202502,15407000,3S2,0,1,-1,0
202502,15407000,3S3,0,21,-21,0
202502,15407000,CA,3,100,-97,0.03
202502,15425000,2,2,5,-3,0.4
202502,15442000,2,0,2,-2,0
202502,15442000,CA,1,0,1,NA
202502,15442001,2,8,0,8,NA
202502,15442002,CA,1,0,1,NA
202502,15455000,2,2,29,-27,0.07
202502,15455000,3,0,1,-1,0
202502,15455000,3S3,3,1,2,3
202502,15455000,CA,21,62,-41,0.34
202502,15464000,2,6,7,-1,0.86
202502,15464000,CA,0,6,-6,0
202502,15466000,2,0,24,-24,0
202502,15466000,CA,0,9,-9,0
202502,15469000,2,3,160,-157,0.02
202502,15469000,2S3,0,1,-1,0
202502,15469000,3,2,4,-2,0.5
202502,15469000,3S2,7,4,3,1.75
202502,15469000,3S3,4,8,-4,0.5
202502,15469000,CA,1,45,-44,0.02
202502,15469000,V3,0,1,-1,0
202502,15469000,V4,2,0,2,NA
202502,15476000,2,2,10,-8,0.2
202502,15476000,CA,0,2,-2,0
202502,15480000,2,0,18,-18,0
202502,15480000,CA,0,4,-4,0
202502,15491000,2,540,173,367,3.12
202502,15491000,2S3,1,2,-1,0.5
202502,15491000,3,122,3,119,40.67
202502,15491000,3S2,123,35,88,3.51
202502,15491000,3S3,4008,1324,2684,3.03
202502,15491000,3S4,2,1,1,2
202502,15491000,4,1,0,1,NA
202502,15491000,CA,3,20,-17,0.15
202502,15491000,V2,0,5,-5,0
202502,15491000,V3,7,40,-33,0.17
202502,15491000,V4,46,0,46,NA
202502,15491000,V4R2,5,0,5,NA
202502,15491001,2,233,76,157,3.07
202502,15491001,2S3,2,2,0,1
202502,15491001,3,1,3,-2,0.33
202502,15491001,3S2,0,5,-5,0
202502,15491001,3S3,370,516,-146,0.72
202502,15491001,3S4,0,2,-2,0
202502,15491001,CA,0,5,-5,0
202502,15491002,2,1,0,1,NA
202502,15491004,2,0,1,-1,0
202502,15491004,3S3,0,1,-1,0
202502,15491006,2,0,15,-15,0
202502,15491007,2,0,1,-1,0
202502,15491007,3S2,0,1,-1,0
202502,15491007,3S3,0,6,-6,0
202502,15494000,2,0,19,-19,0
202502,15494000,CA,0,4,-4,0
202502,15500000,2,24,7,17,3.43
202502,15500000,3,16,0,16,NA
202502,15500000,3S2,0,1,-1,0
202502,15500000,3S3,6,113,-107,0.05
202502,15500000,CA,0,2,-2,0
202502,15507000,2,0,36,-36,0
202502,15507000,3S2,0,1,-1,0
202502,15507000,3S3,2,3,-1,0.67
202502,15507000,CA,2,10,-8,0.2
202502,15507000,V2,2,0,2,NA
202502,15507000,V3,9,0,9,NA
202502,15511000,2,0,1,-1,0
202502,15514000,2,2,7,-5,0.29
202502,15514000,3S2,1,1,0,1
202502,15514000,3S3,1,6,-5,0.17
202502,15514000,CA,8,11,-3,0.73
202502,15516000,2,42,209,-167,0.2
202502,15516000,2R3,0,2,-2,0
202502,15516000,3,0,7,-7,0
202502,15516000,3S2,25,6,19,4.17
202502,15516000,3S3,118,36,82,3.28
202502,15516000,CA,29,169,-140,0.17
202502,15516000,V3,3,43,-40,0.07
202502,15516000,V3R2,0,1,-1,0
202502,15516000,V4R2,0,3,-3,0
202502,15516006,2,0,1,-1,0
202502,15518000,2,1,6,-5,0.17
202502,15518000,2S2,4,1,3,4
202502,15518000,3S2,3,2,1,1.5
202502,15518000,3S3,3,6,-3,0.5
202502,15518000,CA,0,3,-3,0
202502,15518000,V3,0,2,-2,0
202502,15518001,2,0,7,-7,0
202502,15522000,2,0,5,-5,0
202502,15531000,2,1,7,-6,0.14
202502,15531000,3S2,1,0,1,NA
202502,15531000,CA,0,4,-4,0
202502,15533000,2,0,1,-1,0
202502,15533000,3S3,0,1,-1,0
202502,15533000,CA,0,1,-1,0
202502,15533001,2,0,1,-1,0
202502,15533001,V2,0,5,-5,0
202502,15537000,2,3,53,-50,0.06
202502,15537000,3,0,22,-22,0
202502,15537000,3S2,1,3,-2,0.33
202502,15537000,3S3,591,12,579,49.25
202502,15537000,CA,0,7,-7,0
202502,15537000,V2,3,0,3,NA
202502,15537000,V3,34,38,-4,0.89
202502,15537000,V4,29,0,29,NA
202502,15537001,3S3,3,0,3,NA
202502,15542000,2,1,7,-6,0.14
202502,15542000,3,1,1,0,1
202502,15542000,3S2,0,2,-2,0
202502,15542000,3S3,30,12,18,2.5
202502,15542000,CA,0,12,-12,0
202502,15550000,2,0,4,-4,0
202502,15550000,CA,0,1,-1,0
202502,15572000,2,90,778,-688,0.12
202502,15572000,2R2,0,15,-15,0
202502,15572000,2S2,1,4,-3,0.25
202502,15572000,2S3,2,6,-4,0.33
202502,15572000,3,13,38,-25,0.34
202502,15572000,3S2,10,220,-210,0.05
202502,15572000,3S3,59,736,-677,0.08
202502,15572000,3S4,2,2,0,1
202502,15572000,CA,10,192,-182,0.05
202502,15572000,V2,16,10,6,1.6
202502,15572000,V3,82,35,47,2.34
202502,15572006,3S2,0,1,-1,0
202502,15572007,2,0,3,-3,0
202502,15572007,3S3,0,4,-4,0
202502,15572012,2,1,0,1,NA
202502,15572012,3S2,0,1,-1,0
202502,15572014,3S2,0,84,-84,0
202502,15572014,3S3,1,166,-165,0.01
202502,15580000,2,0,3,-3,0
202502,15580000,CA,0,4,-4,0
202502,15599000,2,0,24,-24,0
202502,15599000,2R3,0,1,-1,0
202502,15599000,3S3,1,9,-8,0.11
202502,15599000,CA,0,3,-3,0
202502,15600000,2,0,18,-18,0
202502,15600000,3,0,1,-1,0
202502,15600000,3S3,6,2,4,3
202502,15600000,CA,25,42,-17,0.6
202502,15600000,V3,43,0,43,NA
202502,15600000,V4,113,0,113,NA
202502,15621000,2,0,6,-6,0
202502,15621000,3S3,0,1,-1,0
202502,15632000,2,0,9,-9,0
202502,15632000,3S3,5,0,5,NA
202502,15632000,CA,0,6,-6,0
202502,15638000,2,2,19,-17,0.11
202502,15638000,3S2,1,1,0,1
202502,15638000,3S3,0,1,-1,0
202502,15638000,CA,0,5,-5,0
202502,15646000,2,0,118,-118,0
202502,15646000,2S3,0,2,-2,0
202502,15646000,3,2,1,1,2
202502,15646000,3S2,10,6,4,1.67
202502,15646000,3S3,2354,233,2121,10.1
202502,15646000,3S4,1,2,-1,0.5
202502,15646000,4,12,18,-6,0.67
202502,15646000,CA,1,16,-15,0.06
202502,15646000,V2,0,40,-40,0
202502,15646000,V2R3,0,2,-2,0
202502,15646000,V3,287,367,-80,0.78
202502,15646000,V3R2,1,11,-10,0.09
202502,15646000,V4,84,217,-133,0.39
202502,15646000,V4R2,17,62,-45,0.27
202502,15660000,CA,0,20,-20,0
202502,15664000,2,0,24,-24,0
202502,15664000,3S3,0,1,-1,0
202502,15664000,CA,0,5,-5,0
202502,15667000,2,1,20,-19,0.05
202502,15667000,3S2,0,3,-3,0
202502,15667000,CA,23,26,-3,0.88
202502,15667002,2,0,1,-1,0
202502,15673000,2,1,4,-3,0.25
202502,15673000,CA,0,1,-1,0
202502,15673000,V3R2,8,0,8,NA
202502,15673000,V4R2,14,0,14,NA
202502,15676000,2,1,26,-25,0.04
202502,15681000,2,1,0,1,NA
202502,15681000,CA,0,2,-2,0
202502,15686000,2,28,97,-69,0.29
202502,15686000,3,0,8,-8,0
202502,15686000,3S3,1,19,-18,0.05
202502,15686000,CA,0,10,-10,0
202502,15686000,V2,0,1,-1,0
202502,15690000,2,16,24,-8,0.67
202502,15690000,3,1,6,-5,0.17
202502,15690000,3S3,1,0,1,NA
202502,15690000,CA,0,3,-3,0
202502,15693000,2,5,37,-32,0.14
202502,15693000,3,0,2,-2,0
202502,15693000,3S3,0,1,-1,0
202502,15693000,CA,0,11,-11,0
202502,15696000,2,0,12,-12,0
202502,15696000,CA,0,13,-13,0
202502,15720000,2,1,3,-2,0.33
202502,15720000,CA,0,2,-2,0
202502,15723000,2,0,1,-1,0
202502,15723000,CA,0,1,-1,0
202502,15740000,2,0,9,-9,0
202502,15740000,3S3,0,5,-5,0
202502,15740000,CA,0,7,-7,0
202502,15753000,2,8,62,-54,0.13
202502,15753000,2R3,0,1,-1,0
202502,15753000,3S2,1,1,0,1
202502,15753000,3S3,0,13,-13,0
202502,15753000,CA,40,71,-31,0.56
202502,15755000,2,0,19,-19,0
202502,15755000,3S3,2,1,1,2
202502,15755000,CA,0,2,-2,0
202502,15755000,V3R2,48,0,48,NA
202502,15757000,2,25,53,-28,0.47
202502,15757000,3,18,2,16,9
202502,15757000,3S2,9,1,8,9
202502,15757000,3S3,749,2,747,374.5
202502,15757000,4,6,0,6,NA
202502,15757000,CA,1,21,-20,0.05
202502,15757000,V2,14,13,1,1.08
202502,15757000,V2R3,2,0,2,NA
202502,15757000,V3,120,33,87,3.64
202502,15757000,V3R2,3,47,-44,0.06
202502,15757000,V4,88,10,78,8.8
202502,15757000,V4R2,31,0,31,NA
202502,15757003,3S3,62,0,62,NA
202502,15759000,2,494,2461,-1967,0.2
202502,15759000,2R2,0,9,-9,0
202502,15759000,2R3,0,6,-6,0
202502,15759000,2S2,45,10,35,4.5
202502,15759000,2S3,2,8,-6,0.25
202502,15759000,3,157,100,57,1.57
202502,15759000,3S2,323,85,238,3.8
202502,15759000,3S3,2076,815,1261,2.55
202502,15759000,3S4,0,1,-1,0
202502,15759000,4,0,3,-3,0
202502,15759000,CA,47,826,-779,0.06
202502,15759000,V2,23,9,14,2.56
202502,15759000,V3,19,22,-3,0.86
202502,15759000,V4,7,22,-15,0.32
202502,15761000,2,0,21,-21,0
202502,15761000,CA,0,1,-1,0
202502,15762000,2,0,3,-3,0
202502,15762000,3S3,0,1,-1,0
202502,15762000,CA,0,3,-3,0
202502,15763000,2,13,19,-6,0.68
202502,15763000,2S1,0,1,-1,0
202502,15763000,2S2,0,1,-1,0
202502,15763000,2S3,0,4,-4,0
202502,15763000,3,0,6,-6,0
202502,15763000,3S2,2,28,-26,0.07
202502,15763000,3S3,0,34,-34,0
202502,15763000,CA,3,14,-11,0.21
202502,15764000,2,5,66,-61,0.08
202502,15764000,2R3,0,1,-1,0
202502,15764000,3,0,1,-1,0
202502,15764000,3S2,1,1,0,1
202502,15764000,3S3,2,19,-17,0.11
202502,15764000,CA,3,12,-9,0.25
202502,15774000,2,0,2,-2,0
202502,15774000,CA,0,1,-1,0
202502,15776000,2,8,41,-33,0.2
202502,15776000,2S3,0,1,-1,0
202502,15776000,3S3,0,2,-2,0
202502,15776000,CA,1,9,-8,0.11
202502,15778000,2,0,6,-6,0
202502,15778000,CA,1,1,0,1
202502,15790000,2,0,11,-11,0
202502,15790000,3,0,3,-3,0
202502,15790000,3S2,1,0,1,NA
202502,15790000,3S3,290,0,290,NA
202502,15790000,CA,0,12,-12,0
202502,15790000,V2,14,1,13,14
202502,15790000,V3,33,1,32,33
202502,15790000,V4,34,0,34,NA
202502,15798000,2,0,3,-3,0
202502,15798000,CA,0,8,-8,0
202502,15804000,2,0,16,-16,0
202502,15804000,2S3,0,1,-1,0
202502,15804000,3,0,1,-1,0
202502,15804000,3S3,0,1,-1,0
202502,15804000,CA,0,13,-13,0
202502,15804003,2,0,1,-1,0
202502,15806000,2,15,175,-160,0.09
202502,15806000,2R3,0,1,-1,0
202502,15806000,2S2,37,260,-223,0.14
202502,15806000,2S3,15,46,-31,0.33
202502,15806000,3,6,4,2,1.5
202502,15806000,3S1,0,2,-2,0
202502,15806000,3S2,0,3,-3,0
202502,15806000,3S3,1617,1125,492,1.44
202502,15806000,CA,13,56,-43,0.23
202502,15808000,2,9,6,3,1.5
202502,15808000,CA,0,22,-22,0
202502,15810000,2,0,2,-2,0
202502,15810000,2S3,0,1,-1,0
202502,15814000,2,9,41,-32,0.22
202502,15814000,3S3,0,23,-23,0
202502,15814000,CA,12,9,3,1.33
202502,15816000,2,3,5,-2,0.6
202502,15816000,CA,0,4,-4,0
202502,15820000,3S2,3,0,3,NA
202502,15820000,3S3,224,0,224,NA
202502,15820000,CA,0,1,-1,0
202502,15820000,V3,6,0,6,NA
202502,15822000,2,1,2,-1,0.5
202502,15822000,CA,0,4,-4,0
202502,15832000,2,0,1,-1,0
202502,15835000,2,0,13,-13,0
202502,15835000,3,0,1,-1,0
202502,15835000,3S3,0,10,-10,0
202502,15835000,CA,0,5,-5,0
202502,15837000,2,280,508,-228,0.55
202502,15837000,2R3,0,1,-1,0
202502,15837000,2S3,0,1,-1,0
202502,15837000,3,54,78,-24,0.69
202502,15837000,3S2,9,25,-16,0.36
202502,15837000,3S3,742,944,-202,0.79
202502,15837000,CA,1,18,-17,0.06
202502,15837000,V2,0,12,-12,0
202502,15837000,V3,250,0,250,NA
202502,15837006,3S3,5,0,5,NA
202502,15839000,2,0,1,-1,0
202502,15842000,2,1,6,-5,0.17
202502,15842000,3S3,0,1,-1,0
202502,15842000,CA,0,8,-8,0
202502,15861000,2,23,69,-46,0.33
202502,15861000,3S3,0,14,-14,0
202502,15861000,CA,1,21,-20,0.05
202502,15861007,3S3,0,2,-2,0
202502,15861008,2,0,1,-1,0
202502,15861008,3S3,0,1,-1,0
202502,15897000,2,0,8,-8,0
202502,15897000,2R3,0,1,-1,0
202502,15897000,3,0,3,-3,0
202502,15897000,3S3,0,3,-3,0
202502,15897000,CA,0,3,-3,0
202502,17001000,2,4450,6485,-2035,0.69
202502,17001000,2R2,0,7,-7,0
202502,17001000,2R3,0,49,-49,0
202502,17001000,2S1,1,1,0,1
202502,17001000,2S2,634,804,-170,0.79
202502,17001000,2S3,111,179,-68,0.62
202502,17001000,3,164,145,19,1.13
202502,17001000,3S1,0,2,-2,0
202502,17001000,3S2,376,344,32,1.09
202502,17001000,3S3,1840,1996,-156,0.92
202502,17001000,3S4,1,6,-5,0.17
202502,17001000,4,4,4,0,1
202502,17001000,CA,622,2131,-1509,0.29
202502,17001000,V2,6,0,6,NA
202502,17001002,2,0,3,-3,0
202502,17001004,2,0,1,-1,0
202502,17001013,2,0,2,-2,0
202502,17001013,CA,0,4,-4,0
202502,17001027,3S2,0,1,-1,0
202502,17001027,3S3,0,87,-87,0
202502,17001029,2,0,2,-2,0
202502,17001031,2,0,1,-1,0
202502,17013000,2,59,281,-222,0.21
202502,17013000,3,0,8,-8,0
202502,17013000,3S3,0,1,-1,0
202502,17013000,CA,4,58,-54,0.07
202502,17013000,V3,0,2,-2,0
202502,17042000,2,22,174,-152,0.13
202502,17042000,2R2,0,3,-3,0
202502,17042000,3,0,4,-4,0
202502,17042000,3S2,12,8,4,1.5
202502,17042000,3S3,46,31,15,1.48
202502,17042000,CA,1,87,-86,0.01
202502,17050000,2,34,71,-37,0.48
202502,17050000,3,0,3,-3,0
202502,17050000,3S3,0,28,-28,0
202502,17050000,CA,1,28,-27,0.04
202502,17088000,2,5,69,-64,0.07
202502,17088000,3,0,1,-1,0
202502,17088000,3S3,0,2,-2,0
202502,17088000,CA,0,14,-14,0
202502,17174000,2,477,633,-156,0.75
202502,17174000,2R2,0,12,-12,0
202502,17174000,2R3,0,2,-2,0
202502,17174000,2S2,27,60,-33,0.45
202502,17174000,2S3,37,50,-13,0.74
202502,17174000,3,31,8,23,3.88
202502,17174000,3S2,77,41,36,1.88
202502,17174000,3S3,410,566,-156,0.72
202502,17174000,3S4,0,1,-1,0
202502,17174000,4,41,0,41,NA
202502,17174000,CA,11,220,-209,0.05
202502,17174011,2,5,0,5,NA
202502,17174011,2S3,0,1,-1,0
202502,17272000,2,2,33,-31,0.06
202502,17272000,3S3,0,16,-16,0
202502,17272000,CA,0,26,-26,0
202502,17272005,2,0,2,-2,0
202502,17380000,2,602,970,-368,0.62
202502,17380000,2R2,0,3,-3,0
202502,17380000,2S2,2,8,-6,0.25
202502,17380000,2S3,1,1,0,1
202502,17380000,3,33,15,18,2.2
202502,17380000,3S2,17,4,13,4.25
202502,17380000,3S3,74,160,-86,0.46
202502,17380000,3S4,2,4,-2,0.5
202502,17380000,CA,261,209,52,1.25
202502,17380000,V3,0,4,-4,0
202502,17380001,2S2,0,4,-4,0
202502,17380002,2,0,2,-2,0
202502,17380002,3,5,0,5,NA
202502,17380002,3S3,6,2,4,3
202502,17380002,V2,9,0,9,NA
202502,17380002,V3,23,0,23,NA
202502,17388000,2,0,19,-19,0
202502,17388000,CA,0,6,-6,0
202502,17388002,3S3,0,10,-10,0
202502,17388002,CA,0,2,-2,0
202502,17388008,2,0,3,-3,0
202502,17433000,2,39,91,-52,0.43
202502,17433000,2S2,0,1,-1,0
202502,17433000,3,6,6,0,1
202502,17433000,3S3,24,1,23,24
202502,17433000,CA,1,51,-50,0.02
202502,17433000,V3,0,5,-5,0
202502,17442000,2,13,82,-69,0.16
202502,17442000,3,1,31,-30,0.03
202502,17442000,3S2,0,2,-2,0
202502,17442000,3S3,1,4,-3,0.25
202502,17442000,CA,0,24,-24,0
202502,17442001,2,0,8,-8,0
202502,17442002,2,0,1,-1,0
202502,17444000,2,26,75,-49,0.35
202502,17444000,3,0,7,-7,0
202502,17444000,CA,0,5,-5,0
202502,17444000,V3,0,1,-1,0
202502,17446000,2,2,2,0,1
202502,17446000,CA,0,9,-9,0
202502,17486000,2,18,113,-95,0.16
202502,17486000,3,0,10,-10,0
202502,17486000,3S2,0,1,-1,0
202502,17486000,3S3,0,18,-18,0
202502,17486000,CA,0,66,-66,0
202502,17486009,2,0,1,-1,0
202502,17495000,2,4,31,-27,0.13
202502,17495000,2S2,0,1,-1,0
202502,17495000,3,0,1,-1,0
202502,17495000,3S2,1,3,-2,0.33
202502,17495000,3S3,2,0,2,NA
202502,17495000,CA,0,8,-8,0
202502,17495000,V3,0,1,-1,0
202502,17513000,2,28,51,-23,0.55
202502,17513000,3,0,10,-10,0
202502,17513000,CA,0,5,-5,0
202502,17513000,V2,0,1,-1,0
202502,17513000,V3,0,7,-7,0
202502,17513014,2,0,1,-1,0
202502,17524000,2,4,97,-93,0.04
202502,17524000,3,1,1,0,1
202502,17524000,3S2,0,2,-2,0
202502,17524000,3S3,0,2,-2,0
202502,17524000,CA,0,52,-52,0
202502,17524001,2,10,46,-36,0.22
202502,17524001,3,0,1,-1,0
202502,17524001,3S2,0,2,-2,0
202502,17524001,3S3,0,151,-151,0
202502,17524001,CA,0,26,-26,0
202502,17524003,2,0,9,-9,0
202502,17524003,CA,0,3,-3,0
202502,17524005,3S3,1,3,-2,0.33
202502,17524006,2,1,14,-13,0.07
202502,17524006,3S2,0,1,-1,0
202502,17524006,3S3,0,1,-1,0
202502,17524006,CA,0,1,-1,0
202502,17541000,2,21,118,-97,0.18
202502,17541000,3,0,5,-5,0
202502,17541000,3S3,12,12,0,1
202502,17541000,CA,1,82,-81,0.01
202502,17541002,2,0,9,-9,0
202502,17614000,2,9,317,-308,0.03
202502,17614000,2R2,0,14,-14,0
202502,17614000,3,1,7,-6,0.14
202502,17614000,3S2,0,1,-1,0
202502,17614000,3S3,7,44,-37,0.16
202502,17614000,CA,5,135,-130,0.04
202502,17614001,CA,0,1,-1,0
202502,17614004,2,0,15,-15,0
202502,17616000,2,3,47,-44,0.06
202502,17616000,3S2,2,1,1,2
202502,17616000,3S3,1,6,-5,0.17
202502,17616000,4,0,1,-1,0
202502,17616000,CA,0,27,-27,0
202502,17653000,2,8,111,-103,0.07
202502,17653000,CA,0,28,-28,0
202502,17653000,V3,0,1,-1,0
202502,17653007,2,0,1,-1,0
202502,17662000,2,12,56,-44,0.21
202502,17662000,3,0,10,-10,0
202502,17662000,CA,1,3,-2,0.33
202502,17662000,V3,0,11,-11,0
202502,17662003,2,3,5,-2,0.6
202502,17662003,3,0,4,-4,0
202502,17662003,V3,0,2,-2,0
202502,17662007,2,0,1,-1,0
202502,17665000,2,4,6,-2,0.67
202502,17665000,CA,0,9,-9,0
202502,17777000,2,4,269,-265,0.01
202502,17777000,2R2,0,11,-11,0
202502,17777000,3S2,0,1,-1,0
202502,17777000,3S3,9,9,0,1
202502,17777000,CA,0,322,-322,0
202502,17777008,3S3,0,2,-2,0
202502,17867000,2,9,29,-20,0.31
202502,17867000,3S3,1,0,1,NA
202502,17867000,CA,0,11,-11,0
202502,17873000,2,4,342,-338,0.01
202502,17873000,2S2,4,2,2,2
202502,17873000,2S3,0,2,-2,0
202502,17873000,3,0,8,-8,0
202502,17873000,3S3,0,33,-33,0
202502,17873000,CA,3,164,-161,0.02
202502,17873004,2,1,1,0,1
202502,17873004,4,2,0,2,NA
202502,17873004,CA,0,2,-2,0
202502,17873016,CA,0,1,-1,0
202502,17877000,2,72,158,-86,0.46
202502,17877000,3,0,29,-29,0
202502,17877000,3S2,3,6,-3,0.5
202502,17877000,3S3,1,32,-31,0.03
202502,17877000,CA,0,64,-64,0
202502,18001000,2,520,1890,-1370,0.28
202502,18001000,2R2,0,8,-8,0
202502,18001000,2S2,2,66,-64,0.03
202502,18001000,2S3,3,11,-8,0.27
202502,18001000,3,28,107,-79,0.26
202502,18001000,3S2,0,52,-52,0
202502,18001000,3S3,33,606,-573,0.05
202502,18001000,CA,75,289,-214,0.26
202502,18001002,2,0,1,-1,0
202502,18001013,2,0,2,-2,0
202502,18001013,3S3,2,1,1,2
202502,18029000,2,0,6,-6,0
202502,18029000,3S3,0,1,-1,0
202502,18094000,2,2,16,-14,0.12
202502,18094000,3S2,0,1,-1,0
202502,18094000,3S3,0,5,-5,0
202502,18094000,CA,0,3,-3,0
202502,18094000,V3R2,0,1,-1,0
202502,18150000,2,39,111,-72,0.35
202502,18150000,3,1,12,-11,0.08
202502,18150000,3S2,0,2,-2,0
202502,18150000,3S3,3,38,-35,0.08
202502,18150000,CA,0,22,-22,0
202502,18205000,2,1,20,-19,0.05
202502,18205000,3,0,1,-1,0
202502,18205000,3S3,1,4,-3,0.25
202502,18205000,CA,0,13,-13,0
202502,18247000,2,6,70,-64,0.09
202502,18247000,3,0,5,-5,0
202502,18247000,3S3,0,10,-10,0
202502,18247000,CA,2,4,-2,0.5
202502,18256000,2,4,29,-25,0.14
202502,18256000,3S2,2,0,2,NA
202502,18256000,3S3,0,3,-3,0
202502,18256000,CA,1,2,-1,0.5
202502,18410000,2,2,17,-15,0.12
202502,18410000,2S3,0,1,-1,0
202502,18410000,3S2,0,1,-1,0
202502,18410000,CA,0,1,-1,0
202502,18410000,V3R2,1,0,1,NA
202502,18460000,2,1,2,-1,0.5
202502,18460001,2,0,1,-1,0
202502,18479000,2,4,5,-1,0.8
202502,18479000,3S3,0,10,-10,0
202502,18479000,CA,0,1,-1,0
202502,18592000,2,23,46,-23,0.5
202502,18592000,2S2,1,0,1,NA
202502,18592000,3,1,4,-3,0.25
202502,18592000,3S2,0,3,-3,0
202502,18592000,3S3,0,10,-10,0
202502,18592000,CA,1,5,-4,0.2
202502,18610000,2,0,31,-31,0
202502,18610000,3S3,0,2,-2,0
202502,18610001,2,0,5,-5,0
202502,18610002,2,0,1,-1,0
202502,18610002,3S3,9,1,8,9
202502,18753000,2,110,509,-399,0.22
202502,18753000,2S2,0,1,-1,0
202502,18753000,3,2,16,-14,0.12
202502,18753000,3S2,1,3,-2,0.33
202502,18753000,3S3,5,51,-46,0.1
202502,18753000,4,0,1,-1,0
202502,18753000,CA,1,29,-28,0.03
202502,18753003,2,0,6,-6,0
202502,18753006,2,0,4,-4,0
202502,18756000,CA,0,2,-2,0
202502,18756008,2,1,7,-6,0.14
202502,18756008,2S3,0,1,-1,0
202502,18756008,3,0,1,-1,0
202502,18756008,CA,1,0,1,NA
202502,18785000,2,16,9,7,1.78
202502,18785000,3,0,23,-23,0
202502,18785000,3S2,0,1,-1,0
202502,18785000,3S3,0,3,-3,0
202502,18785000,CA,0,2,-2,0
202502,18860000,2,3,0,3,NA
202502,18860000,2S2,0,1,-1,0
202502,18860000,2S3,0,1,-1,0
202502,18860000,3S3,1,1,0,1
202502,19001000,2,849,3635,-2786,0.23
202502,19001000,2R2,0,23,-23,0
202502,19001000,2S2,9,129,-120,0.07
202502,19001000,2S3,2,20,-18,0.1
202502,19001000,3,18,154,-136,0.12
202502,19001000,3R3,0,2,-2,0
202502,19001000,3S2,35,64,-29,0.55
202502,19001000,3S3,282,863,-581,0.33
202502,19001000,3S4,3,1,2,3
202502,19001000,CA,428,862,-434,0.5
202502,19001000,V2,1,0,1,NA
202502,19001000,V3,2,0,2,NA
202502,19001008,2,2,0,2,NA
202502,19022000,2,1,29,-28,0.03
202502,19050000,2,3,120,-117,0.03
202502,19050000,3,0,5,-5,0
202502,19050000,CA,0,18,-18,0
202502,19050000,V3,0,2,-2,0
202502,19050001,2,0,10,-10,0
202502,19050001,3,0,2,-2,0
202502,19050006,2,0,40,-40,0
202502,19050007,2,0,3,-3,0
202502,19050008,2,0,2,-2,0
202502,19050016,2,0,1,-1,0
202502,19075000,2,2,56,-54,0.04
202502,19075000,3,0,1,-1,0
202502,19075000,3S2,1,0,1,NA
202502,19075000,CA,0,18,-18,0
202502,19100000,2,2,58,-56,0.03
202502,19100000,3,0,10,-10,0
202502,19100000,3S2,1,1,0,1
202502,19100000,3S3,1,16,-15,0.06
202502,19100000,CA,0,1,-1,0
202502,19100004,3S3,0,3,-3,0
202502,19100021,2,0,1,-1,0
202502,19110000,2,0,17,-17,0
202502,19110000,2S3,0,1,-1,0
202502,19110000,CA,0,1,-1,0
202502,19110012,2,0,3,-3,0
202502,19110012,3,1,0,1,NA
202502,19110012,3S3,0,38,-38,0
202502,19110020,2,0,3,-3,0
202502,19130000,2,1,25,-24,0.04
202502,19130000,3,0,14,-14,0
202502,19130000,CA,0,28,-28,0
202502,19137000,2,0,18,-18,0
202502,19137000,3,0,1,-1,0
202502,19137000,CA,0,46,-46,0
202502,19137004,2,0,6,-6,0
202502,19137008,2,1,0,1,NA
202502,19142000,2,1495,796,699,1.88
202502,19142000,2B1,5,2,3,2.5
202502,19142000,2B2,2,2,0,1
202502,19142000,2R2,2,0,2,NA
202502,19142000,2R3,0,4,-4,0
202502,19142000,2S1,0,3,-3,0
202502,19142000,2S2,193,138,55,1.4
202502,19142000,2S3,29,57,-28,0.51
202502,19142000,3,75,19,56,3.95
202502,19142000,3S1,0,5,-5,0
202502,19142000,3S2,195,139,56,1.4
202502,19142000,3S3,824,889,-65,0.93
202502,19142000,3S4,1,1,0,1
202502,19142000,4,1,1,0,1
202502,19142000,CA,170,199,-29,0.85
202502,19142006,2,248,84,164,2.95
202502,19142006,2S2,26,7,19,3.71
202502,19142006,2S3,3,2,1,1.5
202502,19142006,3,7,0,7,NA
202502,19142006,3S2,79,45,34,1.76
202502,19142006,3S3,261,176,85,1.48
202502,19142006,CA,1,8,-7,0.12
202502,19142020,CA,0,2,-2,0
202502,19212000,2,0,132,-132,0
202502,19212000,3,0,6,-6,0
202502,19212000,3S3,0,1,-1,0
202502,19212000,CA,0,78,-78,0
202502,19256000,2,1,69,-68,0.01
202502,19256000,2S3,0,1,-1,0
202502,19256000,3,0,12,-12,0
202502,19256000,3S2,0,1,-1,0
202502,19256000,3S3,0,4,-4,0
202502,19256000,CA,0,14,-14,0
202502,19256012,3,0,1,-1,0
202502,19256018,2,0,6,-6,0
202502,19256018,2S3,1,0,1,NA
202502,19256018,3S3,1,2,-1,0.5
202502,19256018,CA,0,17,-17,0
202502,19290000,2,0,85,-85,0
202502,19290000,3,0,1,-1,0
202502,19290000,3S3,0,11,-11,0
202502,19290000,CA,0,7,-7,0
202502,19300000,2,369,97,272,3.8
202502,19300000,2S1,13,0,13,NA
202502,19300000,2S2,129,43,86,3
202502,19300000,2S3,27,19,8,1.42
202502,19300000,3,1,0,1,NA
202502,19300000,3S1,9,0,9,NA
202502,19300000,3S2,38,18,20,2.11
202502,19300000,3S3,242,193,49,1.25
202502,19300000,CA,49,13,36,3.77
202502,19300000,V2,0,6,-6,0
202502,19318000,2,0,3,-3,0
202502,19318010,2,0,1,-1,0
202502,19355000,2,0,12,-12,0
202502,19355000,3,0,7,-7,0
202502,19355000,3S3,0,5,-5,0
202502,19355012,2,3,13,-10,0.23
202502,19355012,2S3,0,1,-1,0
202502,19355012,3,0,1,-1,0
202502,19355012,3S3,0,2,-2,0
202502,19355012,CA,1,3,-2,0.33
202502,19364000,2,0,1,-1,0
202502,19364000,3,0,1,-1,0
202502,19392000,2,0,15,-15,0
202502,19392000,CA,0,5,-5,0
202502,19397000,2,0,18,-18,0
202502,19397000,3S2,3,2,1,1.5
202502,19397000,3S3,0,3,-3,0
202502,19397000,CA,0,1,-1,0
202502,19418000,CA,0,1,-1,0
202502,19418020,2,0,1,-1,0
202502,19418020,3S3,0,22,-22,0
202502,19418020,CA,0,1,-1,0
202502,19418033,2,0,1,-1,0
202502,19450000,2,1,73,-72,0.01
202502,19450000,3S3,1,4,-3,0.25
202502,19450000,CA,1,4,-3,0.25
202502,19450015,2,0,1,-1,0
202502,19450019,2,0,3,-3,0
202502,19455000,2,59,197,-138,0.3
202502,19455000,2R2,0,2,-2,0
202502,19455000,2S2,8,8,0,1
202502,19455000,3,4,3,1,1.33
202502,19455000,3S2,28,11,17,2.55
202502,19455000,3S3,460,98,362,4.69
202502,19455000,CA,5,76,-71,0.07
202502,19455005,2,65,7,58,9.29
202502,19455005,3,0,1,-1,0
202502,19455005,3S2,1,0,1,NA
202502,19455005,3S3,202,44,158,4.59
202502,19455005,CA,17,5,12,3.4
202502,19473000,2,5,64,-59,0.08
202502,19473000,3S2,0,1,-1,0
202502,19473000,3S3,0,6,-6,0
202502,19473000,CA,0,65,-65,0
202502,19473000,V3,0,1,-1,0
202502,19513000,2,1,30,-29,0.03
202502,19513000,CA,0,1,-1,0
202502,19513003,CA,0,2,-2,0
202502,19517000,2,0,10,-10,0
202502,19517000,CA,0,2,-2,0
202502,19517006,CA,0,2,-2,0
202502,19532000,2,5,216,-211,0.02
202502,19532000,2S2,0,2,-2,0
202502,19532000,3,1,5,-4,0.2
202502,19532000,3S3,1,32,-31,0.03
202502,19532000,CA,25,53,-28,0.47
202502,19532004,3S3,0,1,-1,0
202502,19532005,2,1,10,-9,0.1
202502,19532006,2,0,1,-1,0
202502,19532008,2,0,28,-28,0
202502,19532008,CA,0,7,-7,0
202502,19532009,3,0,8,-8,0
202502,19532013,2,0,8,-8,0
202502,19532013,3,0,1,-1,0
202502,19532013,3S3,0,16,-16,0
202502,19532013,CA,0,1,-1,0
202502,19533000,2,1,26,-25,0.04
202502,19533000,3,6,0,6,NA
202502,19533000,3S3,6,0,6,NA
202502,19533000,CA,0,2,-2,0
202502,19548000,2,13,146,-133,0.09
202502,19548000,3,0,3,-3,0
202502,19548000,3S3,1,23,-22,0.04
202502,19548000,CA,0,58,-58,0
202502,19548001,2,1,0,1,NA
202502,19548014,2,0,2,-2,0
202502,19573000,2,1364,501,863,2.72
202502,19573000,2B1,26,1,25,26
202502,19573000,2B2,2,0,2,NA
202502,19573000,2R2,7,4,3,1.75
202502,19573000,2R3,0,1,-1,0
202502,19573000,2S2,195,62,133,3.15
202502,19573000,2S3,40,33,7,1.21
202502,19573000,3,28,26,2,1.08
202502,19573000,3S2,100,84,16,1.19
202502,19573000,3S3,921,475,446,1.94
202502,19573000,3S4,1,2,-1,0.5
202502,19573000,CA,120,135,-15,0.89
202502,19585000,2,0,3,-3,0
202502,19585000,CA,0,7,-7,0
202502,19585001,2,0,6,-6,0
202502,19585001,CA,0,5,-5,0
202502,19585004,2,0,1,-1,0
202502,19585004,CA,0,1,-1,0
202502,19622000,2,0,13,-13,0
202502,19622000,3,1,0,1,NA
202502,19622000,3S3,2,2,0,1
202502,19622000,CA,0,24,-24,0
202502,19693000,2,0,4,-4,0
202502,19693001,2,0,1,-1,0
202502,19693001,CA,0,5,-5,0
202502,19693005,2,0,1,-1,0
202502,19698000,2,675,1361,-686,0.5
202502,19698000,2B2,1,0,1,NA
202502,19698000,2R2,0,1,-1,0
202502,19698000,2R3,1,0,1,NA
202502,19698000,2S1,0,10,-10,0
202502,19698000,2S2,183,69,114,2.65
202502,19698000,2S3,40,40,0,1
202502,19698000,3,15,69,-54,0.22
202502,19698000,3S1,0,4,-4,0
202502,19698000,3S2,75,89,-14,0.84
202502,19698000,3S3,180,409,-229,0.44
202502,19698000,3S4,0,1,-1,0
202502,19698000,CA,26,560,-534,0.05
202502,19698000,V3,3,0,3,NA
202502,19698007,2,8,21,-13,0.38
202502,19698007,CA,0,30,-30,0
202502,19698036,2,2,0,2,NA
202502,19701000,2,1,5,-4,0.2
202502,19701000,3S3,0,5,-5,0
202502,19701006,2,1,2,-1,0.5
202502,19701006,V2,0,1,-1,0
202502,19743000,2,0,35,-35,0
202502,19743000,3S3,0,1,-1,0
202502,19743000,CA,1,34,-33,0.03
202502,19743008,2,1,0,1,NA
202502,19760000,2,0,2,-2,0
202502,19780000,2,6,90,-84,0.07
202502,19780000,3,0,12,-12,0
202502,19780000,3S3,0,2,-2,0
202502,19780000,CA,1,17,-16,0.06
202502,19780001,2,0,3,-3,0
202502,19785000,2,0,8,-8,0
202502,19785000,CA,0,1,-1,0
202502,19785000,V3,0,2,-2,0
202502,19785001,CA,0,3,-3,0
202502,19785011,3S3,0,1,-1,0
202502,19807000,2,13,196,-183,0.07
202502,19807000,3S3,2,9,-7,0.22
202502,19807000,CA,2,80,-78,0.03
202502,19809000,2,0,1,-1,0
202502,19821000,2,1,33,-32,0.03
202502,19821000,CA,0,1,-1,0
202502,19821007,2,1,0,1,NA
202502,19824000,2,0,14,-14,0
202502,19845000,2,1731,432,1299,4.01
202502,19845000,2B2,0,2,-2,0
202502,19845000,2R3,1,4,-3,0.25
202502,19845000,2S1,0,1,-1,0
202502,19845000,2S2,485,152,333,3.19
202502,19845000,2S3,37,24,13,1.54
202502,19845000,3,17,9,8,1.89
202502,19845000,3S2,156,127,29,1.23
202502,19845000,3S3,196,346,-150,0.57
202502,19845000,4,1,0,1,NA
202502,19845000,CA,133,160,-27,0.83
202502,19845000,V2,1,0,1,NA
202502,20001000,2,2899,5384,-2485,0.54
202502,20001000,2B1,2,8,-6,0.25
202502,20001000,2B2,0,2,-2,0
202502,20001000,2R2,76,15,61,5.07
202502,20001000,2S2,21,183,-162,0.11
202502,20001000,2S3,14,83,-69,0.17
202502,20001000,3,37,145,-108,0.26
202502,20001000,3S2,149,314,-165,0.47
202502,20001000,3S3,396,1553,-1157,0.25
202502,20001000,3S4,1,1,0,1
202502,20001000,4,0,9,-9,0
202502,20001000,CA,382,704,-322,0.54
202502,20001001,2,0,8,-8,0
202502,20001001,3S2,2,0,2,NA
202502,20001001,3S3,6,12,-6,0.5
202502,20001002,2,0,2,-2,0
202502,20001003,2,3,7,-4,0.43
202502,20001005,2,0,5,-5,0
202502,20001005,3S3,5,1,4,5
202502,20001009,2,0,1,-1,0
202502,20001012,3S3,0,2,-2,0
202502,20001013,2,5,6,-1,0.83
202502,20001013,3S3,1,6,-5,0.17
202502,20001014,2,0,1,-1,0
202502,20001018,2,23,1,22,23
202502,20001018,3,2,0,2,NA
202502,20001018,3S3,2,9,-7,0.22
202502,20001018,CA,1,2,-1,0.5
202502,20001024,2,1,1,0,1
202502,20001025,2,0,2,-2,0
202502,20001025,3S3,1,2,-1,0.5
202502,20001031,2,4,2,2,2
202502,20001031,3S2,2,1,1,2
202502,20001039,2,0,1,-1,0
202502,20011000,2,377,1563,-1186,0.24
202502,20011000,2R2,0,3,-3,0
202502,20011000,2S2,2,7,-5,0.29
202502,20011000,2S3,0,22,-22,0
202502,20011000,3,28,152,-124,0.18
202502,20011000,3S2,292,230,62,1.27
202502,20011000,3S2S3,0,2,-2,0
202502,20011000,3S3,279,2874,-2595,0.1
202502,20011000,3S4,4,4,0,1
202502,20011000,4,1,0,1,NA
202502,20011000,CA,67,160,-93,0.42
202502,20011000,V3,0,5,-5,0
202502,20011001,3S3,0,1,-1,0
202502,20011010,3S3,0,5,-5,0
202502,20011011,2,0,1,-1,0
202502,20011014,2,4,0,4,NA
202502,20011021,2,0,13,-13,0
202502,20013000,2,83,322,-239,0.26
202502,20013000,2S2,3,2,1,1.5
202502,20013000,2S3,1,2,-1,0.5
202502,20013000,3,1,4,-3,0.25
202502,20013000,3S2,18,11,7,1.64
202502,20013000,3S3,358,631,-273,0.57
202502,20013000,3S4,0,1,-1,0
202502,20013000,CA,26,64,-38,0.41
202502,20013002,2,12,4,8,3
202502,20013002,2S3,4,0,4,NA
202502,20013004,3S3,1,0,1,NA
202502,20032000,2,5,66,-61,0.08
202502,20032000,3S3,3,13,-10,0.23
202502,20032000,CA,0,7,-7,0
202502,20032001,2,3,5,-2,0.6
202502,20032001,3S3,0,2,-2,0
202502,20045000,2,35,153,-118,0.23
202502,20045000,2S3,1,0,1,NA
202502,20045000,3,1,1,0,1
202502,20045000,3S3,3,32,-29,0.09
202502,20045000,CA,2,17,-15,0.12
202502,20060000,2,313,358,-45,0.87
202502,20060000,2R2,0,2,-2,0
202502,20060000,2R3,0,1,-1,0
202502,20060000,2S2,3,12,-9,0.25
202502,20060000,2S3,3,14,-11,0.21
202502,20060000,3,55,15,40,3.67
202502,20060000,3S2,12,143,-131,0.08
202502,20060000,3S3,108,269,-161,0.4
202502,20060000,3S4,1,0,1,NA
202502,20060000,CA,33,49,-16,0.67
202502,20060000,V2,0,5,-5,0
202502,20060000,V3,4,6,-2,0.67
202502,20175000,2,9,44,-35,0.2
202502,20175000,3S3,0,11,-11,0
202502,20175000,CA,4,8,-4,0.5
202502,20175009,3S3,1,0,1,NA
202502,20175010,3S3,1,3,-2,0.33
202502,20175011,2,0,3,-3,0
202502,20175011,CA,0,5,-5,0
202502,20175014,2S2,0,1,-1,0
202502,20175014,2S3,0,1,-1,0
202502,20175016,2,1,0,1,NA
202502,20175016,2S3,1,0,1,NA
202502,20175016,3S3,3,0,3,NA
202502,20178000,2,12,64,-52,0.19
202502,20178000,3,0,3,-3,0
202502,20178000,3S2,0,10,-10,0
202502,20178000,3S3,2,31,-29,0.06
202502,20178000,CA,0,3,-3,0
202502,20178006,2,14,1,13,14
202502,20178006,2S3,1,0,1,NA
202502,20178006,3S3,0,4,-4,0
202502,20178008,2,1,2,-1,0.5
202502,20178008,3S3,0,3,-3,0
202502,20178014,2,0,1,-1,0
202502,20178018,2,0,3,-3,0
202502,20228000,2,50,270,-220,0.19
202502,20228000,2S2,0,1,-1,0
202502,20228000,2S3,1,1,0,1
202502,20228000,3,1,2,-1,0.5
202502,20228000,3S2,1,6,-5,0.17
202502,20228000,3S3,46,85,-39,0.54
202502,20228000,3S4,0,1,-1,0
202502,20228000,CA,5,32,-27,0.16
202502,20228002,2,1,2,-1,0.5
202502,20228002,3S3,22,7,15,3.14
202502,20228010,2,0,1,-1,0
202502,20238000,2,17,131,-114,0.13
202502,20238000,2S2,0,1,-1,0
202502,20238000,2S3,0,1,-1,0
202502,20238000,3,0,4,-4,0
202502,20238000,3S2,4,2,2,2
202502,20238000,3S3,113,31,82,3.65
202502,20238000,CA,5,13,-8,0.38
202502,20238003,2,0,2,-2,0
202502,20238003,3,0,1,-1,0
202502,20238003,CA,0,1,-1,0
202502,20250000,2,24,112,-88,0.21
202502,20250000,2S1,0,2,-2,0
202502,20250000,2S2,4,6,-2,0.67
202502,20250000,2S3,0,12,-12,0
202502,20250000,3,0,1,-1,0
202502,20250000,3S1,0,1,-1,0
202502,20250000,3S2,16,19,-3,0.84
202502,20250000,3S3,80,204,-124,0.39
202502,20250000,3S4,9,10,-1,0.9
202502,20250000,CA,0,16,-16,0
202502,20250000,V3,0,1,-1,0
202502,20250001,3S3,0,1,-1,0
202502,20250002,2,65,186,-121,0.35
202502,20250002,2R3,0,2,-2,0
202502,20250002,2S2,0,1,-1,0
202502,20250002,2S3,0,2,-2,0
202502,20250002,3,2,3,-1,0.67
202502,20250002,3S2,0,4,-4,0
202502,20250002,3S3,86,34,52,2.53
202502,20250002,3S4,0,2,-2,0
202502,20250002,CA,5,23,-18,0.22
202502,20250002,V3,0,1,-1,0
202502,20250002,V3R3,2,0,2,NA
202502,20250003,3S3,5,0,5,NA
202502,20250004,2,0,3,-3,0
202502,20250004,3S2,1,1,0,1
202502,20250004,3S3,0,77,-77,0
202502,20295000,2,16,95,-79,0.17
202502,20295000,2S2,1,1,0,1
202502,20295000,3S2,2,1,1,2
202502,20295000,3S3,17,77,-60,0.22
202502,20295000,CA,0,11,-11,0
202502,20295000,V2,0,5,-5,0
202502,20295000,V3,0,11,-11,0
202502,20295000,V4,0,13,-13,0
202502,20295004,2S2,1,0,1,NA
202502,20295004,2S3,2,0,2,NA
202502,20295004,3S3,2,0,2,NA
202502,20310000,2,0,2,-2,0
202502,20310006,2,0,2,-2,0
202502,20383000,2,21,28,-7,0.75
202502,20383000,2S2,4,2,2,2
202502,20383000,2S3,1,21,-20,0.05
202502,20383000,3,18,1,17,18
202502,20383000,3S1,3,4,-1,0.75
202502,20383000,3S2,35,144,-109,0.24
202502,20383000,3S3,647,3269,-2622,0.2
202502,20383000,CA,0,6,-6,0
202502,20383001,2,0,8,-8,0
202502,20383001,3,16,0,16,NA
202502,20383001,3S2,22,21,1,1.05
202502,20383001,3S3,177,679,-502,0.26
202502,20383005,2,1,0,1,NA
202502,20383006,2,15,4,11,3.75
202502,20383006,3S3,0,8,-8,0
202502,20383010,2,3,11,-8,0.27
202502,20383010,2S3,1,0,1,NA
202502,20383010,3,0,16,-16,0
202502,20383010,3S2,0,7,-7,0
202502,20383010,3S3,14,88,-74,0.16
202502,20383010,CA,0,1,-1,0
202502,20400000,2,63,310,-247,0.2
202502,20400000,2S2,22,31,-9,0.71
202502,20400000,2S3,6,8,-2,0.75
202502,20400000,3S2,16,122,-106,0.13
202502,20400000,3S3,258,514,-256,0.5
202502,20400000,CA,11,59,-48,0.19
202502,20400000,V3,0,4,-4,0
202502,20400001,2,0,2,-2,0
202502,20400002,2,0,11,-11,0
202502,20400002,3S3,0,1,-1,0
202502,20443000,2,4,46,-42,0.09
202502,20443000,3,0,3,-3,0
202502,20443000,3S2,1,1,0,1
202502,20443000,3S3,2,3,-1,0.67
202502,20443000,CA,0,1,-1,0
202502,20517000,2,11,83,-72,0.13
202502,20517000,3S3,5,23,-18,0.22
202502,20517000,CA,3,6,-3,0.5
202502,20517001,2,1,0,1,NA
202502,20517002,CA,0,2,-2,0
202502,20517004,2,1,0,1,NA
202502,20517004,3S3,0,1,-1,0
202502,20517006,2,1,0,1,NA
202502,20517006,3S3,0,1,-1,0
202502,20550000,2,65,112,-47,0.58
202502,20550000,2R2,0,2,-2,0
202502,20550000,3,3,9,-6,0.33
202502,20550000,3S2,2,0,2,NA
202502,20550000,3S3,10,106,-96,0.09
202502,20550000,CA,1,8,-7,0.12
202502,20550010,2,0,1,-1,0
202502,20570000,2,6,109,-103,0.06
202502,20570000,3S3,5,1,4,5
202502,20570000,CA,0,5,-5,0
202502,20570002,2,0,4,-4,0
202502,20614000,2,56,22,34,2.55
202502,20614000,2S2,0,1,-1,0
202502,20614000,3,1,15,-14,0.07
202502,20614000,3S2,0,1,-1,0
202502,20614000,3S3,31,18,13,1.72
202502,20614000,3S4,1,3,-2,0.33
202502,20614000,CA,1,3,-2,0.33
202502,20614001,3S2,0,1,-1,0
202502,20614001,V3,0,1,-1,0
202502,20614006,3S3,17,0,17,NA
202502,20614012,2,0,6,-6,0
202502,20614012,2S1,0,2,-2,0
202502,20614012,2S2,0,1,-1,0
202502,20614012,3S1,0,7,-7,0
202502,20614012,3S2,11,11,0,1
202502,20614012,3S3,15,46,-31,0.33
202502,20614012,3S4,0,6,-6,0
202502,20621000,2,126,163,-37,0.77
202502,20621000,2S2,2,2,0,1
202502,20621000,2S3,11,5,6,2.2
202502,20621000,3,3,4,-1,0.75
202502,20621000,3S2,11,6,5,1.83
202502,20621000,3S3,175,354,-179,0.49
202502,20621000,3S4,0,1,-1,0
202502,20621000,CA,1,26,-25,0.04
202502,20621006,2,1,5,-4,0.2
202502,20621011,2,1,2,-1,0.5
202502,20621011,3S3,0,3,-3,0
202502,20710000,2,44,193,-149,0.23
202502,20710000,2S2,1,1,0,1
202502,20710000,2S3,0,6,-6,0
202502,20710000,3,2,31,-29,0.06
202502,20710000,3S2,16,4,12,4
202502,20710000,3S3,224,74,150,3.03
202502,20710000,4,0,5,-5,0
202502,20710000,CA,1,55,-54,0.02
202502,20710000,V2,0,1,-1,0
202502,20710000,V3R3,10,0,10,NA
202502,20710001,2S3,12,0,12,NA
202502,20710001,3S3,9,2,7,4.5
202502,20710005,3S3,0,4,-4,0
202502,20750000,2,20,59,-39,0.34
202502,20750000,2S3,1,0,1,NA
202502,20750000,3S2,8,4,4,2
202502,20750000,3S3,4,6,-2,0.67
202502,20750000,CA,0,17,-17,0
202502,20750002,2,0,7,-7,0
202502,20770000,2,34,129,-95,0.26
202502,20770000,2R2,0,24,-24,0
202502,20770000,2S2,0,3,-3,0
202502,20770000,2S3,0,5,-5,0
202502,20770000,3,1,7,-6,0.14
202502,20770000,3S1,1,0,1,NA
202502,20770000,3S2,21,2,19,10.5
202502,20770000,3S3,1615,59,1556,27.37
202502,20770000,3S4,5,0,5,NA
202502,20770000,CA,4,43,-39,0.09
202502,20770000,V3,0,3,-3,0
202502,20770001,2,0,1,-1,0
202502,20770003,3S3,1,0,1,NA
202502,20770010,3,0,4,-4,0
202502,20770014,2,11,8,3,1.38
202502,20770014,2S2,0,4,-4,0
202502,20770014,2S3,0,1,-1,0
202502,20770014,3,6,1,5,6
202502,20770014,3S2,5,9,-4,0.56
202502,20770014,3S3,886,10,876,88.6
202502,20770014,3S4,4,0,4,NA
202502,20770014,CA,1,9,-8,0.11
202502,20787000,2,13,16,-3,0.81
202502,20787000,3S2,0,1,-1,0
202502,20787000,3S3,1,16,-15,0.06
202502,20787000,CA,0,1,-1,0
202502,20787005,CA,3,0,3,NA
202502,23001000,2,2339,4762,-2423,0.49
202502,23001000,2B2,0,45,-45,0
202502,23001000,2R2,1,31,-30,0.03
202502,23001000,2S1,0,3,-3,0
202502,23001000,2S2,45,222,-177,0.2
202502,23001000,2S3,12,62,-50,0.19
202502,23001000,3,29,172,-143,0.17
202502,23001000,3S2,147,425,-278,0.35
202502,23001000,3S3,482,1846,-1364,0.26
202502,23001000,3S4,0,1,-1,0
202502,23001000,4,1,14,-13,0.07
202502,23001000,CA,923,666,257,1.39
202502,23001000,V3,10,0,10,NA
202502,23001001,2,0,17,-17,0
202502,23001001,2R2,3,2,1,1.5
202502,23001001,3S3,0,1,-1,0
202502,23001001,V3,0,1,-1,0
202502,23001004,2,0,4,-4,0
202502,23001004,3,0,2,-2,0
202502,23001008,2,8,0,8,NA
202502,23001008,2S3,1,0,1,NA
202502,23001008,3S2,1,0,1,NA
202502,23001009,2,2,0,2,NA
202502,23001010,3,0,2,-2,0
202502,23001013,2,0,2,-2,0
202502,23001014,2,1,0,1,NA
202502,23001014,3S3,1,0,1,NA
202502,23001016,2,3,0,3,NA
202502,23001017,2,2,2,0,1
202502,23001020,3S2,0,3,-3,0
202502,23001020,3S3,0,4,-4,0
202502,23001031,2,0,1,-1,0
202502,23001031,3S2,0,1,-1,0
202502,23001032,2S2,1,0,1,NA
202502,23001032,2S3,1,0,1,NA
202502,23068000,2,27,102,-75,0.26
202502,23068000,2S2,0,1,-1,0
202502,23068000,3,1,11,-10,0.09
202502,23068000,3S2,7,4,3,1.75
202502,23068000,3S3,2,35,-33,0.06
202502,23068000,4,0,2,-2,0
202502,23068000,CA,0,10,-10,0
202502,23068014,2,2,1,1,2
202502,23068014,V3,0,10,-10,0
202502,23079000,2,67,55,12,1.22
202502,23079000,2B2,0,2,-2,0
202502,23079000,2R2,0,3,-3,0
202502,23079000,2S2,0,1,-1,0
202502,23079000,2S3,0,1,-1,0
202502,23079000,3,0,2,-2,0
202502,23079000,3S2,1,1,0,1
202502,23079000,3S3,7,50,-43,0.14
202502,23079000,CA,0,1,-1,0
202502,23079007,2,0,2,-2,0
202502,23090000,2,48,10,38,4.8
202502,23090000,2S2,4,0,4,NA
202502,23090000,2S3,3,0,3,NA
202502,23090000,3,0,1,-1,0
202502,23090000,3S2,1,0,1,NA
202502,23090000,3S3,4,1,3,4
202502,23090000,CA,0,5,-5,0
202502,23090020,3S3,115,0,115,NA
202502,23090022,3R3,25,0,25,NA
202502,23090022,3S2,2,0,2,NA
202502,23090022,3S3,1470,0,1470,NA
202502,23162000,2,1114,1031,83,1.08
202502,23162000,2B2,181,0,181,NA
202502,23162000,2R2,71,0,71,NA
202502,23162000,2S2,3,54,-51,0.06
202502,23162000,2S3,13,13,0,1
202502,23162000,3,36,84,-48,0.43
202502,23162000,3S2,8,94,-86,0.09
202502,23162000,3S3,307,1006,-699,0.31
202502,23162000,3S4,1,0,1,NA
202502,23162000,4,0,2,-2,0
202502,23162000,CA,52,204,-152,0.25
202502,23162002,3,0,2,-2,0
202502,23162003,2,0,1,-1,0
202502,23162003,3S2,0,1,-1,0
202502,23162004,2,4,0,4,NA
202502,23162016,2,0,1,-1,0
202502,23168000,2,0,3,-3,0
202502,23168000,3,0,1,-1,0
202502,23168000,3S2,0,1,-1,0
202502,23168000,CA,0,1,-1,0
202502,23168004,3S3,170,0,170,NA
202502,23182000,2,24,147,-123,0.16
202502,23182000,2S2,2,0,2,NA
202502,23182000,2S3,3,0,3,NA
202502,23182000,3,0,9,-9,0
202502,23182000,3S2,2,3,-1,0.67
202502,23182000,3S3,6,2,4,3
202502,23182000,CA,5,16,-11,0.31
202502,23182000,V3,1,0,1,NA
202502,23182020,2,0,1,-1,0
202502,23182020,CA,0,1,-1,0
202502,23189000,2,1083,547,536,1.98
202502,23189000,2R2,0,1,-1,0
202502,23189000,2S2,2,9,-7,0.22
202502,23189000,2S3,0,5,-5,0
202502,23189000,3,67,51,16,1.31
202502,23189000,3S2,123,106,17,1.16
202502,23189000,3S3,289,702,-413,0.41
202502,23189000,CA,2,43,-41,0.05
202502,23189000,V3,1,2,-1,0.5
202502,23189001,2,1,1,0,1
202502,23189001,3S2,0,1,-1,0
202502,23189025,2,0,1,-1,0
202502,23300000,2,3,30,-27,0.1
202502,23300000,3,0,3,-3,0
202502,23300000,3S3,0,3,-3,0
202502,23300000,CA,1,2,-1,0.5
202502,23300002,2,1,0,1,NA
202502,23350000,2,16,26,-10,0.62
202502,23350000,2S2,1,0,1,NA
202502,23350000,3S3,3,16,-13,0.19
202502,23350000,CA,0,2,-2,0
202502,23417000,2,44,428,-384,0.1
202502,23417000,2B2,0,1,-1,0
202502,23417000,2R2,0,3,-3,0
202502,23417000,2S2,3,4,-1,0.75
202502,23417000,2S3,2,1,1,2
202502,23417000,3,0,9,-9,0
202502,23417000,3S2,14,13,1,1.08
202502,23417000,3S3,15,125,-110,0.12
202502,23417000,CA,5,111,-106,0.05
202502,23417003,3,0,1,-1,0
202502,23417004,2,0,1,-1,0
202502,23417004,3S3,0,1,-1,0
202502,23417008,2,0,1,-1,0
202502,23417010,2,2,8,-6,0.25
202502,23417010,CA,0,1,-1,0
202502,23417016,2,8,4,4,2
202502,23417016,2S2,1,0,1,NA
202502,23417016,3,0,27,-27,0
202502,23417016,3S3,9,8,1,1.12
202502,23417028,2,0,1,-1,0
202502,23417036,3,0,1,-1,0
202502,23417036,3S3,0,5,-5,0
202502,23417038,2,0,1,-1,0
202502,23419000,2,21,21,0,1
202502,23419000,3,1,0,1,NA
202502,23419000,3S3,0,2,-2,0
202502,23419000,CA,0,2,-2,0
202502,23464000,2,1,14,-13,0.07
202502,23464000,2S2,1,0,1,NA
202502,23464000,3S3,0,19,-19,0
202502,23464000,CA,0,5,-5,0
202502,23464001,2,0,6,-6,0
202502,23464001,2R3,0,1,-1,0
202502,23464001,2S3,0,3,-3,0
202502,23464001,CA,0,1,-1,0
202502,23466000,2,59,391,-332,0.15
202502,23466000,2B2,0,2,-2,0
202502,23466000,2R2,0,3,-3,0
202502,23466000,2S2,0,6,-6,0
202502,23466000,2S3,0,24,-24,0
202502,23466000,3,1,31,-30,0.03
202502,23466000,3S2,3,17,-14,0.18
202502,23466000,3S3,808,2658,-1850,0.3
202502,23466000,3S4,0,6,-6,0
202502,23466000,4,0,1,-1,0
202502,23466000,CA,4,89,-85,0.04
202502,23466000,V3,0,165,-165,0
202502,23466001,2,0,1,-1,0
202502,23466005,2,1,1,0,1
202502,23466005,3S3,2,0,2,NA
202502,23466006,2,0,4,-4,0
202502,23466006,3S3,237,0,237,NA
202502,23466008,3S3,0,3,-3,0
202502,23466023,2,1,0,1,NA
202502,23466034,2,0,2,-2,0
202502,23500000,2,4,48,-44,0.08
202502,23500000,2B2,0,2,-2,0
202502,23500000,3,1,11,-10,0.09
202502,23500000,3S3,0,3,-3,0
202502,23500000,CA,0,9,-9,0
202502,23500006,2,0,1,-1,0
202502,23555000,2,177,377,-200,0.47
202502,23555000,2R2,0,5,-5,0
202502,23555000,2S3,3,3,0,1
202502,23555000,3,24,8,16,3
202502,23555000,3S2,11,42,-31,0.26
202502,23555000,3S3,2225,275,1950,8.09
202502,23555000,CA,4,54,-50,0.07
202502,23555000,V3,0,1,-1,0
202502,23555002,2,0,2,-2,0
202502,23555011,2,0,1,-1,0
202502,23555022,2,0,8,-8,0
202502,23570000,2,45,92,-47,0.49
202502,23570000,2R2,0,1,-1,0
202502,23570000,2S2,1,0,1,NA
202502,23570000,2S3,3,1,2,3
202502,23570000,3,1,9,-8,0.11
202502,23570000,3S1,1,1,0,1
202502,23570000,3S2,10,5,5,2
202502,23570000,3S3,16,18,-2,0.89
202502,23570000,3S4,5,2,3,2.5
202502,23570000,4,2,3,-1,0.67
202502,23570000,CA,2,8,-6,0.25
202502,23570011,2,0,39,-39,0
202502,23570011,2R3,0,2,-2,0
202502,23570011,2S2,0,79,-79,0
202502,23570011,2S3,0,15,-15,0
202502,23570011,3,0,5,-5,0
202502,23570011,3R3,0,2,-2,0
202502,23570011,3S3,0,9,-9,0
202502,23570011,CA,0,11,-11,0
202502,23570013,2,75,11,64,6.82
202502,23570013,3,41,2,39,20.5
202502,23570013,3S3,0,4,-4,0
202502,23570013,CA,6,3,3,2
202502,23574000,2,8,15,-7,0.53
202502,23574000,3,1,0,1,NA
202502,23574000,3S2,1,0,1,NA
202502,23574000,3S3,0,5,-5,0
202502,23574000,CA,0,7,-7,0
202502,23574001,2,0,1,-1,0
202502,23574008,3,0,1,-1,0
202502,23580000,2,34,145,-111,0.23
202502,23580000,2B2,0,7,-7,0
202502,23580000,2R2,0,1,-1,0
202502,23580000,2S3,22,0,22,NA
202502,23580000,3,1,39,-38,0.03
202502,23580000,3R3,1,25,-24,0.04
202502,23580000,3S2,167,9,158,18.56
202502,23580000,3S3,2823,3256,-433,0.87
202502,23580000,4,0,1,-1,0
202502,23580000,CA,2,21,-19,0.1
202502,23580000,V3,172,0,172,NA
202502,23580001,3S2,0,1,-1,0
202502,23580002,3S2,2,0,2,NA
202502,23580002,3S3,1300,0,1300,NA
202502,23580003,3S3,1,0,1,NA
202502,23580006,3S3,143,0,143,NA
202502,23586000,2,0,5,-5,0
202502,23586000,3,0,2,-2,0
202502,23586000,3S3,1,2,-1,0.5
202502,23586000,CA,0,1,-1,0
202502,23660000,2,109,318,-209,0.34
202502,23660000,2B2,0,1,-1,0
202502,23660000,2S2,0,2,-2,0
202502,23660000,2S3,1,4,-3,0.25
202502,23660000,3,29,11,18,2.64
202502,23660000,3S2,2,3,-1,0.67
202502,23660000,3S3,466,102,364,4.57
202502,23660000,3S4,0,4,-4,0
202502,23660000,4,3,3,0,1
202502,23660000,CA,12,53,-41,0.23
202502,23660004,2,8,2,6,4
202502,23660004,3,0,1,-1,0
202502,23660005,2,1,1,0,1
202502,23660005,2S3,2,0,2,NA
202502,23660005,3,0,3,-3,0
202502,23660005,3S2,1,2,-1,0.5
202502,23660005,3S3,4,12,-8,0.33
202502,23660005,3S4,1,3,-2,0.33
202502,23660005,4,2,1,1,2
202502,23660006,2,5,2,3,2.5
202502,23660006,3S3,0,1,-1,0
202502,23660006,3S4,1,0,1,NA
202502,23660006,CA,0,1,-1,0
202502,23660008,2,1,3,-2,0.33
202502,23660008,3S3,1,13,-12,0.08
202502,23660008,4,1,1,0,1
202502,23660015,3S1,0,1,-1,0
202502,23660015,3S2,0,1,-1,0
202502,23660015,3S3,0,1,-1,0
202502,23660015,4,0,1,-1,0
202502,23660044,2,0,1,-1,0
202502,23670000,2,8,61,-53,0.13
202502,23670000,2S3,1,0,1,NA
202502,23670000,3,0,1,-1,0
202502,23670000,3S3,0,1,-1,0
202502,23670000,CA,1,5,-4,0.2
202502,23670011,2,1,7,-6,0.14
202502,23670018,3S3,6,0,6,NA
202502,23672000,2,4,42,-38,0.1
202502,23672000,2S2,0,1,-1,0
202502,23672000,3,0,7,-7,0
202502,23672000,CA,1,13,-12,0.08
202502,23675000,2,9,76,-67,0.12
202502,23675000,2R2,0,2,-2,0
202502,23675000,2S3,1,0,1,NA
202502,23675000,3,0,23,-23,0
202502,23675000,3S3,0,10,-10,0
202502,23675000,CA,0,3,-3,0
202502,23675001,2,0,2,-2,0
202502,23675001,3,0,3,-3,0
202502,23675019,2,0,1,-1,0
202502,23678000,2,17,36,-19,0.47
202502,23678000,3,0,7,-7,0
202502,23678000,3S2,1,1,0,1
202502,23678000,3S3,0,3,-3,0
202502,23678000,CA,0,2,-2,0
202502,23678002,2,1,0,1,NA
202502,23682000,2,2,14,-12,0.14
202502,23682000,3,0,3,-3,0
202502,23682000,3S3,0,1,-1,0
202502,23686000,2,7,29,-22,0.24
202502,23686000,2S2,0,3,-3,0
202502,23686000,3,4,11,-7,0.36
202502,23686000,3S2,2,2,0,1
202502,23686000,3S3,3,0,3,NA
202502,23686000,CA,0,7,-7,0
202502,23686003,3S2,0,5,-5,0
202502,23686003,3S3,1,0,1,NA
202502,23686009,2,5,0,5,NA
202502,23686022,3,0,7,-7,0
202502,23686024,2,1,1,0,1
202502,23807000,2,88,320,-232,0.28
202502,23807000,2B2,0,2,-2,0
202502,23807000,2R2,0,1,-1,0
202502,23807000,2S2,3,3,0,1
202502,23807000,2S3,2,2,0,1
202502,23807000,3,1,27,-26,0.04
202502,23807000,3S2,4,6,-2,0.67
202502,23807000,3S3,43,34,9,1.26
202502,23807000,3S4,1,1,0,1
202502,23807000,CA,2,92,-90,0.02
202502,23807012,3S2,1,0,1,NA
202502,23807017,2,0,1,-1,0
202502,23807027,2,0,16,-16,0
202502,23807027,3S3,10,2,8,5
202502,23807027,CA,0,1,-1,0
202502,23807033,2,0,5,-5,0
202502,23807037,3,2,0,2,NA
202502,23807037,CA,0,1,-1,0
202502,23815000,2,0,15,-15,0
202502,23815000,CA,0,1,-1,0
202502,23855000,2,35,74,-39,0.47
202502,23855000,2S2,2,0,2,NA
202502,23855000,2S3,1,0,1,NA
202502,23855000,3,8,9,-1,0.89
202502,23855000,3S3,4,20,-16,0.2
202502,23855000,CA,0,7,-7,0
202502,23855001,3,0,2,-2,0
202502,23855003,3S3,2,0,2,NA
202502,23855013,3,0,9,-9,0
202502,25001000,2,8,70,-62,0.11
202502,25001000,3S3,0,14,-14,0
202502,25001000,CA,1,49,-48,0.02
202502,25019000,2,18,40,-22,0.45
202502,25019000,2S2,0,1,-1,0
202502,25019000,3,0,3,-3,0
202502,25019000,3S2,1,6,-5,0.17
202502,25019000,3S3,0,1,-1,0
202502,25019000,CA,0,5,-5,0
202502,25035000,2,18,174,-156,0.1
202502,25035000,3S2,0,4,-4,0
202502,25035000,3S3,1,60,-59,0.02
202502,25035000,CA,12,85,-73,0.14
202502,25040000,2,27,93,-66,0.29
202502,25040000,3S3,0,3,-3,0
202502,25040000,CA,0,51,-51,0
202502,25040002,2,0,1,-1,0
202502,25040006,2,1,1,0,1
202502,25053000,2,3,365,-362,0.01
202502,25053000,3,0,1,-1,0
202502,25053000,CA,1,48,-47,0.02
202502,25053000,V2,0,1,-1,0
202502,25086000,2,0,6,-6,0
202502,25086000,CA,0,6,-6,0
202502,25095000,2,0,13,-13,0
202502,25095000,3S2,0,1,-1,0
202502,25099000,2,101,106,-5,0.95
202502,25099000,2S2,6,0,6,NA
202502,25099000,2S3,2,0,2,NA
202502,25099000,3,3,6,-3,0.5
202502,25099000,3S2,2,0,2,NA
202502,25099000,3S3,0,9,-9,0
202502,25099000,CA,97,35,62,2.77
202502,25120000,2,0,15,-15,0
202502,25120000,3,0,1,-1,0
202502,25120000,CA,0,16,-16,0
202502,25123000,2,10,60,-50,0.17
202502,25123000,3,0,1,-1,0
202502,25123000,CA,0,45,-45,0
202502,25123000,V3,0,2,-2,0
202502,25126000,2,3304,1806,1498,1.83
202502,25126000,2B1,18,0,18,NA
202502,25126000,2R2,1,0,1,NA
202502,25126000,2R3,0,13,-13,0
202502,25126000,2S1,1,1,0,1
202502,25126000,2S2,340,141,199,2.41
202502,25126000,2S3,73,54,19,1.35
202502,25126000,3,92,96,-4,0.96
202502,25126000,3S1,36,50,-14,0.72
202502,25126000,3S2,669,488,181,1.37
202502,25126000,3S3,1198,728,470,1.65
202502,25126000,3S4,2,1,1,2
202502,25126000,4,6,15,-9,0.4
202502,25126000,CA,1291,1043,248,1.24
202502,25126000,V2,2,0,2,NA
202502,25126000,V3,149,49,100,3.04
202502,25126000,V4,0,4,-4,0
202502,25126008,CA,0,1,-1,0
202502,25126009,2,2,15,-13,0.13
202502,25126009,3,0,2,-2,0
202502,25148000,2,4,34,-30,0.12
202502,25148000,3S2,1,0,1,NA
202502,25148000,CA,1,21,-20,0.05
202502,25151000,2,10,94,-84,0.11
202502,25151000,2S2,0,1,-1,0
202502,25151000,2S3,1,14,-13,0.07
202502,25151000,3,0,10,-10,0
202502,25151000,3S2,16,0,16,NA
202502,25151000,3S3,4,284,-280,0.01
202502,25151000,4,0,1,-1,0
202502,25151000,CA,10,98,-88,0.1
202502,25154000,2,0,28,-28,0
202502,25154000,CA,0,28,-28,0
202502,25154007,3,0,1,-1,0
202502,25168000,2,0,4,-4,0
202502,25175000,2,900,2430,-1530,0.37
202502,25175000,2R3,0,2,-2,0
202502,25175000,2S1,1,3,-2,0.33
202502,25175000,2S2,104,225,-121,0.46
202502,25175000,2S3,18,51,-33,0.35
202502,25175000,3,14,90,-76,0.16
202502,25175000,3S1,0,3,-3,0
202502,25175000,3S2,193,127,66,1.52
202502,25175000,3S2S3,2,0,2,NA
202502,25175000,3S3,238,429,-191,0.55
202502,25175000,3S4,1,0,1,NA
202502,25175000,CA,438,2085,-1647,0.21
202502,25175000,V2,2,4,-2,0.5
202502,25175004,2,2,0,2,NA
202502,25175004,2S3,0,1,-1,0
202502,25175004,3S3,0,1,-1,0
202502,25175004,CA,1,0,1,NA
202502,25178000,2,18,81,-63,0.22
202502,25178000,3,1,4,-3,0.25
202502,25178000,3S2,1,3,-2,0.33
202502,25178000,3S3,0,12,-12,0
202502,25178000,3S4,0,2,-2,0
202502,25178000,CA,1,11,-10,0.09
202502,25181000,2,4,124,-120,0.03
202502,25181000,3,0,20,-20,0
202502,25181000,3S2,0,1,-1,0
202502,25181000,CA,1,59,-58,0.02
202502,25181000,V2,0,2,-2,0
202502,25181000,V3,0,10,-10,0
202502,25183000,2,13,111,-98,0.12
202502,25183000,2R3,0,1,-1,0
202502,25183000,2S3,0,2,-2,0
202502,25183000,3,1,13,-12,0.08
202502,25183000,3S2,0,2,-2,0
202502,25183000,3S3,18,14,4,1.29
202502,25183000,CA,3,74,-71,0.04
202502,25183000,V2,0,4,-4,0
202502,25183000,V3,0,5,-5,0
202502,25183001,2,0,39,-39,0
202502,25183001,3S3,0,1,-1,0
202502,25200000,2,336,461,-125,0.73
202502,25200000,2S1,28,3,25,9.33
202502,25200000,2S2,378,73,305,5.18
202502,25200000,2S3,653,26,627,25.12
202502,25200000,3,26,8,18,3.25
202502,25200000,3S1,3,0,3,NA
202502,25200000,3S2,144,48,96,3
202502,25200000,3S3,682,565,117,1.21
202502,25200000,4,0,2,-2,0
202502,25200000,CA,22,108,-86,0.2
202502,25200000,V2,0,7,-7,0
202502,25200000,V3,0,15,-15,0
202502,25200000,V4,0,3,-3,0
202502,25200005,2,3,0,3,NA
202502,25200010,3S2,1,0,1,NA
202502,25200010,3S3,4,0,4,NA
202502,25200010,V2,4,0,4,NA
202502,25200010,V3,15,0,15,NA
202502,25200012,CA,0,1,-1,0
202502,25214000,2,20730,6673,14057,3.11
202502,25214000,2B1,19,5,14,3.8
202502,25214000,2R2,57,5,52,11.4
202502,25214000,2R3,61,5,56,12.2
202502,25214000,2S1,6,22,-16,0.27
202502,25214000,2S2,990,1605,-615,0.62
202502,25214000,2S3,496,427,69,1.16
202502,25214000,3,352,179,173,1.97
202502,25214000,3S1,9,5,4,1.8
202502,25214000,3S2,577,749,-172,0.77
202502,25214000,3S3,1944,3228,-1284,0.6
202502,25214000,3S4,8,9,-1,0.89
202502,25214000,4,3,8,-5,0.38
202502,25214000,CA,11000,1937,9063,5.68
202502,25214000,V2,2,3,-1,0.67
202502,25214000,V3,0,3,-3,0
202502,25214008,2,853,468,385,1.82
202502,25214008,2R3,121,2,119,60.5
202502,25214008,2S2,244,42,202,5.81
202502,25214008,2S3,319,14,305,22.79
202502,25214008,3,17,3,14,5.67
202502,25214008,3S2,45,33,12,1.36
202502,25214008,3S3,92,110,-18,0.84
202502,25214008,3S4,1,1,0,1
202502,25214008,4,2,1,1,2
202502,25214008,CA,288,403,-115,0.71
202502,25224000,2,1,32,-31,0.03
202502,25224000,3,5,1,4,5
202502,25224000,3S2,17,1,16,17
202502,25224000,3S3,1357,97,1260,13.99
202502,25224000,4,12,2,10,6
202502,25224000,CA,0,12,-12,0
202502,25224000,V2,8,2,6,4
202502,25224000,V3,130,65,65,2
202502,25224000,V4,67,66,1,1.02
202502,25224000,V4R2,10,4,6,2.5
202502,25245000,2,6,86,-80,0.07
202502,25245000,3,1,13,-12,0.08
202502,25245000,3S2,0,1,-1,0
202502,25245000,3S3,0,14,-14,0
202502,25245000,CA,3,83,-80,0.04
202502,25245000,V2,0,1,-1,0
202502,25245001,CA,0,1,-1,0
202502,25245002,CA,0,4,-4,0
202502,25258000,2,0,2,-2,0
202502,25258000,3,1,0,1,NA
202502,25258000,CA,0,2,-2,0
202502,25260000,2,357,1324,-967,0.27
202502,25260000,2S2,39,16,23,2.44
202502,25260000,2S3,20,7,13,2.86
202502,25260000,3,1,4,-3,0.25
202502,25260000,3S2,2,44,-42,0.05
202502,25260000,3S3,10,181,-171,0.06
202502,25260000,CA,66,228,-162,0.29
202502,25260000,V2,1,38,-37,0.03
202502,25260000,V3,0,28,-28,0
202502,25260002,2,3,1,2,3
202502,25269000,2,1264,2462,-1198,0.51
202502,25269000,2B1,2,0,2,NA
202502,25269000,2R3,0,1,-1,0
202502,25269000,2S2,168,20,148,8.4
202502,25269000,2S3,341,23,318,14.83
202502,25269000,3,715,38,677,18.82
202502,25269000,3S2,1349,304,1045,4.44
202502,25269000,3S3,3407,2255,1152,1.51
202502,25269000,3S4,1,1,0,1
202502,25269000,4,49,0,49,NA
202502,25269000,CA,194,1843,-1649,0.11
202502,25269000,V2,0,3,-3,0
202502,25269000,V3,0,8,-8,0
202502,25269007,3S3,5,0,5,NA
202502,25269009,3S3,0,8,-8,0
202502,25269012,2,0,1,-1,0
202502,25269013,2,0,1,-1,0
202502,25269017,2,26,13,13,2
202502,25269018,2,1,3,-2,0.33
202502,25279000,2,0,41,-41,0
202502,25279000,3,0,8,-8,0
202502,25279000,3S3,0,69,-69,0
202502,25279000,CA,1,54,-53,0.02
202502,25279000,V3,0,1,-1,0
202502,25281000,2,1,10,-9,0.1
202502,25281000,2S3,1,0,1,NA
202502,25281000,3S2,0,5,-5,0
202502,25281000,CA,0,9,-9,0
202502,25281002,2,1,0,1,NA
202502,25286000,2,34028,12263,21765,2.77
202502,25286000,2B1,6,6,0,1
202502,25286000,2R2,52,10,42,5.2
202502,25286000,2R3,104,12,92,8.67
202502,25286000,2S1,48,54,-6,0.89
202502,25286000,2S2,4135,3797,338,1.09
202502,25286000,2S3,875,920,-45,0.95
202502,25286000,3,370,256,114,1.45
202502,25286000,3S1,9,5,4,1.8
202502,25286000,3S2,1086,1708,-622,0.64
202502,25286000,3S3,2837,6300,-3463,0.45
202502,25286000,3S4,6,5,1,1.2
202502,25286000,4,15,4,11,3.75
202502,25286000,CA,21243,3222,18021,6.59
202502,25286000,V2,42,8,34,5.25
202502,25286000,V3,1,3,-2,0.33
202502,25288000,2,6,40,-34,0.15
202502,25288000,2S2,18,91,-73,0.2
202502,25288000,2S3,1,0,1,NA
202502,25288000,3,7,0,7,NA
202502,25288000,3S2,66,21,45,3.14
202502,25288000,3S3,50,0,50,NA
202502,25288000,CA,7,11,-4,0.64
202502,25288001,2,0,2,-2,0
202502,25290000,2,136,1469,-1333,0.09
202502,25290000,2R2,0,3,-3,0
202502,25290000,2S2,2,15,-13,0.13
202502,25290000,2S3,1,5,-4,0.2
202502,25290000,3,3,89,-86,0.03
202502,25290000,3S2,2,36,-34,0.06
202502,25290000,3S3,2,480,-478,0
202502,25290000,3S4,2,0,2,NA
202502,25290000,4,0,1,-1,0
202502,25290000,CA,121,406,-285,0.3
202502,25290000,V2,0,23,-23,0
202502,25290002,2,0,1,-1,0
202502,25290011,2,2,4,-2,0.5
202502,25290011,3,0,1,-1,0
202502,25290011,3S2,1,0,1,NA
202502,25290011,3S3,0,1,-1,0
202502,25290011,3S4,1,0,1,NA
202502,25290011,CA,0,2,-2,0
202502,25290012,3S3,0,23,-23,0
202502,25293000,2,1,5,-4,0.2
202502,25293000,3,2,7,-5,0.29
202502,25293000,CA,0,53,-53,0
202502,25295000,2,3020,1027,1993,2.94
202502,25295000,2B2,1,0,1,NA
202502,25295000,2R3,0,1,-1,0
202502,25295000,2S1,0,10,-10,0
202502,25295000,2S2,129,286,-157,0.45
202502,25295000,2S3,45,109,-64,0.41
202502,25295000,3,44,98,-54,0.45
202502,25295000,3S2,49,204,-155,0.24
202502,25295000,3S3,260,424,-164,0.61
202502,25295000,3S4,0,2,-2,0
202502,25295000,4,3,0,3,NA
202502,25295000,CA,34,258,-224,0.13
202502,25295000,V2,12,6,6,2
202502,25295000,V3,37,9,28,4.11
202502,25295005,2,218,0,218,NA
202502,25297000,2,3,33,-30,0.09
202502,25297000,3,1,10,-9,0.1
202502,25297000,3S3,0,3,-3,0
202502,25297000,3S4,0,1,-1,0
202502,25297000,CA,1,60,-59,0.02
202502,25297000,V3,0,1,-1,0
202502,25299000,2,0,13,-13,0
202502,25299000,CA,0,7,-7,0
202502,25307000,2,326,1671,-1345,0.2
202502,25307000,2R2,0,9,-9,0
202502,25307000,2S2,4,22,-18,0.18
202502,25307000,2S3,2,5,-3,0.4
202502,25307000,3,16,63,-47,0.25
202502,25307000,3S2,0,7,-7,0
202502,25307000,3S3,244,441,-197,0.55
202502,25307000,CA,376,582,-206,0.65
202502,25307000,V3,0,1,-1,0
202502,25312000,2,2,54,-52,0.04
202502,25312000,2S2,0,1,-1,0
202502,25312000,2S3,0,2,-2,0
202502,25312000,3,0,1,-1,0
202502,25312000,3S2,12,2,10,6
202502,25312000,3S3,5,4,1,1.25
202502,25312000,CA,2,18,-16,0.11
202502,25312013,2,0,2,-2,0
202502,25312013,3S3,0,1,-1,0
202502,25317000,2,3,49,-46,0.06
202502,25317000,3,0,5,-5,0
202502,25317000,3S2,7,0,7,NA
202502,25317000,3S3,2109,98,2011,21.52
202502,25317000,4,4,0,4,NA
202502,25317000,CA,1,31,-30,0.03
202502,25317000,V2,24,2,22,12
202502,25317000,V3,296,404,-108,0.73
202502,25317000,V4,129,249,-120,0.52
202502,25320000,2,176,426,-250,0.41
202502,25320000,2S2,1,7,-6,0.14
202502,25320000,2S3,0,61,-61,0
202502,25320000,3,1,9,-8,0.11
202502,25320000,3S2,4,509,-505,0.01
202502,25320000,3S3,6,841,-835,0.01
202502,25320000,CA,3,128,-125,0.02
202502,25320000,V3,0,2,-2,0
202502,25320003,3S3,1,0,1,NA
202502,25322000,2,27,190,-163,0.14
202502,25322000,2S2,0,1,-1,0
202502,25322000,3,43,5,38,8.6
202502,25322000,3S2,31,0,31,NA
202502,25322000,3S3,20,4,16,5
202502,25322000,4,0,1,-1,0
202502,25322000,CA,3,194,-191,0.02
202502,25322000,V2,0,2,-2,0
202502,25322000,V3,129,5,124,25.8
202502,25324000,2,1,8,-7,0.12
202502,25324000,CA,0,6,-6,0
202502,25326000,2,0,47,-47,0
202502,25326000,3,0,1,-1,0
202502,25326000,3S3,3,4,-1,0.75
202502,25326000,CA,0,25,-25,0
202502,25328000,2,1,29,-28,0.03
202502,25328000,2S1,1,0,1,NA
202502,25328000,2S3,0,1,-1,0
202502,25328000,3,1,10,-9,0.1
202502,25328000,3S2,0,1,-1,0
202502,25328000,3S3,0,4,-4,0
202502,25328000,CA,0,1,-1,0
202502,25328001,3S3,0,4,-4,0
202502,25335000,2,4,28,-24,0.14
202502,25335000,2S2,1,0,1,NA
202502,25335000,2S3,1,0,1,NA
202502,25335000,3,0,8,-8,0
202502,25335000,3S2,10,1,9,10
202502,25335000,3S3,3,41,-38,0.07
202502,25335000,3S4,1,0,1,NA
202502,25335000,CA,6,27,-21,0.22
202502,25339000,2,0,2,-2,0
202502,25339000,CA,0,5,-5,0
202502,25368000,2,0,13,-13,0
202502,25368000,3,1,0,1,NA
202502,25368000,CA,0,3,-3,0
202502,25372000,2,3,4,-1,0.75
202502,25372000,2S2,0,1,-1,0
202502,25372000,3S3,0,2,-2,0
202502,25372000,CA,0,3,-3,0
202502,25377000,2,485,544,-59,0.89
202502,25377000,2S2,12,31,-19,0.39
202502,25377000,2S3,4,7,-3,0.57
202502,25377000,3,209,62,147,3.37
202502,25377000,3S2,2,1,1,2
202502,25377000,3S3,510,143,367,3.57
202502,25377000,CA,10,449,-439,0.02
202502,25377000,V2,2,4,-2,0.5
202502,25377000,V3,168,2,166,84
202502,25377000,V4,1,0,1,NA
202502,25377003,3S3,0,4,-4,0
202502,25386000,2,18,423,-405,0.04
202502,25386000,2S3,0,1,-1,0
202502,25386000,3,0,3,-3,0
202502,25386000,3S2,1,4,-3,0.25
202502,25386000,3S3,4,99,-95,0.04
202502,25386000,CA,7,166,-159,0.04
202502,25386001,2,0,7,-7,0
202502,25386003,2,0,1,-1,0
202502,25394000,2,0,13,-13,0
202502,25394000,3,0,2,-2,0
202502,25394000,CA,0,10,-10,0
202502,25398000,2,0,15,-15,0
202502,25398000,CA,0,7,-7,0
202502,25402000,2,17,206,-189,0.08
202502,25402000,2S2,2,1,1,2
202502,25402000,2S3,0,10,-10,0
202502,25402000,3,1,23,-22,0.04
202502,25402000,3S2,0,7,-7,0
202502,25402000,3S3,1,6,-5,0.17
202502,25402000,4,0,1,-1,0
202502,25402000,CA,5,57,-52,0.09
202502,25407000,2,8,68,-60,0.12
202502,25407000,2S2,0,1,-1,0
202502,25407000,3,0,1,-1,0
202502,25407000,3S2,15,21,-6,0.71
202502,25407000,3S3,1319,237,1082,5.57
202502,25407000,4,12,18,-6,0.67
202502,25407000,CA,0,40,-40,0
202502,25407000,V2,1,16,-15,0.06
202502,25407000,V3,58,84,-26,0.69
202502,25407000,V4,39,21,18,1.86
202502,25407000,V4R2,10,5,5,2
202502,25426000,2,0,43,-43,0
202502,25426000,3S3,0,2,-2,0
202502,25426000,CA,0,8,-8,0
202502,25430000,2,5439,2983,2456,1.82
202502,25430000,2B1,0,6,-6,0
202502,25430000,2B2,2,17,-15,0.12
202502,25430000,2R2,2,8,-6,0.25
202502,25430000,2S1,3,7,-4,0.43
202502,25430000,2S2,1407,620,787,2.27
202502,25430000,2S3,286,146,140,1.96
202502,25430000,3,245,182,63,1.35
202502,25430000,3S1,1,0,1,NA
202502,25430000,3S2,293,402,-109,0.73
202502,25430000,3S3,1522,2512,-990,0.61
202502,25430000,3S4,2,0,2,NA
202502,25430000,4,6,14,-8,0.43
202502,25430000,CA,1574,1001,573,1.57
202502,25430000,V2,2,5,-3,0.4
202502,25430000,V3,6,475,-469,0.01
202502,25430000,V4,0,164,-164,0
202502,25430003,2,3,1,2,3
202502,25430003,3S3,0,14,-14,0
202502,25430004,2,9,5,4,1.8
202502,25430004,2S2,56,0,56,NA
202502,25430004,2S3,4,0,4,NA
202502,25430004,3S2,7,0,7,NA
202502,25430004,3S3,0,1,-1,0
202502,25430004,CA,1,1,0,1
202502,25430005,2,5,4,1,1.25
202502,25430006,2,11,4,7,2.75
202502,25436000,2,1,10,-9,0.1
202502,25436000,3,0,6,-6,0
202502,25436000,3S3,1,0,1,NA
202502,25436000,CA,0,14,-14,0
202502,25438000,2,10,25,-15,0.4
202502,25438000,3,0,2,-2,0
202502,25438000,3S2,0,1,-1,0
202502,25438000,3S3,3,5,-2,0.6
202502,25438000,CA,0,6,-6,0
202502,25473000,2,9576,5193,4383,1.84
202502,25473000,2B1,0,13,-13,0
202502,25473000,2R2,1,0,1,NA
202502,25473000,2R3,2,4,-2,0.5
202502,25473000,2S1,7,3,4,2.33
202502,25473000,2S2,988,930,58,1.06
202502,25473000,2S3,224,236,-12,0.95
202502,25473000,3,143,449,-306,0.32
202502,25473000,3S1,4,2,2,2
202502,25473000,3S2,396,402,-6,0.99
202502,25473000,3S3,1638,3985,-2347,0.41
202502,25473000,3S4,6,8,-2,0.75
202502,25473000,4,3,44,-41,0.07
202502,25473000,CA,3494,1721,1773,2.03
202502,25473000,V2,30,78,-48,0.38
202502,25473000,V3,36,396,-360,0.09
202502,25473000,V4,1,33,-32,0.03
202502,25473004,2,0,1,-1,0
202502,25483000,2,1,12,-11,0.08
202502,25483000,3S3,1,3,-2,0.33
202502,25483000,CA,0,17,-17,0
202502,25486000,2,183,236,-53,0.78
202502,25486000,2R3,0,2,-2,0
202502,25486000,3,76,0,76,NA
202502,25486000,3S2,9,15,-6,0.6
202502,25486000,3S3,167,6,161,27.83
202502,25486000,CA,2,121,-119,0.02
202502,25486000,V2,0,1,-1,0
202502,25486000,V3,1087,28,1059,38.82
202502,25486000,V4,236,0,236,NA
202502,25486002,2,5,0,5,NA
202502,25488000,2,6,107,-101,0.06
202502,25488000,2S2,0,4,-4,0
202502,25488000,3,0,7,-7,0
202502,25488000,3S2,2,0,2,NA
202502,25488000,3S3,0,5,-5,0
202502,25488000,CA,2,22,-20,0.09
202502,25488000,V2,0,2,-2,0
202502,25489000,2,0,30,-30,0
202502,25489000,CA,0,3,-3,0
202502,25489001,2,0,1,-1,0
202502,25491000,2,0,9,-9,0
202502,25491000,2S3,0,1,-1,0
202502,25491000,CA,0,7,-7,0
202502,25506000,2,1,13,-12,0.08
202502,25506000,CA,0,6,-6,0
202502,25513000,2,14,125,-111,0.11
202502,25513000,3,1,14,-13,0.07
202502,25513000,3S2,1,1,0,1
202502,25513000,3S3,0,10,-10,0
202502,25513000,CA,2,71,-69,0.03
202502,25513000,V3,0,5,-5,0
202502,25518000,2,0,12,-12,0
202502,25518000,CA,0,2,-2,0
202502,25518004,2,0,7,-7,0
202502,25518004,CA,0,1,-1,0
202502,25524000,2,0,12,-12,0
202502,25524000,3,0,2,-2,0
202502,25524000,CA,0,8,-8,0
202502,25530000,2,8,56,-48,0.14
202502,25530000,2S3,2,1,1,2
202502,25530000,3,2,33,-31,0.06
202502,25530000,3S2,1,11,-10,0.09
202502,25530000,3S3,5,23,-18,0.22
202502,25530000,CA,2,16,-14,0.12
202502,25530001,2,1,0,1,NA
202502,25530001,V3,0,1,-1,0
202502,25530002,2S3,0,1,-1,0
202502,25530002,3S3,1,0,1,NA
202502,25535000,2,0,39,-39,0
202502,25535000,3,1,0,1,NA
202502,25535000,3S3,0,8,-8,0
202502,25535000,CA,0,5,-5,0
202502,25535000,V2,0,3,-3,0
202502,25572000,2,31,124,-93,0.25
202502,25572000,2R2,0,3,-3,0
202502,25572000,2S2,3,2,1,1.5
202502,25572000,3,2,1,1,2
202502,25572000,3S2,41,1,40,41
202502,25572000,3S3,168,129,39,1.3
202502,25572000,3S4,0,1,-1,0
202502,25572000,CA,3,39,-36,0.08
202502,25572000,V3,0,1,-1,0
202502,25572003,2,1,0,1,NA
202502,25572003,2S3,1,1,0,1
202502,25580000,2,0,8,-8,0
202502,25580000,CA,0,5,-5,0
202502,25592000,2,1,9,-8,0.11
202502,25592000,3,0,4,-4,0
202502,25592000,CA,0,9,-9,0
202502,25592000,V3,0,1,-1,0
202502,25594000,2,1,21,-20,0.05
202502,25594000,3,0,2,-2,0
202502,25594000,3S3,0,19,-19,0
202502,25594000,CA,0,18,-18,0
202502,25594002,2,0,5,-5,0
202502,25594002,3S2,1,0,1,NA
202502,25594002,3S3,0,5,-5,0
202502,25594002,CA,0,17,-17,0
202502,25596000,2,0,10,-10,0
202502,25596000,3,0,1,-1,0
202502,25596000,CA,0,10,-10,0
202502,25596001,2,0,1,-1,0
202502,25599000,2,9,55,-46,0.16
202502,25599000,3,0,1,-1,0
202502,25599000,3S3,0,4,-4,0
202502,25599000,CA,0,61,-61,0
202502,25599002,2,0,5,-5,0
202502,25599002,CA,0,2,-2,0
202502,25612000,2,12,246,-234,0.05
202502,25612000,2R2,0,1,-1,0
202502,25612000,2S2,1,1,0,1
202502,25612000,2S3,0,2,-2,0
202502,25612000,3,47,3,44,15.67
202502,25612000,3S3,3,114,-111,0.03
202502,25612000,CA,14,129,-115,0.11
202502,25612000,V2,4,0,4,NA
202502,25612000,V3,13,0,13,NA
202502,25612002,3,0,1,-1,0
202502,25645000,2,0,38,-38,0
202502,25645000,3,0,1,-1,0
202502,25645000,3S3,0,4,-4,0
202502,25645000,CA,0,9,-9,0
202502,25645001,2,14,0,14,NA
202502,25649000,2,0,58,-58,0
202502,25649000,CA,3,19,-16,0.16
202502,25658000,2,4,69,-65,0.06
202502,25658000,3,0,5,-5,0
202502,25658000,3S2,0,8,-8,0
202502,25658000,3S3,1,6,-5,0.17
202502,25658000,CA,0,25,-25,0
202502,25658000,V3,0,4,-4,0
202502,25662000,2,0,54,-54,0
202502,25662000,3,1,4,-3,0.25
202502,25662000,CA,1,12,-11,0.08
202502,25662000,V3,0,3,-3,0
202502,25662001,2,3,8,-5,0.38
202502,25662001,3,1,1,0,1
202502,25662001,3S3,0,1,-1,0
202502,25662001,CA,0,8,-8,0
202502,25718000,2,23,201,-178,0.11
202502,25718000,3,24,0,24,NA
202502,25718000,3S3,0,1,-1,0
202502,25718000,CA,31,24,7,1.29
202502,25718000,V2,0,3,-3,0
202502,25736000,2,627,234,393,2.68
202502,25736000,2R3,0,2,-2,0
202502,25736000,2S2,10,30,-20,0.33
202502,25736000,2S3,2,31,-29,0.06
202502,25736000,3,2,7,-5,0.29
202502,25736000,3S2,16,34,-18,0.47
202502,25736000,3S3,587,180,407,3.26
202502,25736000,3S4,0,1,-1,0
202502,25736000,CA,145,88,57,1.65
202502,25736000,V2,82,0,82,NA
202502,25736000,V3,63,2,61,31.5
202502,25736002,2,1,0,1,NA
202502,25740000,2,1025,1476,-451,0.69
202502,25740000,2S1,0,1,-1,0
202502,25740000,2S2,104,105,-1,0.99
202502,25740000,2S3,7,26,-19,0.27
202502,25740000,3,35,69,-34,0.51
202502,25740000,3S2,59,104,-45,0.57
202502,25740000,3S3,1037,1384,-347,0.75
202502,25740000,3S4,0,1,-1,0
202502,25740000,4,2,0,2,NA
202502,25740000,CA,707,460,247,1.54
202502,25740000,V2,0,20,-20,0
202502,25740000,V3,3,0,3,NA
202502,25740000,V4,0,5,-5,0
202502,25743000,2,17,217,-200,0.08
202502,25743000,2S2,6,1,5,6
202502,25743000,2S3,0,1,-1,0
202502,25743000,3,2,23,-21,0.09
202502,25743000,3S2,2,17,-15,0.12
202502,25743000,3S3,7,20,-13,0.35
202502,25743000,3S4,0,5,-5,0
202502,25743000,4,1,0,1,NA
202502,25743000,CA,0,47,-47,0
202502,25743000,V2,0,18,-18,0
202502,25743005,2,0,5,-5,0
202502,25743005,2S2,6,0,6,NA
202502,25743005,2S3,1,0,1,NA
202502,25743005,3S2,13,1,12,13
202502,25743005,CA,2,0,2,NA
202502,25745000,2,7,111,-104,0.06
202502,25745000,2R3,0,1,-1,0
202502,25745000,2S2,0,2,-2,0
202502,25745000,2S3,6,20,-14,0.3
202502,25745000,3,1,0,1,NA
202502,25745000,3S2,109,1,108,109
202502,25745000,3S3,66,15,51,4.4
202502,25745000,CA,1,100,-99,0.01
202502,25754000,2,6796,3817,2979,1.78
202502,25754000,2B1,0,6,-6,0
202502,25754000,2R2,1,0,1,NA
202502,25754000,2R3,0,1,-1,0
202502,25754000,2S1,6,0,6,NA
202502,25754000,2S2,155,163,-8,0.95
202502,25754000,2S3,59,49,10,1.2
202502,25754000,3,798,160,638,4.99
202502,25754000,3S1,1,1,0,1
202502,25754000,3S2,27,68,-41,0.4
202502,25754000,3S3,2559,1232,1327,2.08
202502,25754000,3S4,1,0,1,NA
202502,25754000,4,39,1,38,39
202502,25754000,CA,3703,1954,1749,1.9
202502,25754000,V2,52,12,40,4.33
202502,25754000,V3,106,23,83,4.61
202502,25754001,2,41,3,38,13.67
202502,25754001,2S2,7,1,6,7
202502,25754001,2S3,1,0,1,NA
202502,25754001,3,0,1,-1,0
202502,25754001,3S2,1,0,1,NA
202502,25754001,3S3,7,5,2,1.4
202502,25754001,CA,4,0,4,NA
202502,25758000,2,1102,1259,-157,0.88
202502,25758000,2R3,0,5,-5,0
202502,25758000,2S2,27,102,-75,0.26
202502,25758000,2S3,22,18,4,1.22
202502,25758000,3,498,175,323,2.85
202502,25758000,3S2,398,66,332,6.03
202502,25758000,3S3,1231,234,997,5.26
202502,25758000,4,14,20,-6,0.7
202502,25758000,CA,102,343,-241,0.3
202502,25758000,V2,0,9,-9,0
202502,25758000,V3,5,2441,-2436,0
202502,25758000,V4,0,259,-259,0
202502,25758006,2,26,20,6,1.3
202502,25758006,2B2,0,1,-1,0
202502,25758006,2S2,7,7,0,1
202502,25758006,2S3,6,2,4,3
202502,25758006,3,2,0,2,NA
202502,25758006,3S2,7,1,6,7
202502,25758006,3S3,1191,9,1182,132.33
202502,25758006,CA,2,8,-6,0.25
202502,25758006,V3,32,0,32,NA
202502,25769000,2,151,369,-218,0.41
202502,25769000,2S2,5,0,5,NA
202502,25769000,2S3,0,1,-1,0
202502,25769000,3,71,0,71,NA
202502,25769000,3S3,0,15,-15,0
202502,25769000,CA,3,189,-186,0.02
202502,25769000,V2,0,1,-1,0
202502,25769002,3S3,0,1,-1,0
202502,25769002,CA,0,1,-1,0
202502,25772000,2,94,379,-285,0.25
202502,25772000,2S2,7,5,2,1.4
202502,25772000,2S3,2,4,-2,0.5
202502,25772000,3,12,25,-13,0.48
202502,25772000,3S2,23,6,17,3.83
202502,25772000,3S3,459,1072,-613,0.43
202502,25772000,4,1,1,0,1
202502,25772000,CA,1,118,-117,0.01
202502,25772000,V2,0,3,-3,0
202502,25772000,V3,0,2,-2,0
202502,25772000,V4,0,3,-3,0
202502,25772004,2,6,1,5,6
202502,25777000,2,1,21,-20,0.05
202502,25777000,3,0,2,-2,0
202502,25777000,CA,0,22,-22,0
202502,25777000,V2,0,1,-1,0
202502,25779000,2,1,23,-22,0.04
202502,25779000,3S3,0,1,-1,0
202502,25779000,CA,0,17,-17,0
202502,25781000,2,2,11,-9,0.18
202502,25781000,3,6,6,0,1
202502,25781000,3S2,1,0,1,NA
202502,25781000,3S3,608,3,605,202.67
202502,25781000,CA,1,12,-11,0.08
202502,25781000,V3,70,31,39,2.26
202502,25781000,V4,11,16,-5,0.69
202502,25785000,2,38,159,-121,0.24
202502,25785000,2S2,0,6,-6,0
202502,25785000,2S3,0,1,-1,0
202502,25785000,3,7,2,5,3.5
202502,25785000,3S3,0,14,-14,0
202502,25785000,CA,2,230,-228,0.01
202502,25785000,V2,0,11,-11,0
202502,25785000,V3,0,6,-6,0
202502,25793000,2,0,32,-32,0
202502,25793000,3,1,0,1,NA
202502,25793000,3S2,0,5,-5,0
202502,25793000,3S3,1050,36,1014,29.17
202502,25793000,CA,0,15,-15,0
202502,25793000,V2,2,9,-7,0.22
202502,25793000,V3,22,30,-8,0.73
202502,25793000,V4,4,0,4,NA
202502,25793003,3S3,0,8,-8,0
202502,25797000,2,5,40,-35,0.12
202502,25797000,3,0,10,-10,0
202502,25797000,CA,1,13,-12,0.08
202502,25797001,2,1,0,1,NA
202502,25797001,CA,0,6,-6,0
202502,25799000,2,14546,3655,10891,3.98
202502,25799000,2B1,3,1,2,3
202502,25799000,2R2,28,3,25,9.33
202502,25799000,2R3,19,9,10,2.11
202502,25799000,2S1,44,2,42,22
202502,25799000,2S2,1761,1813,-52,0.97
202502,25799000,2S3,342,237,105,1.44
202502,25799000,3,48,64,-16,0.75
202502,25799000,3S1,3,0,3,NA
202502,25799000,3S2,514,662,-148,0.78
202502,25799000,3S3,518,647,-129,0.8
202502,25799000,3S4,7,0,7,NA
202502,25799000,4,1,0,1,NA
202502,25799000,CA,11350,985,10365,11.52
202502,25799000,V2,0,5,-5,0
202502,25799000,V3,1,4,-3,0.25
202502,25799001,2,5,15,-10,0.33
202502,25799001,2S2,1,6,-5,0.17
202502,25799001,3,0,1,-1,0
202502,25799001,4,1,0,1,NA
202502,25799001,CA,1,0,1,NA
202502,25805000,2,0,36,-36,0
202502,25805000,CA,0,4,-4,0
202502,25807000,2,1,2,-1,0.5
202502,25807000,3,0,3,-3,0
202502,25807000,CA,0,3,-3,0
202502,25807000,V3,0,1,-1,0
202502,25815000,2,8,77,-69,0.1
202502,25815000,3,0,1,-1,0
202502,25815000,3S2,0,1,-1,0
202502,25815000,3S3,0,18,-18,0
202502,25815000,CA,2,43,-41,0.05
202502,25817000,2,8822,5562,3260,1.59
202502,25817000,2B1,19,5,14,3.8
202502,25817000,2B2,0,1,-1,0
202502,25817000,2R2,9,7,2,1.29
202502,25817000,2R3,164,5,159,32.8
202502,25817000,2S1,7,5,2,1.4
202502,25817000,2S2,1809,1037,772,1.74
202502,25817000,2S3,1308,619,689,2.11
202502,25817000,3,762,116,646,6.57
202502,25817000,3S1,2,3,-1,0.67
202502,25817000,3S2,992,647,345,1.53
202502,25817000,3S3,6614,6421,193,1.03
202502,25817000,3S4,14,11,3,1.27
202502,25817000,4,12,5,7,2.4
202502,25817000,CA,2938,1323,1615,2.22
202502,25817000,V2,6,6,0,1
202502,25817000,V3,1,19,-18,0.05
202502,25817001,2,0,1,-1,0
202502,25817001,3S2,0,1,-1,0
202502,25817001,3S3,4,0,4,NA
202502,25817002,2,3,1,2,3
202502,25817002,2S2,2,1,1,2
202502,25817002,2S3,3,2,1,1.5
202502,25817002,3S2,2,1,1,2
202502,25817002,3S3,24,10,14,2.4
202502,25817005,2,0,3,-3,0
202502,25817005,3S3,0,1,-1,0
202502,25817005,CA,0,3,-3,0
202502,25817006,2,8,3,5,2.67
202502,25817014,3S2,0,1,-1,0
202502,25817014,3S3,90,71,19,1.27
202502,25817014,CA,1,0,1,NA
202502,25823000,2,0,3,-3,0
202502,25823000,3,0,1,-1,0
202502,25823000,CA,0,1,-1,0
202502,25839000,2,0,50,-50,0
202502,25839000,3,54,7,47,7.71
202502,25839000,4,0,1,-1,0
202502,25839000,CA,0,12,-12,0
202502,25839000,V3,1479,0,1479,NA
202502,25839003,2,0,6,-6,0
202502,25839003,CA,0,2,-2,0
202502,25839007,CA,0,1,-1,0
202502,25841000,2,2,51,-49,0.04
202502,25841000,3,0,10,-10,0
202502,25841000,3S2,0,2,-2,0
202502,25841000,3S3,2,64,-62,0.03
202502,25841000,CA,2,11,-9,0.18
202502,25843000,2,85,414,-329,0.21
202502,25843000,2R3,0,1,-1,0
202502,25843000,2S2,1,14,-13,0.07
202502,25843000,2S3,0,1,-1,0
202502,25843000,3,47,53,-6,0.89
202502,25843000,3S2,28,5,23,5.6
202502,25843000,3S3,119,154,-35,0.77
202502,25843000,4,0,15,-15,0
202502,25843000,CA,3,230,-227,0.01
202502,25843000,V2,0,111,-111,0
202502,25843000,V3,0,211,-211,0
202502,25843000,V4,0,49,-49,0
202502,25843000,V4R2,0,14,-14,0
202502,25845000,2,2,17,-15,0.12
202502,25845000,3,0,7,-7,0
202502,25845000,3S3,0,5,-5,0
202502,25845000,CA,0,10,-10,0
202502,25851000,2,1,27,-26,0.04
202502,25851000,3,0,1,-1,0
202502,25851000,3S2,5,0,5,NA
202502,25851000,3S3,1,0,1,NA
202502,25851000,CA,0,47,-47,0
202502,25862000,2,0,18,-18,0
202502,25862000,CA,0,5,-5,0
202502,25862000,V3,0,1,-1,0
202502,25867000,2,1,14,-13,0.07
202502,25867000,CA,1,7,-6,0.14
202502,25871000,2,0,1,-1,0
202502,25871000,CA,0,1,-1,0
202502,25873000,2,16,142,-126,0.11
202502,25873000,3,0,7,-7,0
202502,25873000,3S2,1,0,1,NA
202502,25873000,3S3,83,54,29,1.54
202502,25873000,CA,9,116,-107,0.08
202502,25873000,V2,0,1,-1,0
202502,25875000,2,40,506,-466,0.08
202502,25875000,2S3,0,1,-1,0
202502,25875000,3,7,16,-9,0.44
202502,25875000,3S2,2,3,-1,0.67
202502,25875000,3S3,4,70,-66,0.06
202502,25875000,CA,5,177,-172,0.03
202502,25875000,V3,0,1,-1,0
202502,25878000,2,7,54,-47,0.13
202502,25878000,3,0,2,-2,0
202502,25878000,3S3,0,7,-7,0
202502,25878000,CA,0,78,-78,0
202502,25885000,2,8,32,-24,0.25
202502,25885000,CA,0,10,-10,0
202502,25885003,2,0,1,-1,0
202502,25898000,2,1,20,-19,0.05
202502,25898000,2S2,0,1,-1,0
202502,25898000,CA,2,8,-6,0.25
202502,25899000,2,814,2250,-1436,0.36
202502,25899000,2R3,0,1,-1,0
202502,25899000,2S1,1,0,1,NA
202502,25899000,2S2,184,49,135,3.76
202502,25899000,2S3,105,37,68,2.84
202502,25899000,3,43,66,-23,0.65
202502,25899000,3S2,153,48,105,3.19
202502,25899000,3S3,715,580,135,1.23
202502,25899000,3S4,2,0,2,NA
202502,25899000,4,7,4,3,1.75
202502,25899000,CA,180,1753,-1573,0.1
202502,25899000,V2,0,6,-6,0
202502,25899000,V3,65,132,-67,0.49
202502,25899000,V4,4,1,3,4
202502,25899001,2,1,0,1,NA
202502,25899010,3S3,1,0,1,NA
202502,27001000,2,200,1511,-1311,0.13
202502,27001000,2S2,7,11,-4,0.64
202502,27001000,2S3,0,1,-1,0
202502,27001000,3,5,127,-122,0.04
202502,27001000,3S2,2,27,-25,0.07
202502,27001000,3S3,0,105,-105,0
202502,27001000,4,1,18,-17,0.06
202502,27001000,CA,7,135,-128,0.05
202502,27001004,CA,0,1,-1,0
202502,27001032,2,0,3,-3,0
202502,27001032,3S2,1,0,1,NA
202502,27001060,2R3,0,1,-1,0
202502,27001060,2S3,0,1,-1,0
202502,27006000,2,0,2,-2,0
202502,27006000,3S3,0,5,-5,0
202502,27006007,2,0,1,-1,0
202502,27006007,CA,1,0,1,NA
202502,27025003,3S3,1,0,1,NA
202502,27050000,2,0,4,-4,0
202502,27050000,2S2,0,1,-1,0
202502,27073000,2,0,5,-5,0
202502,27073000,CA,0,2,-2,0
202502,27075000,2,0,2,-2,0
202502,27077000,2,0,1,-1,0
202502,27077024,2S2,0,1,-1,0
202502,27086000,2,2,62,-60,0.03
202502,27086000,2S2,1,0,1,NA
202502,27086000,3,0,31,-31,0
202502,27086000,3S3,5,16,-11,0.31
202502,27086000,CA,0,6,-6,0
202502,27086001,2,0,1,-1,0
202502,27086003,2,0,1,-1,0
202502,27135000,3S3,0,1,-1,0
202502,27150000,2,0,1,-1,0
202502,27150001,2,0,1,-1,0
202502,27150001,3,0,1,-1,0
202502,27160000,2,0,18,-18,0
202502,27205000,2,4,105,-101,0.04
202502,27205000,3,0,15,-15,0
202502,27205000,3S2,2,3,-1,0.67
202502,27205000,3S3,0,3,-3,0
202502,27205000,4,1,0,1,NA
202502,27205000,CA,2,14,-12,0.14
202502,27245000,2,4,62,-58,0.06
202502,27245000,2S2,0,2,-2,0
202502,27245000,2S3,0,1,-1,0
202502,27245000,3,0,21,-21,0
202502,27245000,3S2,2,29,-27,0.07
202502,27245000,3S3,52,19,33,2.74
202502,27245000,4,0,1,-1,0
202502,27245000,CA,0,1,-1,0
202502,27245000,V3,0,6,-6,0
202502,27245003,3,0,1,-1,0
202502,27250000,CA,0,3,-3,0
202502,27250021,CA,0,2,-2,0
202502,27361000,2,56,655,-599,0.09
202502,27361000,2S2,0,1,-1,0
202502,27361000,3,2,33,-31,0.06
202502,27361000,3S2,2,9,-7,0.22
202502,27361000,3S3,6,14,-8,0.43
202502,27361000,4,0,4,-4,0
202502,27361000,CA,0,67,-67,0
202502,27361024,2,0,2,-2,0
202502,27413000,2,1,9,-8,0.11
202502,27413000,2S2,0,1,-1,0
202502,27430000,2,1,4,-3,0.25
202502,27430000,3,0,9,-9,0
202502,27430011,2,0,11,-11,0
202502,27430011,3,2,0,2,NA
202502,27450000,2,0,3,-3,0
202502,27450000,3,0,3,-3,0
202502,27450009,3,0,2,-2,0
202502,27450009,3S2,0,1,-1,0
202502,27491000,2,0,7,-7,0
202502,27491000,3,0,1,-1,0
202502,27491000,3S2,0,11,-11,0
202502,27491000,3S3,0,4,-4,0
202502,27491000,CA,0,1,-1,0
202502,27491008,3,0,2,-2,0
202502,27495007,2,0,1,-1,0
202502,27495007,2S3,0,1,-1,0
202502,27580000,2,0,2,-2,0
202502,27615000,2,0,6,-6,0
202502,27615000,2S2,0,1,-1,0
202502,27615000,3,0,8,-8,0
202502,27615000,3S2,1,2,-1,0.5
202502,27615000,3S3,0,6,-6,0
202502,27615000,CA,0,1,-1,0
202502,27660000,2,0,7,-7,0
202502,27660000,3,0,1,-1,0
202502,27745000,2,0,2,-2,0
202502,27787000,2,3,47,-44,0.06
202502,27787000,3,1,8,-7,0.12
202502,27787000,3S2,0,1,-1,0
202502,27787000,3S3,0,1,-1,0
202502,27787000,CA,0,6,-6,0
202502,27810000,2,1,25,-24,0.04
202502,27810000,3S2,2,3,-1,0.67
202502,27810000,3S3,0,6,-6,0
202502,27810000,CA,1,3,-2,0.33
202502,27810002,2,0,25,-25,0
202502,27810002,3,0,1,-1,0
202502,27810002,3S2,1,0,1,NA
202502,41001000,2,2614,4127,-1513,0.63
202502,41001000,2B1,0,2,-2,0
202502,41001000,2R2,65,25,40,2.6
202502,41001000,2S1,0,1,-1,0
202502,41001000,2S2,77,317,-240,0.24
202502,41001000,2S3,37,161,-124,0.23
202502,41001000,3,189,139,50,1.36
202502,41001000,3S1,1,1,0,1
202502,41001000,3S2,153,272,-119,0.56
202502,41001000,3S3,2071,2262,-191,0.92
202502,41001000,3S4,5,1,4,5
202502,41001000,4,14,15,-1,0.93
202502,41001000,CA,706,841,-135,0.84
202502,41001000,V2R2,3,1,2,3
202502,41001001,3S3,0,1,-1,0
202502,41001001,CA,0,23,-23,0
202502,41001003,2,76,3,73,25.33
202502,41001003,3,20,0,20,NA
202502,41001003,3S3,0,2,-2,0
202502,41001009,2,0,1,-1,0
202502,41001009,3,0,3,-3,0
202502,41001012,2,1,0,1,NA
202502,41001018,2,0,1,-1,0
202502,41006000,2,3,129,-126,0.02
202502,41006000,2S3,0,1,-1,0
202502,41006000,3,1,6,-5,0.17
202502,41006000,3S2,1,0,1,NA
202502,41006000,3S3,1,28,-27,0.04
202502,41006000,CA,0,32,-32,0
202502,41006001,2,1,3,-2,0.33
202502,41006005,3S2,1,0,1,NA
202502,41006005,3S3,8,0,8,NA
202502,41013000,2,0,4,-4,0
202502,41013000,3,0,1,-1,0
202502,41013000,3S2,0,2,-2,0
202502,41013000,3S3,0,7,-7,0
202502,41016000,2,51,89,-38,0.57
202502,41016000,2R2,0,1,-1,0
202502,41016000,2S2,1,28,-27,0.04
202502,41016000,2S3,1,5,-4,0.2
202502,41016000,3,15,304,-289,0.05
202502,41016000,3S1,0,2,-2,0
202502,41016000,3S1S2,0,1,-1,0
202502,41016000,3S2,9,24,-15,0.38
202502,41016000,3S3,55,222,-167,0.25
202502,41016000,3S4,0,1,-1,0
202502,41016000,4,6,11,-5,0.55
202502,41016000,CA,3,48,-45,0.06
202502,41016000,V2R2,0,1,-1,0
202502,41016001,2,0,8,-8,0
202502,41016001,3,0,1,-1,0
202502,41016001,3S3,0,1,-1,0
202502,41016003,3S3,1,1,0,1
202502,41020000,2,0,47,-47,0
202502,41020000,3S3,0,1,-1,0
202502,41020000,CA,0,15,-15,0
202502,41026000,2,7,9,-2,0.78
202502,41026000,2S2,1,0,1,NA
202502,41026000,3S3,0,8,-8,0
202502,41026000,CA,0,2,-2,0
202502,41026000,V3,2,1,1,2
202502,41078000,2,1,1,0,1
202502,41078000,3S2,1,0,1,NA
202502,41078000,3S3,0,11,-11,0
202502,41078000,CA,0,4,-4,0
202502,41132000,2,22,182,-160,0.12
202502,41132000,2S2,0,1,-1,0
202502,41132000,3,54,1,53,54
202502,41132000,3S2,1,2,-1,0.5
202502,41132000,3S3,47,59,-12,0.8
202502,41132000,CA,1,41,-40,0.02
202502,41132000,V3,49,0,49,NA
202502,41206000,2,0,1,-1,0
202502,41206000,CA,0,1,-1,0
202502,41244000,2,1,0,1,NA
202502,41298000,2,109,510,-401,0.21
202502,41298000,2S2,0,1,-1,0
202502,41298000,3,12,42,-30,0.29
202502,41298000,3S2,2,1,1,2
202502,41298000,3S3,87,224,-137,0.39
202502,41298000,CA,17,82,-65,0.21
202502,41298002,3,0,3,-3,0
202502,41298003,2,0,1,-1,0
202502,41298004,2,0,1,-1,0
202502,41298004,3S3,0,4,-4,0
202502,41298004,CA,0,1,-1,0
202502,41306000,2,12,47,-35,0.26
202502,41306000,2S3,0,1,-1,0
202502,41306000,3,1,5,-4,0.2
202502,41306000,3S2,19,0,19,NA
202502,41306000,3S3,67,40,27,1.68
202502,41306000,CA,1,8,-7,0.12
202502,41319000,2,2,39,-37,0.05
202502,41319000,2S3,0,1,-1,0
202502,41319000,3,3,4,-1,0.75
202502,41319000,3S2,0,1,-1,0
202502,41319000,3S3,5,8,-3,0.62
202502,41319000,CA,0,1,-1,0
202502,41349000,2,5,21,-16,0.24
202502,41349000,3,29,0,29,NA
202502,41349000,3S2,1,1,0,1
202502,41349000,3S3,69,2,67,34.5
202502,41349000,CA,1,4,-3,0.25
202502,41357000,2,0,2,-2,0
202502,41357000,3,1,1,0,1
202502,41357000,CA,0,2,-2,0
202502,41359000,2,15,94,-79,0.16
202502,41359000,2S3,2,0,2,NA
202502,41359000,3S3,1,9,-8,0.11
202502,41359000,CA,0,40,-40,0
202502,41359002,3,0,1,-1,0
202502,41359002,3S3,0,11,-11,0
202502,41359004,2,0,1,-1,0
202502,41378000,2,25,28,-3,0.89
202502,41378000,3,0,12,-12,0
202502,41378000,3S3,0,2,-2,0
202502,41378000,CA,0,32,-32,0
202502,41396000,2,38,389,-351,0.1
202502,41396000,2S2,0,1,-1,0
202502,41396000,2S3,0,2,-2,0
202502,41396000,3,2,20,-18,0.1
202502,41396000,3S2,0,1,-1,0
202502,41396000,3S3,2,112,-110,0.02
202502,41396000,CA,0,77,-77,0
202502,41483000,2,0,2,-2,0
202502,41483000,3,0,3,-3,0
202502,41503000,2,0,11,-11,0
202502,41503000,3,1,0,1,NA
202502,41503000,CA,0,24,-24,0
202502,41518000,2,39,16,23,2.44
202502,41518000,3,202,19,183,10.63
202502,41518000,3S2,0,2,-2,0
202502,41518000,3S3,0,3,-3,0
202502,41518000,CA,2,2,0,1
202502,41524000,2,144,271,-127,0.53
202502,41524000,2S1,0,3,-3,0
202502,41524000,2S2,4,11,-7,0.36
202502,41524000,2S3,5,4,1,1.25
202502,41524000,3,17,18,-1,0.94
202502,41524000,3S1,2,0,2,NA
202502,41524000,3S2,11,22,-11,0.5
202502,41524000,3S3,447,615,-168,0.73
202502,41524000,4,2,0,2,NA
202502,41524000,CA,24,55,-31,0.44
202502,41524001,3S3,0,4,-4,0
202502,41524006,2,0,2,-2,0
202502,41524006,CA,0,2,-2,0
202502,41530000,2,1,19,-18,0.05
202502,41530000,2S2,0,1,-1,0
202502,41530000,2S3,0,1,-1,0
202502,41530000,3,1,1,0,1
202502,41530000,3S3,0,1,-1,0
202502,41530000,CA,0,27,-27,0
202502,41548000,2,2,2,0,1
202502,41548000,2S3,0,1,-1,0
202502,41548000,3,0,1,-1,0
202502,41548000,3S3,0,2,-2,0
202502,41548000,CA,0,2,-2,0
202502,41551000,2,502,1941,-1439,0.26
202502,41551000,2S2,8,24,-16,0.33
202502,41551000,2S3,7,62,-55,0.11
202502,41551000,3,10,69,-59,0.14
202502,41551000,3S2,31,64,-33,0.48
202502,41551000,3S3,194,434,-240,0.45
202502,41551000,CA,155,314,-159,0.49
202502,41551000,V3,2,7,-5,0.29
202502,41551001,2,15,20,-5,0.75
202502,41551001,2S3,0,1,-1,0
202502,41551001,3,5,3,2,1.67
202502,41551001,3S3,9,8,1,1.12
202502,41551001,CA,1,29,-28,0.03
202502,41615000,2,127,62,65,2.05
202502,41615000,2S3,54,0,54,NA
202502,41615000,3,51,55,-4,0.93
202502,41615000,3S2,0,1,-1,0
202502,41615000,3S3,153,228,-75,0.67
202502,41615000,CA,30,58,-28,0.52
202502,41615000,V3,0,49,-49,0
202502,41615001,CA,0,1,-1,0
202502,41615002,3S3,1,0,1,NA
202502,41660000,2,0,23,-23,0
202502,41660000,3,0,10,-10,0
202502,41660000,3S3,0,7,-7,0
202502,41660000,CA,0,2,-2,0
202502,41668000,2,44,213,-169,0.21
202502,41668000,2S2,0,3,-3,0
202502,41668000,3,2,3,-1,0.67
202502,41668000,3S3,2,21,-19,0.1
202502,41668000,3S4,0,1,-1,0
202502,41668000,CA,2,14,-12,0.14
202502,41668007,2,0,1,-1,0
202502,41668007,CA,0,1,-1,0
202502,41676000,2,0,9,-9,0
202502,41676000,3,0,1,-1,0
202502,41676000,CA,0,5,-5,0
202502,41770000,2,2,61,-59,0.03
202502,41770000,2S2,1,0,1,NA
202502,41770000,3,0,2,-2,0
202502,41770000,3S2,1,2,-1,0.5
202502,41770000,3S3,4,19,-15,0.21
202502,41770000,CA,0,1,-1,0
202502,41770001,2,0,10,-10,0
202502,41770001,3,0,3,-3,0
202502,41791000,2,0,17,-17,0
202502,41791000,3,3,0,3,NA
202502,41791000,3S3,0,11,-11,0
202502,41791000,CA,0,1,-1,0
202502,41791002,CA,0,1,-1,0
202502,41797000,2,7,65,-58,0.11
202502,41797000,2S2,0,8,-8,0
202502,41797000,3,4,149,-145,0.03
202502,41797000,3S2,1,4,-3,0.25
202502,41797000,3S3,152,68,84,2.24
202502,41797000,CA,1,12,-11,0.08
202502,41799000,2,2,6,-4,0.33
202502,41799000,3S1S2,1,0,1,NA
202502,41799000,3S2,0,25,-25,0
202502,41799000,3S3,2,25,-23,0.08
202502,41799000,CA,0,7,-7,0
202502,41799000,V2R2,0,2,-2,0
202502,41801000,2,0,14,-14,0
202502,41801000,3S3,0,10,-10,0
202502,41801000,CA,1,32,-31,0.03
202502,41807000,2,17,69,-52,0.25
202502,41807000,3,0,6,-6,0
202502,41807000,3S2,0,2,-2,0
202502,41807000,3S3,0,95,-95,0
202502,41807000,CA,0,1,-1,0
202502,41807000,V3,1,0,1,NA
202502,41872000,2,0,8,-8,0
202502,41872000,3S2,23,0,23,NA
202502,41872000,3S3,20,10,10,2
202502,41872000,CA,0,19,-19,0
202502,41872003,3S3,0,1,-1,0
202502,41872003,V2R2,0,1,-1,0
202502,41885000,2,2,18,-16,0.11
202502,41885000,3,2,5,-3,0.4
202502,41885000,3S2,2,2,0,1
202502,41885000,3S3,3,22,-19,0.14
202502,41885000,3S4,1,0,1,NA
202502,41885000,4,7,2,5,3.5
202502,41885000,CA,0,10,-10,0
202502,41885000,V2R2,3,1,2,3
202502,44001000,2,260,1542,-1282,0.17
202502,44001000,2R2,0,12,-12,0
202502,44001000,2S2,5,32,-27,0.16
202502,44001000,2S3,2,31,-29,0.06
202502,44001000,3,3,43,-40,0.07
202502,44001000,3R3,1,0,1,NA
202502,44001000,3S2,3,16,-13,0.19
202502,44001000,3S3,141,364,-223,0.39
202502,44001000,3S4,20,1,19,20
202502,44001000,CA,65,199,-134,0.33
202502,44001000,V3,3,0,3,NA
202502,44001002,3S3,0,1,-1,0
202502,44001003,CA,0,1,-1,0
202502,44001008,2,0,1,-1,0
202502,44001011,2,1,1,0,1
202502,44001011,3S2,0,2,-2,0
202502,44001016,3S2,0,1,-1,0
202502,44001020,3S3,0,1,-1,0
202502,44001025,3S2,19,2,17,9.5
202502,44001025,3S3,2,1,1,2
202502,44001025,V3R3,16,0,16,NA
202502,44001027,3S3,0,1,-1,0
202502,44035000,2,39,270,-231,0.14
202502,44035000,2S2,94,62,32,1.52
202502,44035000,2S3,9,14,-5,0.64
202502,44035000,3,1,3,-2,0.33
202502,44035000,3S2,8,25,-17,0.32
202502,44035000,3S3,75,305,-230,0.25
202502,44035000,3S4,0,13,-13,0
202502,44035000,CA,2,59,-57,0.03
202502,44035001,2,9,12,-3,0.75
202502,44035001,2S3,1,1,0,1
202502,44035001,3,0,1,-1,0
202502,44035001,3S2,10,5,5,2
202502,44035001,3S3,7,30,-23,0.23
202502,44035001,3S4,0,1,-1,0
202502,44035001,CA,2,8,-6,0.25
202502,44078000,2,15,113,-98,0.13
202502,44078000,3,1,1,0,1
202502,44078000,3S2,2,3,-1,0.67
202502,44078000,3S3,1,61,-60,0.02
202502,44078000,CA,0,22,-22,0
202502,44078000,V2,6,0,6,NA
202502,44078000,V3,6,0,6,NA
202502,44090000,2,14,86,-72,0.16
202502,44090000,2S3,1,3,-2,0.33
202502,44090000,3S2,0,3,-3,0
202502,44090000,3S3,36,3933,-3897,0.01
202502,44090000,3S4,0,3,-3,0
202502,44090000,4,0,1,-1,0
202502,44090000,CA,0,8,-8,0
202502,44090000,V4,0,1,-1,0
202502,44090001,CA,0,1,-1,0
202502,44090003,2,11,34,-23,0.32
202502,44090003,3R3,0,1,-1,0
202502,44090003,3S2,0,1,-1,0
202502,44090003,3S3,11,2203,-2192,0
202502,44090003,CA,2,8,-6,0.25
202502,44090004,2,22,33,-11,0.67
202502,44090004,3,1,1,0,1
202502,44090004,3S2,0,1,-1,0
202502,44090004,3S3,1,8,-7,0.12
202502,44090004,CA,3,21,-18,0.14
202502,44090005,3S3,0,3,-3,0
202502,44090006,2,2,2,0,1
202502,44098000,2,3,15,-12,0.2
202502,44098000,3S2,2,2,0,1
202502,44098000,3S3,4,3,1,1.33
202502,44098000,CA,1,2,-1,0.5
202502,44098001,2,0,1,-1,0
202502,44110000,2,1,6,-5,0.17
202502,44110000,3S3,0,3,-3,0
202502,44279000,2,65,292,-227,0.22
202502,44279000,2R2,0,1,-1,0
202502,44279000,2S2,1,2,-1,0.5
202502,44279000,2S3,1,0,1,NA
202502,44279000,3,0,9,-9,0
202502,44279000,3S2,1,0,1,NA
202502,44279000,3S3,34,100,-66,0.34
202502,44279000,CA,1,49,-48,0.02
202502,44279000,V2,1,0,1,NA
202502,44279000,V3,1,0,1,NA
202502,44279002,3S3,0,1,-1,0
202502,44378000,2,28,87,-59,0.32
202502,44378000,3S3,652,11,641,59.27
202502,44378000,3S4,1,1,0,1
202502,44378000,CA,0,16,-16,0
202502,44430000,2,289,2050,-1761,0.14
202502,44430000,2R2,0,27,-27,0
202502,44430000,2S2,3,56,-53,0.05
202502,44430000,2S3,0,44,-44,0
202502,44430000,3,4,71,-67,0.06
202502,44430000,3S1,0,1,-1,0
202502,44430000,3S2,1,30,-29,0.03
202502,44430000,3S3,78,995,-917,0.08
202502,44430000,CA,14,228,-214,0.06
202502,44430000,V3,0,3,-3,0
202502,44430002,2,1,0,1,NA
202502,44430002,3S3,0,1,-1,0
202502,44430005,3S3,0,1,-1,0
202502,44430007,2,7,175,-168,0.04
202502,44430007,2B2,0,1,-1,0
202502,44430007,2R2,0,2,-2,0
202502,44430007,2S2,6,14,-8,0.43
202502,44430007,2S3,2,13,-11,0.15
202502,44430007,3,0,1,-1,0
202502,44430007,3S2,16,41,-25,0.39
202502,44430007,3S3,85,406,-321,0.21
202502,44430007,CA,0,19,-19,0
202502,44560000,2,6,85,-79,0.07
202502,44560000,2R2,0,1,-1,0
202502,44560000,2S2,0,1,-1,0
202502,44560000,2S3,0,3,-3,0
202502,44560000,3,0,2,-2,0
202502,44560000,3S3,2,29,-27,0.07
202502,44560000,3S4,1,0,1,NA
202502,44560000,CA,2,4,-2,0.5
202502,44560007,2,1,7,-6,0.14
202502,44560007,CA,0,1,-1,0
202502,44650000,2,16,146,-130,0.11
202502,44650000,2R2,0,1,-1,0
202502,44650000,2S2,0,3,-3,0
202502,44650000,2S3,1,1,0,1
202502,44650000,3,0,1,-1,0
202502,44650000,3S2,2,1,1,2
202502,44650000,3S3,5,26,-21,0.19
202502,44650000,4,0,1,-1,0
202502,44650000,CA,0,18,-18,0
202502,44847000,2,206,270,-64,0.76
202502,44847000,2R2,1,7,-6,0.14
202502,44847000,2S2,32,39,-7,0.82
202502,44847000,2S3,3,1,2,3
202502,44847000,3,14,5,9,2.8
202502,44847000,3S2,9,8,1,1.12
202502,44847000,3S3,465,223,242,2.09
202502,44847000,CA,3,47,-44,0.06
202502,44847000,V3,0,1,-1,0
202502,44847004,2,0,1,-1,0
202502,44847013,2,0,1,-1,0
202502,44855000,2,2,20,-18,0.1
202502,44855000,CA,0,10,-10,0
202502,44874000,2,9,117,-108,0.08
202502,44874000,2R3,0,1,-1,0
202502,44874000,2S3,6,0,6,NA
202502,44874000,3S2,0,2,-2,0
202502,44874000,3S3,3,11,-8,0.27
202502,44874000,CA,0,33,-33,0
202502,47001000,2,2175,6439,-4264,0.34
202502,47001000,2B1,0,8,-8,0
202502,47001000,2B2,6,6,0,1
202502,47001000,2R2,2,200,-198,0.01
202502,47001000,2R3,0,3,-3,0
202502,47001000,2S2,632,514,118,1.23
202502,47001000,2S3,161,223,-62,0.72
202502,47001000,3,74,167,-93,0.44
202502,47001000,3S1,0,1,-1,0
202502,47001000,3S2,1152,2014,-862,0.57
202502,47001000,3S3,11737,9048,2689,1.3
202502,47001000,3S3S2,2,0,2,NA
202502,47001000,3S4,8,5,3,1.6
202502,47001000,4,0,1,-1,0
202502,47001000,CA,486,1173,-687,0.41
202502,47001000,V2,1,5,-4,0.2
202502,47001000,V3,2,0,2,NA
202502,47001000,V3R3,18,33,-15,0.55
202502,47001000,V4,1,1,0,1
202502,47001001,3S2,0,1,-1,0
202502,47001001,3S3,0,1,-1,0
202502,47001002,2,0,9,-9,0
202502,47001002,3S2,0,1,-1,0
202502,47001003,3S2,21,0,21,NA
202502,47001003,3S3,2,1,1,2
202502,47001005,2S3,1,1,0,1
202502,47001005,3S3,1,6,-5,0.17
202502,47001006,2,13,24,-11,0.54
202502,47001006,3S2,54,49,5,1.1
202502,47001006,3S3,7,3,4,2.33
202502,47001009,2,0,1,-1,0
202502,47001009,CA,0,4,-4,0
202502,47001010,2,0,6,-6,0
202502,47001010,3S3,0,4,-4,0
202502,47001010,CA,0,3,-3,0
202502,47001011,2,5,7,-2,0.71
202502,47001011,3S2,24,23,1,1.04
202502,47001011,3S3,6,0,6,NA
202502,47001011,CA,0,5,-5,0
202502,47001014,2,1,2,-1,0.5
202502,47001014,3S3,2,0,2,NA
202502,47001019,2,0,1,-1,0
202502,47001019,3S3,2,8,-6,0.25
202502,47030000,2,17,34,-17,0.5
202502,47030000,2S2,0,5,-5,0
202502,47030000,2S3,1,1,0,1
202502,47030000,3S2,0,9,-9,0
202502,47030000,3S3,3,10,-7,0.3
202502,47030000,CA,0,3,-3,0
202502,47030004,2,6,1,5,6
202502,47053000,2,14,139,-125,0.1
202502,47053000,2S2,1,0,1,NA
202502,47053000,2S3,2,9,-7,0.22
202502,47053000,3,8,1,7,8
202502,47053000,3S2,5,6,-1,0.83
202502,47053000,3S3,177,226,-49,0.78
202502,47053000,CA,3,16,-13,0.19
202502,47053000,V2,0,1,-1,0
202502,47053000,V3R3,5,34,-29,0.15
202502,47053008,2,1,3,-2,0.33
202502,47053008,2S2,1,0,1,NA
202502,47053008,3,0,3,-3,0
202502,47053008,CA,0,1,-1,0
202502,47058000,2,31,89,-58,0.35
202502,47058000,3,1,0,1,NA
202502,47058000,3S2,5,101,-96,0.05
202502,47058000,3S3,2,141,-139,0.01
202502,47058000,CA,1,3,-2,0.33
202502,47058003,2,5,2,3,2.5
202502,47058003,3S3,0,1,-1,0
202502,47161000,CA,0,1,-1,0
202502,47170000,2,15,54,-39,0.28
202502,47170000,2S2,0,2,-2,0
202502,47170000,3,0,3,-3,0
202502,47170000,3S2,1,2,-1,0.5
202502,47170000,3S3,1,7,-6,0.14
202502,47170000,CA,0,6,-6,0
202502,47170003,2,0,1,-1,0
202502,47170003,3S3,0,1,-1,0
202502,47189000,2,208,890,-682,0.23
202502,47189000,2B1,0,13,-13,0
202502,47189000,2R2,0,18,-18,0
202502,47189000,2S2,10,24,-14,0.42
202502,47189000,2S3,7,10,-3,0.7
202502,47189000,3,13,40,-27,0.32
202502,47189000,3S2,13,44,-31,0.3
202502,47189000,3S3,432,344,88,1.26
202502,47189000,CA,11,158,-147,0.07
202502,47189000,V2,4,0,4,NA
202502,47189004,2,0,1,-1,0
202502,47189006,2,0,1,-1,0
202502,47189009,2,8,5,3,1.6
202502,47189009,2S3,7,5,2,1.4
202502,47189009,3S3,4,3,1,1.33
202502,47189018,2,1,2,-1,0.5
202502,47189022,2,1,2,-1,0.5
202502,47189022,3S3,3,2,1,1.5
202502,47205000,2,1,5,-4,0.2
202502,47205000,3,0,1,-1,0
202502,47205003,2,0,1,-1,0
202502,47245000,2,49,432,-383,0.11
202502,47245000,2R2,0,7,-7,0
202502,47245000,2S2,0,2,-2,0
202502,47245000,3,0,15,-15,0
202502,47245000,3S2,2,3,-1,0.67
202502,47245000,3S3,16,43,-27,0.37
202502,47245000,3S4,1,0,1,NA
202502,47245000,CA,19,44,-25,0.43
202502,47245001,2,0,1,-1,0
202502,47245005,3S3,0,2,-2,0
202502,47245018,2,0,1,-1,0
202502,47258000,2,4,27,-23,0.15
202502,47258000,2S2,0,1,-1,0
202502,47258005,2,0,1,-1,0
202502,47258015,CA,0,1,-1,0
202502,47268000,2,6,61,-55,0.1
202502,47268000,2S2,0,1,-1,0
202502,47268000,2S3,1,0,1,NA
202502,47268000,3,0,1,-1,0
202502,47268000,3S2,24,24,0,1
202502,47268000,3S3,0,4,-4,0
202502,47268000,CA,0,5,-5,0
202502,47288000,2,91,580,-489,0.16
202502,47288000,2S2,3,25,-22,0.12
202502,47288000,2S3,2,4,-2,0.5
202502,47288000,3,5,27,-22,0.19
202502,47288000,3S2,37,16,21,2.31
202502,47288000,3S3,71,151,-80,0.47
202502,47288000,3S4,0,1,-1,0
202502,47288000,CA,6,72,-66,0.08
202502,47288004,2,2,2,0,1
202502,47288011,2,1,2,-1,0.5
202502,47318000,2,30,119,-89,0.25
202502,47318000,2R2,0,1,-1,0
202502,47318000,2S2,1,1,0,1
202502,47318000,3,0,7,-7,0
202502,47318000,3S3,0,16,-16,0
202502,47318000,CA,10,41,-31,0.24
202502,47318001,2,1,0,1,NA
202502,47318005,2,1,1,0,1
202502,47318012,2,0,2,-2,0
202502,47318012,3S3,5,0,5,NA
202502,47318012,CA,0,1,-1,0
202502,47318015,2,0,1,-1,0
202502,47318015,3,0,1,-1,0
202502,47460000,2,24,33,-9,0.73
202502,47460000,3,1,0,1,NA
202502,47460000,3S2,0,1,-1,0
202502,47460000,3S3,0,12,-12,0
202502,47460000,CA,3,9,-6,0.33
202502,47460001,2,0,2,-2,0
202502,47460001,CA,0,3,-3,0
202502,47460002,2,1,0,1,NA
202502,47460004,2,0,1,-1,0
202502,47460005,2,0,5,-5,0
202502,47460005,CA,0,1,-1,0
202502,47541000,2,3,1,2,3
202502,47541000,2S2,2,0,2,NA
202502,47541000,CA,0,1,-1,0
202502,47545000,2,16,9,7,1.78
202502,47545000,3S2,2,0,2,NA
202502,47545000,3S3,0,2,-2,0
202502,47551000,2,30,207,-177,0.14
202502,47551000,2R2,0,1,-1,0
202502,47551000,2S2,0,1,-1,0
202502,47551000,3S1,1,0,1,NA
202502,47551000,3S2,4,0,4,NA
202502,47551000,3S3,8,3,5,2.67
202502,47551000,CA,2,49,-47,0.04
202502,47551002,2,0,1,-1,0
202502,47551009,2,1,3,-2,0.33
202502,47555000,2,53,314,-261,0.17
202502,47555000,2S2,1,2,-1,0.5
202502,47555000,2S3,0,1,-1,0
202502,47555000,3,0,10,-10,0
202502,47555000,3S2,91,6,85,15.17
202502,47555000,3S3,517,40,477,12.93
202502,47555000,CA,6,37,-31,0.16
202502,47555001,3S2,20,0,20,NA
202502,47555001,3S3,61,0,61,NA
202502,47570000,2,1,2,-1,0.5
202502,47570000,3S3,0,1,-1,0
202502,47570000,CA,0,1,-1,0
202502,47570004,2,0,1,-1,0
202502,47605000,2,0,6,-6,0
202502,47605000,CA,0,3,-3,0
202502,47660000,2,26,11,15,2.36
202502,47660000,2S2,1,0,1,NA
202502,47660000,2S3,1,1,0,1
202502,47660000,3,0,7,-7,0
202502,47660000,3S2,0,2,-2,0
202502,47660000,3S3,2,1,1,2
202502,47660000,CA,0,1,-1,0
202502,47660011,2,1,0,1,NA
202502,47675000,2,8,13,-5,0.62
202502,47675000,2S2,2,1,1,2
202502,47675000,3,0,2,-2,0
202502,47675000,3S3,1,1,0,1
202502,47675000,CA,0,4,-4,0
202502,47692000,2,17,35,-18,0.49
202502,47692000,2S3,2,0,2,NA
202502,47692000,3,0,13,-13,0
202502,47692000,3S2,1,2,-1,0.5
202502,47692000,3S3,134,1,133,134
202502,47692000,CA,0,2,-2,0
202502,47692019,2,0,1,-1,0
202502,47703000,2,1,0,1,NA
202502,47707000,2,7,54,-47,0.13
202502,47707000,3S3,6,6,0,1
202502,47707000,CA,0,7,-7,0
202502,47707001,2,0,5,-5,0
202502,47707004,2,0,1,-1,0
202502,47720000,2,2,7,-5,0.29
202502,47720000,2S3,2,0,2,NA
202502,47720000,3S3,0,1,-1,0
202502,47720000,CA,0,1,-1,0
202502,47745000,2,14,34,-20,0.41
202502,47745000,2S2,2,45,-43,0.04
202502,47745000,2S3,5,48,-43,0.1
202502,47745000,3,13,4,9,3.25
202502,47745000,3S2,142,7,135,20.29
202502,47745000,3S3,3103,1719,1384,1.81
202502,47745000,3S4,2,1,1,2
202502,47745000,CA,0,5,-5,0
202502,47745000,V2,65,6,59,10.83
202502,47745000,V3,249,21,228,11.86
202502,47745000,V4,43,3,40,14.33
202502,47745003,2,230,70,160,3.29
202502,47745003,2S3,21,1,20,21
202502,47745003,3,93,0,93,NA
202502,47745003,3S2,84,22,62,3.82
202502,47745003,3S3,1592,1779,-187,0.89
202502,47745003,CA,8,20,-12,0.4
202502,47745003,V2,0,6,-6,0
202502,47745003,V3,0,62,-62,0
202502,47745003,V4,0,11,-11,0
202502,47798000,2,13,4,9,3.25
202502,47798000,3S3,0,3,-3,0
202502,47960000,2,5,1,4,5
202502,47960000,2S3,0,1,-1,0
202502,47960000,3,1,1,0,1
202502,47980000,2,229,95,134,2.41
202502,47980000,3,0,3,-3,0
202502,47980000,3S2,362,106,256,3.42
202502,47980000,3S3,19,30,-11,0.63
202502,47980000,CA,0,12,-12,0
202502,47980001,2,88,36,52,2.44
202502,47980001,3S2,78,44,34,1.77
202502,47980001,3S3,10,10,0,1
202502,47980001,CA,0,5,-5,0
202502,47980002,2,10,9,1,1.11
202502,47980002,2S3,0,1,-1,0
202502,47980002,3,0,1,-1,0
202502,47980002,3S2,4,0,4,NA
202502,47980002,3S3,8,7,1,1.14
202502,47980003,2,0,6,-6,0
202502,47980003,2R2,0,3,-3,0
202502,47980003,2S2,1,1,0,1
202502,47980003,2S3,0,1,-1,0
202502,47980003,3,0,1,-1,0
202502,47980003,3S2,16,1,15,16
202502,47980003,3S3,3,28,-25,0.11
202502,47980004,2,156,89,67,1.75
202502,47980004,2R2,0,10,-10,0
202502,47980004,3,0,2,-2,0
202502,47980004,3S2,209,178,31,1.17
202502,47980004,3S3,7,9,-2,0.78
202502,47980004,CA,0,10,-10,0
202502,47980006,2,105,82,23,1.28
202502,47980006,2S2,0,2,-2,0
202502,47980006,2S3,1,1,0,1
202502,47980006,3,0,4,-4,0
202502,47980006,3S2,0,1,-1,0
202502,47980006,3S3,22,34,-12,0.65
202502,47980006,CA,0,6,-6,0
202502,47980007,3S2,0,7,-7,0
202502,47980007,3S3,0,1,-1,0
202502,47980008,2,70,48,22,1.46
202502,47980008,2S2,1,0,1,NA
202502,47980008,3,1,3,-2,0.33
202502,47980008,3S2,127,113,14,1.12
202502,47980008,3S3,9,10,-1,0.9
202502,47980008,CA,0,1,-1,0
202502,47980010,2,12,16,-4,0.75
202502,47980010,2S3,0,1,-1,0
202502,47980010,3S2,68,48,20,1.42
202502,47980010,3S3,4,11,-7,0.36
202502,47980010,CA,1,2,-1,0.5
202502,47980010,V3R3,13,0,13,NA
202502,47980011,2,0,3,-3,0
202502,47980011,3S3,1,1,0,1
202502,47980012,2,0,1,-1,0
202502,47980012,2S3,2,0,2,NA
202502,47980012,3S3,87,0,87,NA
202502,47980013,2,0,2,-2,0
202502,47980013,3,0,1,-1,0
202502,47980013,3S2,5,1,4,5
202502,47980013,3S3,27,26,1,1.04
202502,47980014,2,0,1,-1,0
202502,50001000,2,3448,6108,-2660,0.56
202502,50001000,2B1,0,1,-1,0
202502,50001000,2B2,29,0,29,NA
202502,50001000,2R2,15,17,-2,0.88
202502,50001000,2R3,0,1,-1,0
202502,50001000,2S1,2,15,-13,0.13
202502,50001000,2S2,130,556,-426,0.23
202502,50001000,2S3,117,172,-55,0.68
202502,50001000,3,407,446,-39,0.91
202502,50001000,3R2,2,0,2,NA
202502,50001000,3S1,3,18,-15,0.17
202502,50001000,3S2,884,1010,-126,0.88
202502,50001000,3S3,2205,3422,-1217,0.64
202502,50001000,3S4,8,4,4,2
202502,50001000,4,16,17,-1,0.94
202502,50001000,CA,1062,1747,-685,0.61
202502,50001000,V2,15,17,-2,0.88
202502,50001000,V3,50,31,19,1.61
202502,50001000,V3R3,13,0,13,NA
202502,50001000,V4,1,1,0,1
202502,50001000,V4R2,2,0,2,NA
202502,50001001,3S3,0,9,-9,0
202502,50001002,2,6,10,-4,0.6
202502,50001002,2S2,1,0,1,NA
202502,50001002,3S2,2,7,-5,0.29
202502,50001002,3S3,16,70,-54,0.23
202502,50001002,3S4,1,0,1,NA
202502,50001002,CA,3,4,-1,0.75
202502,50001004,2,0,4,-4,0
202502,50001013,2,1,0,1,NA
202502,50001015,2,14,18,-4,0.78
202502,50001015,2S1,1,0,1,NA
202502,50001015,2S2,0,1,-1,0
202502,50001015,3,0,1,-1,0
202502,50001015,3S2,0,1,-1,0
202502,50001015,3S3,4,60,-56,0.07
202502,50001015,CA,2,2,0,1
202502,50001019,2,59,8,51,7.38
202502,50001019,2S2,1,1,0,1
202502,50001019,2S3,2,1,1,2
202502,50001019,3,80,1,79,80
202502,50001019,3S2,23,1,22,23
202502,50001019,3S3,54,66,-12,0.82
202502,50001019,CA,6,11,-5,0.55
202502,50006000,2,382,984,-602,0.39
202502,50006000,2B2,0,7,-7,0
202502,50006000,2R2,0,2,-2,0
202502,50006000,2S1,1,0,1,NA
202502,50006000,2S2,35,28,7,1.25
202502,50006000,2S3,14,18,-4,0.78
202502,50006000,3,179,73,106,2.45
202502,50006000,3S1,7,5,2,1.4
202502,50006000,3S2,1375,116,1259,11.85
202502,50006000,3S3,1485,704,781,2.11
202502,50006000,3S4,7,4,3,1.75
202502,50006000,4,2,3,-1,0.67
202502,50006000,CA,44,255,-211,0.17
202502,50006000,V2,8,95,-87,0.08
202502,50006000,V3,377,355,22,1.06
202502,50006000,V3R3,2,0,2,NA
202502,50006000,V4,0,1,-1,0
202502,50006001,2,1,3,-2,0.33
202502,50006001,2S2,0,2,-2,0
202502,50006001,3S3,5,7,-2,0.71
202502,50006001,CA,0,1,-1,0
202502,50006003,2,18,48,-30,0.38
202502,50006003,2S2,3,2,1,1.5
202502,50006003,2S3,2,4,-2,0.5
202502,50006003,3,2,2,0,1
202502,50006003,3S1,1,1,0,1
202502,50006003,3S2,15,24,-9,0.62
202502,50006003,3S3,21,80,-59,0.26
202502,50006003,3S4,1,2,-1,0.5
202502,50006003,CA,17,4,13,4.25
202502,50006003,V3,0,6,-6,0
202502,50110000,2,22,67,-45,0.33
202502,50110000,2S2,3,4,-1,0.75
202502,50110000,2S3,6,3,3,2
202502,50110000,3,4,31,-27,0.13
202502,50110000,3S1,16,0,16,NA
202502,50110000,3S2,541,79,462,6.85
202502,50110000,3S3,974,77,897,12.65
202502,50110000,3S4,1,0,1,NA
202502,50110000,CA,7,27,-20,0.26
202502,50110000,V3,0,13,-13,0
202502,50110001,3S3,16,0,16,NA
202502,50110004,3S2,0,1,-1,0
202502,50110004,3S3,0,3,-3,0
202502,50124000,2,23,84,-61,0.27
202502,50124000,2R3,0,1,-1,0
202502,50124000,2S2,4,5,-1,0.8
202502,50124000,2S3,7,6,1,1.17
202502,50124000,3,4,39,-35,0.1
202502,50124000,3S1,3,0,3,NA
202502,50124000,3S2,996,7,989,142.29
202502,50124000,3S3,2501,146,2355,17.13
202502,50124000,3S4,4,2,2,2
202502,50124000,CA,2,14,-12,0.14
202502,50124000,V2,0,48,-48,0
202502,50124000,V3,87,444,-357,0.2
202502,50124003,3S2,0,1,-1,0
202502,50124003,3S3,0,2,-2,0
202502,50150000,2,73,246,-173,0.3
202502,50150000,2S2,4,23,-19,0.17
202502,50150000,2S3,7,30,-23,0.23
202502,50150000,3,14,124,-110,0.11
202502,50150000,3S1,2,1,1,2
202502,50150000,3S2,170,258,-88,0.66
202502,50150000,3S3,125,258,-133,0.48
202502,50150000,3S4,1,2,-1,0.5
202502,50150000,CA,10,65,-55,0.15
202502,50150000,V2,21,50,-29,0.42
202502,50150000,V3,64,75,-11,0.85
202502,50150001,2,0,2,-2,0
202502,50150001,CA,0,2,-2,0
202502,50223000,2,0,18,-18,0
202502,50223000,3S2,0,1,-1,0
202502,50223000,3S3,0,4,-4,0
202502,50223000,CA,2,12,-10,0.17
202502,50226000,2,31,206,-175,0.15
202502,50226000,2B2,0,3,-3,0
202502,50226000,2R2,0,2,-2,0
202502,50226000,2S2,2,2,0,1
202502,50226000,2S3,2,0,2,NA
202502,50226000,3,7,58,-51,0.12
202502,50226000,3S2,65,8,57,8.12
202502,50226000,3S3,226,64,162,3.53
202502,50226000,CA,11,92,-81,0.12
202502,50226000,V2,5,0,5,NA
202502,50226004,2,1,1,0,1
202502,50226004,2S3,0,1,-1,0
202502,50226004,CA,0,1,-1,0
202502,50226005,2,1,3,-2,0.33
202502,50245000,CA,1,0,1,NA
202502,50251000,2,12,38,-26,0.32
202502,50251000,3S2,1,3,-2,0.33
202502,50251000,3S3,0,8,-8,0
202502,50251000,CA,1,19,-18,0.05
202502,50270000,2,3,9,-6,0.33
202502,50270000,3,0,4,-4,0
202502,50270000,CA,0,3,-3,0
202502,50270001,2,0,1,-1,0
202502,50287000,2,3,56,-53,0.05
202502,50287000,2B2,0,3,-3,0
202502,50287000,2R2,0,1,-1,0
202502,50287000,2S2,0,1,-1,0
202502,50287000,2S3,1,0,1,NA
202502,50287000,3,0,2,-2,0
202502,50287000,3S3,1,5,-4,0.2
202502,50287000,CA,0,6,-6,0
202502,50313000,2,129,1038,-909,0.12
202502,50313000,2B2,0,5,-5,0
202502,50313000,2R2,1,3,-2,0.33
202502,50313000,2S2,2,4,-2,0.5
202502,50313000,2S3,1,1,0,1
202502,50313000,3,6,52,-46,0.12
202502,50313000,3S2,4,20,-16,0.2
202502,50313000,3S3,148,305,-157,0.49
202502,50313000,3S4,0,1,-1,0
202502,50313000,4,1,0,1,NA
202502,50313000,CA,24,309,-285,0.08
202502,50313002,2,0,17,-17,0
202502,50313002,2R3,0,12,-12,0
202502,50313002,2S2,0,9,-9,0
202502,50313002,2S3,0,4,-4,0
202502,50313002,3,0,2,-2,0
202502,50313002,CA,0,1,-1,0
202502,50313007,2,1,1,0,1
202502,50318000,2,145,150,-5,0.97
202502,50318000,2B2,0,2,-2,0
202502,50318000,2S2,4,6,-2,0.67
202502,50318000,2S3,3,4,-1,0.75
202502,50318000,3,326,35,291,9.31
202502,50318000,3S1,11,1,10,11
202502,50318000,3S2,1156,221,935,5.23
202502,50318000,3S3,847,259,588,3.27
202502,50318000,4,1,1,0,1
202502,50318000,CA,7,61,-54,0.11
202502,50318000,V2,154,4,150,38.5
202502,50318000,V3,561,3,558,187
202502,50318001,2S2,1,1,0,1
202502,50318001,3S2,0,1,-1,0
202502,50318004,3S2,0,1,-1,0
202502,50325000,2,3,14,-11,0.21
202502,50325000,2S3,1,2,-1,0.5
202502,50325000,3,1,1,0,1
202502,50325000,3S2,9,2,7,4.5
202502,50325000,3S3,54,17,37,3.18
202502,50325000,CA,1,0,1,NA
202502,50325000,V3,1,0,1,NA
202502,50330000,2,1,46,-45,0.02
202502,50330000,3,0,8,-8,0
202502,50330000,4,1,2,-1,0.5
202502,50330000,CA,1,9,-8,0.11
202502,50330008,2,1,1,0,1
202502,50330008,3S3,1,0,1,NA
202502,50330008,CA,0,3,-3,0
202502,50350000,2,11,19,-8,0.58
202502,50350000,3S3,0,1,-1,0
202502,50350000,CA,1,0,1,NA
202502,50350003,CA,1,0,1,NA
202502,50370000,2,0,19,-19,0
202502,50370000,3S2,0,1,-1,0
202502,50370000,3S3,0,6,-6,0
202502,50370000,4,0,1,-1,0
202502,50370000,CA,1,3,-2,0.33
202502,50370001,2,0,1,-1,0
202502,50370001,CA,1,0,1,NA
202502,50400000,2,0,34,-34,0
202502,50400000,2S2,0,1,-1,0
202502,50400000,3,0,3,-3,0
202502,50400000,3S3,0,6,-6,0
202502,50400000,CA,1,28,-27,0.04
202502,50400001,2,0,1,-1,0
202502,50400001,3,0,1,-1,0
202502,50400001,3S3,0,3,-3,0
202502,50450000,2,3,12,-9,0.25
202502,50450000,2S3,0,2,-2,0
202502,50450000,3,0,1,-1,0
202502,50450000,3S2,0,1,-1,0
202502,50450000,3S3,0,3,-3,0
202502,50450000,CA,3,2,1,1.5
202502,50450001,2,1,0,1,NA
202502,50568000,2,209,966,-757,0.22
202502,50568000,2B2,0,3,-3,0
202502,50568000,2R2,0,1,-1,0
202502,50568000,2R3,0,4,-4,0
202502,50568000,2S1,5,3,2,1.67
202502,50568000,2S2,22,44,-22,0.5
202502,50568000,2S3,49,51,-2,0.96
202502,50568000,3,52,102,-50,0.51
202502,50568000,3S1,2,8,-6,0.25
202502,50568000,3S2,1168,378,790,3.09
202502,50568000,3S3,2890,1458,1432,1.98
202502,50568000,3S4,3,3,0,1
202502,50568000,4,0,1,-1,0
202502,50568000,CA,31,225,-194,0.14
202502,50568000,V2,0,1,-1,0
202502,50568000,V2R3,0,14,-14,0
202502,50568000,V3,2,2,0,1
202502,50568000,V3R2,0,30,-30,0
202502,50568000,V3R3,0,205,-205,0
202502,50568000,V4,1,0,1,NA
202502,50568001,2,0,9,-9,0
202502,50568001,2S2,2,0,2,NA
202502,50568002,2,0,1,-1,0
202502,50568002,CA,0,1,-1,0
202502,50568004,2,0,1,-1,0
202502,50568007,2,2,8,-6,0.25
202502,50568007,3S2,0,2,-2,0
202502,50568007,3S3,0,4,-4,0
202502,50568007,CA,1,0,1,NA
202502,50568010,2,13,17,-4,0.76
202502,50568010,2S2,1,8,-7,0.12
202502,50568010,2S3,13,19,-6,0.68
202502,50568010,3S2,3,0,3,NA
202502,50568010,3S3,11,30,-19,0.37
202502,50568010,3S4,1,3,-2,0.33
202502,50568010,4,0,1,-1,0
202502,50568010,CA,2,13,-11,0.15
202502,50568011,2,49,238,-189,0.21
202502,50568011,2S1,0,5,-5,0
202502,50568011,2S2,5,44,-39,0.11
202502,50568011,2S3,3,31,-28,0.1
202502,50568011,3,0,14,-14,0
202502,50568011,3R2,0,2,-2,0
202502,50568011,3R3,0,12,-12,0
202502,50568011,3S1,0,9,-9,0
202502,50568011,3S2,80,313,-233,0.26
202502,50568011,3S3,215,798,-583,0.27
202502,50568011,3S4,7,17,-10,0.41
202502,50568011,CA,4,62,-58,0.06
202502,50568011,V2R3,0,41,-41,0
202502,50568011,V3,1,0,1,NA
202502,50568011,V3R2,0,19,-19,0
202502,50568011,V3R3,0,151,-151,0
202502,50568011,V4R2,0,3,-3,0
202502,50573000,2,79,265,-186,0.3
202502,50573000,2B2,0,1,-1,0
202502,50573000,2R3,2,0,2,NA
202502,50573000,2S2,3,6,-3,0.5
202502,50573000,2S3,17,22,-5,0.77
202502,50573000,3,11,17,-6,0.65
202502,50573000,3R3,12,0,12,NA
202502,50573000,3S1,0,1,-1,0
202502,50573000,3S2,213,19,194,11.21
202502,50573000,3S3,670,215,455,3.12
202502,50573000,CA,7,65,-58,0.11
202502,50573000,V2,43,0,43,NA
202502,50573000,V2R3,56,0,56,NA
202502,50573000,V3,380,0,380,NA
202502,50573000,V3R2,43,0,43,NA
202502,50573000,V3R3,339,0,339,NA
202502,50573000,V4R2,1,0,1,NA
202502,50573001,3S3,4,0,4,NA
202502,50573001,V3R2,7,0,7,NA
202502,50573001,V3R3,3,0,3,NA
202502,50573003,2,4,5,-1,0.8
202502,50573003,3,0,1,-1,0
202502,50573003,3S2,1,0,1,NA
202502,50573003,3S3,12,5,7,2.4
202502,50573003,CA,1,5,-4,0.2
202502,50573003,V3R3,3,0,3,NA
202502,50577000,2,4,35,-31,0.11
202502,50577000,2S2,2,1,1,2
202502,50577000,3S3,0,3,-3,0
202502,50577000,CA,1,2,-1,0.5
202502,50590000,2,7,34,-27,0.21
202502,50590000,2S2,0,6,-6,0
202502,50590000,3,0,4,-4,0
202502,50590000,3S2,30,3,27,10
202502,50590000,3S3,117,22,95,5.32
202502,50590000,CA,2,8,-6,0.25
202502,50590000,V3,176,0,176,NA
202502,50606000,2,19,220,-201,0.09
202502,50606000,2B2,0,2,-2,0
202502,50606000,2R2,0,1,-1,0
202502,50606000,2S2,2,0,2,NA
202502,50606000,2S3,1,1,0,1
202502,50606000,3,1,60,-59,0.02
202502,50606000,3S2,3,17,-14,0.18
202502,50606000,3S3,42,57,-15,0.74
202502,50606000,4,0,2,-2,0
202502,50606000,CA,20,72,-52,0.28
202502,50606000,V3,0,4,-4,0
202502,50680000,2,21,84,-63,0.25
202502,50680000,2S2,1,8,-7,0.12
202502,50680000,2S3,4,4,0,1
202502,50680000,3,1,39,-38,0.03
202502,50680000,3S2,119,122,-3,0.98
202502,50680000,3S3,596,269,327,2.22
202502,50680000,3S4,0,1,-1,0
202502,50680000,CA,5,20,-15,0.25
202502,50680000,V2,0,2,-2,0
202502,50680000,V3,0,509,-509,0
202502,50680001,3S2,0,2,-2,0
202502,50680002,2,0,1,-1,0
202502,50680002,2S2,0,1,-1,0
202502,50680002,2S3,1,1,0,1
202502,50680002,3,0,1,-1,0
202502,50680003,2,1,1,0,1
202502,50680003,CA,0,1,-1,0
202502,50683000,2,3,12,-9,0.25
202502,50683000,3S2,6,1,5,6
202502,50683000,3S3,0,7,-7,0
202502,50683000,CA,1,13,-12,0.08
202502,50683000,V2,0,17,-17,0
202502,50683000,V3,0,11,-11,0
202502,50686000,CA,1,0,1,NA
202502,50689000,2,132,126,6,1.05
202502,50689000,2B2,0,1,-1,0
202502,50689000,2S2,2,0,2,NA
202502,50689000,3,16,13,3,1.23
202502,50689000,3S2,48,2,46,24
202502,50689000,3S3,356,60,296,5.93
202502,50689000,4,1,0,1,NA
202502,50689000,CA,53,52,1,1.02
202502,50689000,V2,0,1,-1,0
202502,50689000,V3,0,192,-192,0
202502,50711000,2,5,90,-85,0.06
202502,50711000,2S2,0,2,-2,0
202502,50711000,3,1,0,1,NA
202502,50711000,3S2,1,1,0,1
202502,50711000,3S3,1,15,-14,0.07
202502,50711000,CA,4,15,-11,0.27
202502,50711000,V3,1,2,-1,0.5
202502,50711002,2S2,0,1,-1,0
202502,52001000,2,3263,4494,-1231,0.73
202502,52001000,2B1,0,2,-2,0
202502,52001000,2R3,0,33,-33,0
202502,52001000,2S1,0,1,-1,0
202502,52001000,2S2,76,307,-231,0.25
202502,52001000,2S3,7,81,-74,0.09
202502,52001000,3,17,110,-93,0.15
202502,52001000,3S2,133,292,-159,0.46
202502,52001000,3S3,458,1544,-1086,0.3
202502,52001000,3S4,1,0,1,NA
202502,52001000,4,0,2,-2,0
202502,52001000,CA,1328,497,831,2.67
202502,52001000,V2,0,2,-2,0
202502,52001001,2,33,29,4,1.14
202502,52001001,3,1,1,0,1
202502,52001001,3S2,22,0,22,NA
202502,52001001,3S3,1,1,0,1
202502,52001001,CA,25,12,13,2.08
202502,52001001,V3,0,1,-1,0
202502,52001003,2,0,6,-6,0
202502,52001003,CA,0,29,-29,0
202502,52001004,2,1,0,1,NA
202502,52001004,3S3,0,1,-1,0
202502,52001006,2,7,13,-6,0.54
202502,52001006,3S3,0,1,-1,0
202502,52001006,CA,0,1,-1,0
202502,52001007,2,0,1,-1,0
202502,52001008,2,0,2,-2,0
202502,52001010,2,0,2,-2,0
202502,52001010,3S3,0,2,-2,0
202502,52001039,2,0,3,-3,0
202502,52001042,2,0,1,-1,0
202502,52001058,2,0,1,-1,0
202502,52001058,CA,0,1,-1,0
202502,52001060,2,0,1,-1,0
202502,52019000,2,0,23,-23,0
202502,52019000,3,0,1,-1,0
202502,52019003,2,0,2,-2,0
202502,52019003,CA,0,22,-22,0
202502,52022000,2,0,17,-17,0
202502,52022000,CA,0,20,-20,0
202502,52036000,2,1,4,-3,0.25
202502,52036000,CA,0,21,-21,0
202502,52036015,2,1,0,1,NA
202502,52051000,2,0,7,-7,0
202502,52051007,2,2,0,2,NA
202502,52079000,2,1,114,-113,0.01
202502,52079000,3S2,1,2,-1,0.5
202502,52079000,3S3,0,2,-2,0
202502,52079000,CA,0,30,-30,0
202502,52079012,3S3,0,1,-1,0
202502,52083000,2,7,14,-7,0.5
202502,52083000,CA,0,21,-21,0
202502,52110000,2,9,47,-38,0.19
202502,52110000,3,1,5,-4,0.2
202502,52110000,3S2,1,3,-2,0.33
202502,52110000,3S3,3,16,-13,0.19
202502,52110000,CA,0,20,-20,0
202502,52110000,V2,0,4,-4,0
202502,52110007,2,2,4,-2,0.5
202502,52203000,2,0,20,-20,0
202502,52203000,CA,0,32,-32,0
202502,52203007,2,1,5,-4,0.2
202502,52207000,2,1,26,-25,0.04
202502,52207000,3S3,2,6,-4,0.33
202502,52207000,4,1,0,1,NA
202502,52207000,CA,0,21,-21,0
202502,52210000,2,0,4,-4,0
202502,52210000,CA,0,7,-7,0
202502,52215000,2,0,26,-26,0
202502,52215000,3,0,2,-2,0
202502,52215000,CA,0,22,-22,0
202502,52215002,2,0,4,-4,0
202502,52215004,2,0,4,-4,0
202502,52224000,2,0,17,-17,0
202502,52224000,CA,0,4,-4,0
202502,52227000,2,5,98,-93,0.05
202502,52227000,3S3,2,20,-18,0.1
202502,52227000,CA,0,41,-41,0
202502,52233000,2,0,5,-5,0
202502,52233000,CA,0,4,-4,0
202502,52240000,2,5,30,-25,0.17
202502,52240000,2S2,0,1,-1,0
202502,52240000,3S2,4,4,0,1
202502,52240000,3S3,3,8,-5,0.38
202502,52240000,CA,40,35,5,1.14
202502,52250000,2,0,3,-3,0
202502,52250000,CA,0,1,-1,0
202502,52250006,CA,0,1,-1,0
202502,52254000,2,1,16,-15,0.06
202502,52254000,3S3,0,2,-2,0
202502,52256000,2,0,5,-5,0
202502,52256000,CA,0,20,-20,0
202502,52256003,2,0,2,-2,0
202502,52256021,3S3,0,4,-4,0
202502,52258000,2,2,28,-26,0.07
202502,52258000,3,0,1,-1,0
202502,52258000,3S3,0,1,-1,0
202502,52258000,CA,0,1,-1,0
202502,52258000,V3,1,0,1,NA
202502,52258001,3S3,0,1,-1,0
202502,52258003,2,0,4,-4,0
202502,52258003,CA,0,2,-2,0
202502,52260000,2,19,39,-20,0.49
202502,52260000,3,0,2,-2,0
202502,52260000,3S3,0,3,-3,0
202502,52260000,CA,0,16,-16,0
202502,52260009,2,1,1,0,1
202502,52287000,2,0,8,-8,0
202502,52287000,3S3,1,1,0,1
202502,52287000,CA,0,10,-10,0
202502,52317000,2,2,110,-108,0.02
202502,52317000,3,0,6,-6,0
202502,52317000,3S3,0,33,-33,0
202502,52317000,CA,0,27,-27,0
202502,52320000,2,1,21,-20,0.05
202502,52320000,3S3,0,2,-2,0
202502,52320000,CA,0,6,-6,0
202502,52320001,2,0,1,-1,0
202502,52320001,2S2,0,1,-1,0
202502,52320001,2S3,0,2,-2,0
202502,52320001,3S3,0,1,-1,0
202502,52320001,CA,0,2,-2,0
202502,52323000,2,0,11,-11,0
202502,52323000,3S3,0,1,-1,0
202502,52352000,2,2,19,-17,0.11
202502,52352000,3S2,0,1,-1,0
202502,52352000,3S4,0,2,-2,0
202502,52352000,CA,0,17,-17,0
202502,52354000,2,0,2,-2,0
202502,52354000,3,1,0,1,NA
202502,52354000,CA,0,12,-12,0
202502,52354000,V2,1,0,1,NA
202502,52354005,3S3,1,0,1,NA
202502,52354007,2,0,1,-1,0
202502,52354012,2,0,1,-1,0
202502,52356000,2,600,2917,-2317,0.21
202502,52356000,2R3,0,15,-15,0
202502,52356000,2S2,41,75,-34,0.55
202502,52356000,2S3,27,45,-18,0.6
202502,52356000,3,19,28,-9,0.68
202502,52356000,3S2,76,102,-26,0.75
202502,52356000,3S3,934,950,-16,0.98
202502,52356000,3S4,0,1,-1,0
202502,52356000,CA,194,327,-133,0.59
202502,52356003,2,0,26,-26,0
202502,52356003,3S3,0,64,-64,0
202502,52356006,2,0,1,-1,0
202502,52356009,2,0,3,-3,0
202502,52378000,2,4,55,-51,0.07
202502,52378000,3,0,11,-11,0
202502,52378000,3S3,0,7,-7,0
202502,52378000,CA,0,37,-37,0
202502,52378009,2,0,1,-1,0
202502,52381000,2,0,6,-6,0
202502,52381000,3S2,1,2,-1,0.5
202502,52381000,CA,0,23,-23,0
202502,52381001,2,0,1,-1,0
202502,52381002,2,0,1,-1,0
202502,52385000,2,1,18,-17,0.06
202502,52385000,3,0,1,-1,0
202502,52385000,CA,0,9,-9,0
202502,52385007,3S3,0,2,-2,0
202502,52399000,2,118,332,-214,0.36
202502,52399000,3,2,8,-6,0.25
202502,52399000,3S3,7,46,-39,0.15
202502,52399000,CA,22,80,-58,0.28
202502,52399000,V2,2,0,2,NA
202502,52405000,2,1,16,-15,0.06
202502,52405000,CA,0,1,-1,0
202502,52405000,V2,0,1,-1,0
202502,52405001,2,0,2,-2,0
202502,52405005,3S3,0,6,-6,0
202502,52405006,2,0,1,-1,0
202502,52405007,2,0,1,-1,0
202502,52405008,2,2,0,2,NA
202502,52405008,CA,0,10,-10,0
202502,52405009,3S2,0,1,-1,0
202502,52411000,2,1,47,-46,0.02
202502,52411000,3S3,0,2,-2,0
202502,52411000,CA,0,26,-26,0
202502,52418000,2,1,24,-23,0.04
202502,52418000,3S3,0,1,-1,0
202502,52418000,CA,0,1,-1,0
202502,52427000,2,0,2,-2,0
202502,52427006,2,0,1,-1,0
202502,52435000,2,1,5,-4,0.2
202502,52435000,CA,0,12,-12,0
202502,52473000,2,5,2,3,2.5
202502,52473000,3S3,0,2,-2,0
202502,52473000,CA,3,1,2,3
202502,52473004,CA,0,2,-2,0
202502,52473010,2,0,7,-7,0
202502,52480000,2,16,12,4,1.33
202502,52480000,3,2,3,-1,0.67
202502,52480000,3S2,0,2,-2,0
202502,52480000,3S3,1,2,-1,0.5
202502,52480000,CA,0,2,-2,0
202502,52490000,CA,0,3,-3,0
202502,52506000,2,1,6,-5,0.17
202502,52506000,3S2,0,1,-1,0
202502,52506000,3S3,0,1,-1,0
202502,52506000,CA,0,10,-10,0
202502,52520000,CA,0,2,-2,0
202502,52520003,2,0,4,-4,0
202502,52540000,2,0,18,-18,0
202502,52540000,3S2,0,1,-1,0
202502,52540000,3S3,0,1,-1,0
202502,52540000,CA,0,4,-4,0
202502,52540002,2,0,4,-4,0
202502,52540006,2,0,1,-1,0
202502,52560000,2,0,6,-6,0
202502,52560000,3,1,1,0,1
202502,52560000,CA,0,24,-24,0
202502,52560005,CA,0,1,-1,0
202502,52565000,2,6,4,2,1.5
202502,52565000,CA,0,12,-12,0
202502,52573000,2,2,20,-18,0.1
202502,52573000,3S3,0,2,-2,0
202502,52573000,CA,0,25,-25,0
202502,52573004,CA,0,1,-1,0
202502,52585000,2,3,93,-90,0.03
202502,52585000,3S3,1,9,-8,0.11
202502,52585000,CA,0,47,-47,0
202502,52612000,2,3,39,-36,0.08
202502,52612000,3S2,1,0,1,NA
202502,52612000,CA,0,14,-14,0
202502,52621000,2,0,2,-2,0
202502,52678000,2,9,93,-84,0.1
202502,52678000,3S2,3,3,0,1
202502,52678000,3S3,0,3,-3,0
202502,52678000,CA,0,30,-30,0
202502,52678017,2,1,10,-9,0.1
202502,52678017,2S2,0,1,-1,0
202502,52678017,2S3,0,25,-25,0
202502,52678017,CA,0,1,-1,0
202502,52683000,2,38,65,-27,0.58
202502,52683000,3S2,1,0,1,NA
202502,52683000,3S3,5,13,-8,0.38
202502,52683000,CA,0,35,-35,0
202502,52683021,3S3,0,1,-1,0
202502,52685000,2,9,36,-27,0.25
202502,52685000,CA,0,8,-8,0
202502,52687000,2,1,20,-19,0.05
202502,52687000,3S3,0,11,-11,0
202502,52687000,CA,0,22,-22,0
202502,52693000,2,3,85,-82,0.04
202502,52693000,2S3,0,1,-1,0
202502,52693000,3,0,4,-4,0
202502,52693000,3S3,0,5,-5,0
202502,52693000,CA,1,30,-29,0.03
202502,52694000,3S2,1,0,1,NA
202502,52699000,2,0,1,-1,0
202502,52699000,CA,0,1,-1,0
202502,52720000,2,0,15,-15,0
202502,52720000,3S2,0,1,-1,0
202502,52720000,3S3,0,1,-1,0
202502,52720000,CA,1,5,-4,0.2
202502,52720001,2,2,1,1,2
202502,52720001,3S2,0,2,-2,0
202502,52720001,3S3,0,1,-1,0
202502,52786000,2,4,55,-51,0.07
202502,52786000,2S3,0,1,-1,0
202502,52786000,3,0,7,-7,0
202502,52786000,3S2,0,3,-3,0
202502,52786000,3S3,0,2,-2,0
202502,52786000,CA,0,38,-38,0
202502,52786002,2,0,1,-1,0
202502,52786019,2,4,18,-14,0.22
202502,52786019,3,0,2,-2,0
202502,52786019,3S2,8,1,7,8
202502,52786019,3S3,0,9,-9,0
202502,52786019,CA,0,1,-1,0
202502,52788000,2,3,6,-3,0.5
202502,52788000,3S3,0,6,-6,0
202502,52788000,CA,1,22,-21,0.05
202502,52788000,V2,1,0,1,NA
202502,52835000,2,58,1242,-1184,0.05
202502,52835000,2R3,0,1,-1,0
202502,52835000,2S2,1,6,-5,0.17
202502,52835000,2S3,1,1,0,1
202502,52835000,3,21,39,-18,0.54
202502,52835000,3S2,2,13,-11,0.15
202502,52835000,3S3,114,261,-147,0.44
202502,52835000,CA,22,135,-113,0.16
202502,52835030,2,0,1,-1,0
202502,52835031,2,7,82,-75,0.09
202502,52835031,3,2,0,2,NA
202502,52835031,3S2,4,0,4,NA
202502,52835031,3S3,26,5,21,5.2
202502,52835031,CA,0,2,-2,0
202502,52835062,3S3,0,2,-2,0
202502,52835143,2S2,0,2,-2,0
202502,52835160,3S2,1,0,1,NA
202502,52835160,3S3,8,0,8,NA
202502,52835163,3,0,12,-12,0
202502,52838000,2,29,324,-295,0.09
202502,52838000,2S2,1,4,-3,0.25
202502,52838000,3,0,3,-3,0
202502,52838000,3S2,1,0,1,NA
202502,52838000,3S3,2,48,-46,0.04
202502,52838000,CA,102,77,25,1.32
202502,52838001,2,0,2,-2,0
202502,52885000,2,0,19,-19,0
202502,52885000,3S2,1,0,1,NA
202502,52885000,3S3,0,2,-2,0
202502,52885000,CA,0,15,-15,0
202502,54001000,2,4303,8938,-4635,0.48
202502,54001000,2B1,1,8,-7,0.12
202502,54001000,2R2,94,18,76,5.22
202502,54001000,2R3,0,70,-70,0
202502,54001000,2S1,0,6,-6,0
202502,54001000,2S2,145,385,-240,0.38
202502,54001000,2S3,43,129,-86,0.33
202502,54001000,3,222,304,-82,0.73
202502,54001000,3R3,0,24,-24,0
202502,54001000,3S1,0,3,-3,0
202502,54001000,3S2,234,499,-265,0.47
202502,54001000,3S3,3470,3916,-446,0.89
202502,54001000,3S4,1,0,1,NA
202502,54001000,4,2,5,-3,0.4
202502,54001000,CA,991,1300,-309,0.76
202502,54001000,V2,399,197,202,2.03
202502,54001000,V3,73,17,56,4.29
202502,54001000,V4,16,421,-405,0.04
202502,54001001,2,0,20,-20,0
202502,54001001,3S3,0,37,-37,0
202502,54001001,CA,0,24,-24,0
202502,54001017,3S3,52,0,52,NA
202502,54001018,3S3,0,1,-1,0
202502,54001018,V2,78,0,78,NA
202502,54001025,2,0,4,-4,0
202502,54001025,3S3,0,1,-1,0
202502,54001026,2S2,1,1,0,1
202502,54001026,3S2,0,1,-1,0
202502,54001026,3S3,0,3,-3,0
202502,54001027,2,1,0,1,NA
202502,54001030,2S2,0,1,-1,0
202502,54001042,2,2,8,-6,0.25
202502,54001042,3,1,0,1,NA
202502,54001042,3S3,0,26,-26,0
202502,54001045,2,1,0,1,NA
202502,54001046,3S3,67,0,67,NA
202502,54001047,2,0,8,-8,0
202502,54001047,2S2,0,1,-1,0
202502,54001047,3,0,8,-8,0
202502,54001049,2S2,0,1,-1,0
202502,54003000,2,29,278,-249,0.1
202502,54003000,2S2,0,1,-1,0
202502,54003000,3,0,8,-8,0
202502,54003000,3S3,1,28,-27,0.04
202502,54003000,CA,0,9,-9,0
202502,54003020,2,0,1,-1,0
202502,54051000,2,1,21,-20,0.05
202502,54051000,CA,0,30,-30,0
202502,54099000,2,26,27,-1,0.96
202502,54099000,3R3,24,0,24,NA
202502,54099000,3S2,0,4,-4,0
202502,54099000,3S3,388,6,382,64.67
202502,54099000,CA,0,1,-1,0
202502,54099000,V2,73,1,72,73
202502,54099000,V3,28,0,28,NA
202502,54099002,2,13,4,9,3.25
202502,54099002,2S2,3,2,1,1.5
202502,54099002,3S3,10,1,9,10
202502,54099002,V2,39,0,39,NA
202502,54099002,V3,7,0,7,NA
202502,54109000,2,4,27,-23,0.15
202502,54109003,2S2,1,0,1,NA
202502,54125000,2S2,0,2,-2,0
202502,54125002,2S2,1,0,1,NA
202502,54128000,2,2,0,2,NA
202502,54128000,3,0,1,-1,0
202502,54128000,CA,0,6,-6,0
202502,54172000,2,5,96,-91,0.05
202502,54172000,2S2,0,1,-1,0
202502,54172000,3,0,10,-10,0
202502,54172000,3S2,1,1,0,1
202502,54172000,3S3,1,6,-5,0.17
202502,54172000,CA,1,35,-34,0.03
202502,54172000,V2,0,32,-32,0
202502,54172001,3S3,0,1,-1,0
202502,54174000,2,23,16,7,1.44
202502,54174000,2S2,1,2,-1,0.5
202502,54174000,2S3,1,0,1,NA
202502,54174000,3S3,1,7,-6,0.14
202502,54174000,CA,0,11,-11,0
202502,54174000,V2,32,0,32,NA
202502,54206000,2,0,12,-12,0
202502,54206010,2,1,3,-2,0.33
202502,54206010,3,8,1,7,8
202502,54206010,3S3,9,6,3,1.5
202502,54206013,2,0,36,-36,0
202502,54206013,2S2,0,1,-1,0
202502,54206013,2S3,0,1,-1,0
202502,54206013,CA,0,4,-4,0
202502,54223000,2,8,11,-3,0.73
202502,54223000,2S2,0,1,-1,0
202502,54223000,3S2,0,1,-1,0
202502,54223000,3S3,0,2,-2,0
202502,54223000,CA,0,24,-24,0
202502,54239000,2,3,18,-15,0.17
202502,54239000,CA,0,1,-1,0
202502,54239000,V2,24,0,24,NA
202502,54245000,2,1,3,-2,0.33
202502,54250000,2,0,11,-11,0
202502,54250000,3,0,2,-2,0
202502,54250000,CA,0,1,-1,0
202502,54261000,2,75,222,-147,0.34
202502,54261000,2S2,2,1,1,2
202502,54261000,2S3,1,0,1,NA
202502,54261000,3,14,13,1,1.08
202502,54261000,3S2,8,1,7,8
202502,54261000,3S3,1570,54,1516,29.07
202502,54261000,CA,1,72,-71,0.01
202502,54261000,V2,15,209,-194,0.07
202502,54261000,V3,14,0,14,NA
202502,54261000,V4,21,0,21,NA
202502,54261003,2,3,11,-8,0.27
202502,54261005,2,2,0,2,NA
202502,54261005,3S2,1,0,1,NA
202502,54261007,2,1,0,1,NA
202502,54261007,2S2,3,2,1,1.5
202502,54261007,3S2,3,3,0,1
202502,54261007,3S3,2,0,2,NA
202502,54261007,CA,0,24,-24,0
202502,54313000,2,0,1,-1,0
202502,54313000,2S2,0,1,-1,0
202502,54313000,3S3,0,3,-3,0
202502,54344000,2,0,2,-2,0
202502,54347000,2,0,1,-1,0
202502,54347000,V2,32,0,32,NA
202502,54377000,2,0,7,-7,0
202502,54377000,CA,0,29,-29,0
202502,54385000,2,39,22,17,1.77
202502,54385000,3,0,4,-4,0
202502,54385000,3S3,28,7,21,4
202502,54385000,CA,0,10,-10,0
202502,54385000,V2,1,0,1,NA
202502,54385000,V3,1,0,1,NA
202502,54385003,2,0,1,-1,0
202502,54398000,2,0,8,-8,0
202502,54405000,2,603,424,179,1.42
202502,54405000,2R3,0,3,-3,0
202502,54405000,2S2,3,15,-12,0.2
202502,54405000,2S3,0,9,-9,0
202502,54405000,3,82,18,64,4.56
202502,54405000,3S2,4,3,1,1.33
202502,54405000,3S3,290,793,-503,0.37
202502,54405000,4,0,1,-1,0
202502,54405000,CA,14,120,-106,0.12
202502,54405000,V2,187,86,101,2.17
202502,54405000,V3,0,34,-34,0
202502,54405001,2S2,0,1,-1,0
202502,54405003,2,17,0,17,NA
202502,54405003,3S3,1,0,1,NA
202502,54405004,2,4,0,4,NA
202502,54405004,2S2,1,0,1,NA
202502,54405004,3,1,0,1,NA
202502,54418000,2,0,2,-2,0
202502,54480000,2,2,6,-4,0.33
202502,54480001,2,0,7,-7,0
202502,54480001,3S3,0,1,-1,0
202502,54498000,2,261,2332,-2071,0.11
202502,54498000,2R2,0,2,-2,0
202502,54498000,2S2,1,4,-3,0.25
202502,54498000,3,4,116,-112,0.03
202502,54498000,3S2,0,6,-6,0
202502,54498000,3S3,16,323,-307,0.05
202502,54498000,CA,8,140,-132,0.06
202502,54498000,V2,0,1,-1,0
202502,54498000,V3,0,13,-13,0
202502,54498001,2,0,5,-5,0
202502,54498003,3S3,0,3,-3,0
202502,54498009,2,0,1,-1,0
202502,54498011,2,0,4,-4,0
202502,54498021,CA,0,3,-3,0
202502,54518000,2,10,444,-434,0.02
202502,54518000,3,0,15,-15,0
202502,54518000,3S1,0,1,-1,0
202502,54518000,3S2,0,1,-1,0
202502,54518000,3S3,464,66,398,7.03
202502,54518000,CA,2,75,-73,0.03
202502,54518000,V2,0,32,-32,0
202502,54520000,2,2,12,-10,0.17
202502,54520000,2S2,0,1,-1,0
202502,54520000,3S3,7,0,7,NA
202502,54520000,V2,34,0,34,NA
202502,54520001,2,1,0,1,NA
202502,54520001,3S3,0,2,-2,0
202502,54553000,2,1,39,-38,0.03
202502,54553000,2S2,0,1,-1,0
202502,54553000,3,0,5,-5,0
202502,54553000,3S3,1,5,-4,0.2
202502,54553000,CA,1,32,-31,0.03
202502,54599000,2,1,5,-4,0.2
202502,54660000,2,21,10,11,2.1
202502,54660000,2S2,2,0,2,NA
202502,54660000,3S2,1,0,1,NA
202502,54660000,CA,0,30,-30,0
202502,54660000,V2,20,0,20,NA
202502,54670000,2,0,1,-1,0
202502,54673000,2,3,70,-67,0.04
202502,54673000,2S2,11,0,11,NA
202502,54673000,2S3,1,0,1,NA
202502,54673000,3,0,17,-17,0
202502,54673000,3S2,2,0,2,NA
202502,54673000,3S3,368,7,361,52.57
202502,54673000,CA,0,27,-27,0
202502,54673000,V2,0,403,-403,0
202502,54673000,V3,0,353,-353,0
202502,54673000,V4,24,58,-34,0.41
202502,54673002,2,1,1,0,1
202502,54673005,2,0,1,-1,0
202502,54673005,2S2,2,2,0,1
202502,54673005,3S3,16,1,15,16
202502,54673005,V2,0,95,-95,0
202502,54673005,V3,0,5,-5,0
202502,54680000,2,1,5,-4,0.2
202502,54680000,2S2,0,3,-3,0
202502,54680000,CA,0,24,-24,0
202502,54680000,V2,1,29,-28,0.03
202502,54680000,V3,5,0,5,NA
202502,54720000,2,48,87,-39,0.55
202502,54720000,2S2,2,0,2,NA
202502,54720000,2S3,2,0,2,NA
202502,54720000,3,16,8,8,2
202502,54720000,3S2,9,0,9,NA
202502,54720000,3S3,3291,25,3266,131.64
202502,54720000,4,1,0,1,NA
202502,54720000,CA,1,6,-5,0.17
202502,54720000,V2,197,1,196,197
202502,54720000,V3,297,0,297,NA
202502,54720000,V4,435,1,434,435
202502,54720002,2,0,9,-9,0
202502,54720024,2,0,6,-6,0
202502,54720024,3,0,1,-1,0
202502,54743000,2,0,17,-17,0
202502,54743000,CA,0,8,-8,0
202502,54800000,2,0,2,-2,0
202502,54810000,2,11,102,-91,0.11
202502,54810000,2S2,1,1,0,1
202502,54810000,3,0,12,-12,0
202502,54810000,3S1,2,0,2,NA
202502,54810000,3S2,19,2,17,9.5
202502,54810000,3S3,452,83,369,5.45
202502,54810000,CA,0,31,-31,0
202502,54810000,V2,0,1,-1,0
202502,54810002,2,0,1,-1,0
202502,54810008,2,1,0,1,NA
202502,54810017,2,0,1,-1,0
202502,54810017,2S2,0,1,-1,0
202502,54810017,3S2,9,0,9,NA
202502,54810017,3S3,101,2,99,50.5
202502,54810017,CA,0,24,-24,0
202502,54820000,2,3,42,-39,0.07
202502,54820000,2S2,0,1,-1,0
202502,54820000,3,0,1,-1,0
202502,54820000,3S2,4,2,2,2
202502,54820000,3S3,189,2,187,94.5
202502,54820000,CA,1,25,-24,0.04
202502,54820008,2,2,1,1,2
202502,54820008,CA,0,1,-1,0
202502,54820015,2,1,3,-2,0.33
202502,54820015,3,1,0,1,NA
202502,54871000,2,0,3,-3,0
202502,54871000,CA,0,1,-1,0
202502,54874000,2,156,351,-195,0.44
202502,54874000,2B1,0,1,-1,0
202502,54874000,2R3,0,1,-1,0
202502,54874000,2S2,1,3,-2,0.33
202502,54874000,2S3,1,0,1,NA
202502,54874000,3,5,14,-9,0.36
202502,54874000,3S2,7,14,-7,0.5
202502,54874000,3S3,62,642,-580,0.1
202502,54874000,CA,2,268,-266,0.01
202502,54874000,V2,0,15,-15,0
202502,54874001,2,1,0,1,NA
202502,54874005,2,14,2,12,7
202502,54874005,3S3,4,1,3,4
202502,54874007,3S3,30,0,30,NA
202502,63001000,2,1986,4848,-2862,0.41
202502,63001000,2R2,0,23,-23,0
202502,63001000,2R3,0,14,-14,0
202502,63001000,2S2,26,178,-152,0.15
202502,63001000,2S3,5,37,-32,0.14
202502,63001000,3,99,254,-155,0.39
202502,63001000,3S1,0,1,-1,0
202502,63001000,3S2,32,64,-32,0.5
202502,63001000,3S3,543,1267,-724,0.43
202502,63001000,4,12,3,9,4
202502,63001000,CA,458,1383,-925,0.33
202502,63001000,V2R2,1,0,1,NA
202502,63001001,2,10,6,4,1.67
202502,63001001,3S3,4,0,4,NA
202502,63111000,2,32,19,13,1.68
202502,63111000,3,1,5,-4,0.2
202502,63111000,3S3,0,1,-1,0
202502,63111000,CA,0,2,-2,0
202502,63130000,2,132,655,-523,0.2
202502,63130000,2R3,0,1,-1,0
202502,63130000,2S2,1,5,-4,0.2
202502,63130000,2S3,1,1,0,1
202502,63130000,3,1,46,-45,0.02
202502,63130000,3S2,123,111,12,1.11
202502,63130000,3S3,65,383,-318,0.17
202502,63130000,4,0,2,-2,0
202502,63130000,CA,20,154,-134,0.13
202502,63130000,V2,1,0,1,NA
202502,63130000,V2R2,1,1,0,1
202502,63130000,V3,1,0,1,NA
202502,63130001,2,6,15,-9,0.4
202502,63130001,CA,0,2,-2,0
202502,63130001,V3,0,1,-1,0
202502,63130004,2,0,2,-2,0
202502,63130004,CA,0,2,-2,0
202502,63190000,2,50,206,-156,0.24
202502,63190000,2S2,0,1,-1,0
202502,63190000,3,0,59,-59,0
202502,63190000,3S3,0,4,-4,0
202502,63190000,CA,6,62,-56,0.1
202502,63190000,V2,0,1,-1,0
202502,63212000,2,1,28,-27,0.04
202502,63212000,CA,0,9,-9,0
202502,63272000,2,26,99,-73,0.26
202502,63272000,3S3,0,16,-16,0
202502,63272000,CA,1,35,-34,0.03
202502,63272000,V2,0,4,-4,0
202502,63272000,V2R2,2,2,0,1
202502,63302000,2,5,29,-24,0.17
202502,63302000,3,0,1,-1,0
202502,63302000,3S3,0,1,-1,0
202502,63302000,CA,0,36,-36,0
202502,63401000,2,945,831,114,1.14
202502,63401000,2B1,1,0,1,NA
202502,63401000,2R2,46,6,40,7.67
202502,63401000,2R3,0,9,-9,0
202502,63401000,2S2,51,34,17,1.5
202502,63401000,2S3,11,22,-11,0.5
202502,63401000,3,4,6,-2,0.67
202502,63401000,3S2,170,40,130,4.25
202502,63401000,3S3,95,168,-73,0.57
202502,63401000,3S4,1,0,1,NA
202502,63401000,CA,17,192,-175,0.09
202502,63401000,V2R2,0,1,-1,0
202502,63401001,2S2,1,8,-7,0.12
202502,63401001,2S3,5,2,3,2.5
202502,63401001,3S2,2,15,-13,0.13
202502,63401001,3S3,3,5,-2,0.6
202502,63470000,2,91,303,-212,0.3
202502,63470000,2S2,0,1,-1,0
202502,63470000,3,0,14,-14,0
202502,63470000,3S2,0,8,-8,0
202502,63470000,3S3,0,14,-14,0
202502,63470000,4,0,1,-1,0
202502,63470000,CA,1,110,-109,0.01
202502,63470003,2,14,12,2,1.17
202502,63470003,3S3,0,3,-3,0
202502,63470003,CA,0,1,-1,0
202502,63548000,2,36,44,-8,0.82
202502,63548000,3,1,3,-2,0.33
202502,63548000,CA,0,15,-15,0
202502,63548001,2,0,1,-1,0
202502,63594000,2,320,331,-11,0.97
202502,63594000,2S3,0,1,-1,0
202502,63594000,3,0,83,-83,0
202502,63594000,3S2,0,1,-1,0
202502,63594000,3S3,29,24,5,1.21
202502,63594000,CA,3,147,-144,0.02
202502,63594000,V2R2,0,1,-1,0
202502,63594005,2,0,2,-2,0
202502,63690000,2,6,111,-105,0.05
202502,63690000,3S3,0,1,-1,0
202502,63690000,CA,0,44,-44,0
202502,63690003,2,0,1,-1,0
202502,63690003,CA,1,0,1,NA
202502,66001000,2,11560,9320,2240,1.24
202502,66001000,2B2,2,0,2,NA
202502,66001000,2R2,175,3,172,58.33
202502,66001000,2R3,0,57,-57,0
202502,66001000,2S1,2,19,-17,0.11
202502,66001000,2S2,1349,1389,-40,0.97
202502,66001000,2S3,219,378,-159,0.58
202502,66001000,3,347,189,158,1.84
202502,66001000,3S1,0,2,-2,0
202502,66001000,3S2,544,883,-339,0.62
202502,66001000,3S3,1345,3095,-1750,0.43
202502,66001000,3S4,5,4,1,1.25
202502,66001000,4,2,2,0,1
202502,66001000,CA,3152,3013,139,1.05
202502,66001000,V3,0,1,-1,0
202502,66001001,2,1,0,1,NA
202502,66001005,2,103,11,92,9.36
202502,66001005,3,0,44,-44,0
202502,66001015,2,0,5,-5,0
202502,66001015,3S2,1,0,1,NA
202502,66001018,2,1,2,-1,0.5
202502,66001018,2S2,2,1,1,2
202502,66001018,3S3,0,8,-8,0
202502,66001031,2,0,1,-1,0
202502,66001036,2,0,1,-1,0
202502,66001051,2,1,0,1,NA
202502,66001053,2,0,14,-14,0
202502,66001053,3S3,0,1,-1,0
202502,66001056,2,2,1,1,2
202502,66001058,2,0,3,-3,0
202502,66001072,2,31,3,28,10.33
202502,66001072,3,0,5,-5,0
202502,66001080,2,11,520,-509,0.02
202502,66001080,3S2,7,0,7,NA
202502,66045000,2,9,116,-107,0.08
202502,66045000,3S3,0,3,-3,0
202502,66045000,CA,0,36,-36,0
202502,66045001,2S2,0,3,-3,0
202502,66045002,CA,0,1,-1,0
202502,66075000,2,15,36,-21,0.42
202502,66075000,3,0,1,-1,0
202502,66075000,3S2,0,2,-2,0
202502,66075000,3S3,361,69,292,5.23
202502,66075000,CA,0,12,-12,0
202502,66075006,2,0,1,-1,0
202502,66075006,CA,0,13,-13,0
202502,66088000,2,18,161,-143,0.11
202502,66088000,3,0,1,-1,0
202502,66088000,3S2,1,2,-1,0.5
202502,66088000,3S3,1,2,-1,0.5
202502,66088000,CA,3,79,-76,0.04
202502,66170000,2,8956,3881,5075,2.31
202502,66170000,2B1,0,1,-1,0
202502,66170000,2B2,1,0,1,NA
202502,66170000,2R2,6,1,5,6
202502,66170000,2R3,0,13,-13,0
202502,66170000,2S2,239,239,0,1
202502,66170000,2S3,106,113,-7,0.94
202502,66170000,3,65,219,-154,0.3
202502,66170000,3S2,481,652,-171,0.74
202502,66170000,3S3,1216,1230,-14,0.99
202502,66170000,3S4,2,0,2,NA
202502,66170000,CA,6065,696,5369,8.71
202502,66170000,V3,0,1,-1,0
202502,66170008,2,0,1,-1,0
202502,66170009,3S3,0,2,-2,0
202502,66170011,2,0,1,-1,0
202502,66318000,2,33,73,-40,0.45
202502,66318000,3,0,1,-1,0
202502,66318000,3S2,28,19,9,1.47
202502,66318000,3S3,58,25,33,2.32
202502,66318000,CA,0,27,-27,0
202502,66318002,3S2,2,0,2,NA
202502,66318002,3S3,2,0,2,NA
202502,66383000,2,2,22,-20,0.09
202502,66383000,3,0,1,-1,0
202502,66383000,3S2,0,1,-1,0
202502,66383000,CA,0,19,-19,0
202502,66400000,2,869,510,359,1.7
202502,66400000,2R3,1,5,-4,0.2
202502,66400000,2S2,3,16,-13,0.19
202502,66400000,2S3,2,10,-8,0.2
202502,66400000,3,7,8,-1,0.88
202502,66400000,3S2,24,33,-9,0.73
202502,66400000,3S3,92,133,-41,0.69
202502,66400000,4,0,1,-1,0
202502,66400000,CA,9,131,-122,0.07
202502,66440000,2,13,68,-55,0.19
202502,66440000,3S2,0,2,-2,0
202502,66440000,CA,0,61,-61,0
202502,66440009,2,0,1,-1,0
202502,66456000,2,3,92,-89,0.03
202502,66456000,3,0,2,-2,0
202502,66456000,3S2,0,1,-1,0
202502,66456000,3S3,1,2,-1,0.5
202502,66456000,CA,0,115,-115,0
202502,66572000,2,3,66,-63,0.05
202502,66572000,2S3,0,1,-1,0
202502,66572000,3,0,2,-2,0
202502,66572000,3S2,0,3,-3,0
202502,66572000,CA,0,161,-161,0
202502,66572001,2,0,7,-7,0
202502,66572001,3,0,1,-1,0
202502,66572001,CA,0,2,-2,0
202502,66594000,2,2,125,-123,0.02
202502,66594000,3S2,0,4,-4,0
202502,66594000,3S4,1,0,1,NA
202502,66594000,CA,0,56,-56,0
202502,66594002,2,3,8,-5,0.38
202502,66594002,2S2,1,3,-2,0.33
202502,66594002,3,1,2,-1,0.5
202502,66594002,3S3,0,25,-25,0
202502,66594002,CA,0,1,-1,0
202502,66682000,2,163,774,-611,0.21
202502,66682000,2R3,0,1,-1,0
202502,66682000,2S2,27,19,8,1.42
202502,66682000,2S3,2,2,0,1
202502,66682000,3,5,11,-6,0.45
202502,66682000,3S2,3,5,-2,0.6
202502,66682000,3S3,77,84,-7,0.92
202502,66682000,CA,10,307,-297,0.03
202502,66687000,2,6,97,-91,0.06
202502,66687000,3,0,10,-10,0
202502,66687000,3S3,0,2,-2,0
202502,66687000,CA,1,22,-21,0.05
202502,68001000,2,13132,12617,515,1.04
202502,68001000,2B1,0,4,-4,0
202502,68001000,2B2,2,2,0,1
202502,68001000,2R2,1,46,-45,0.02
202502,68001000,2R3,0,17,-17,0
202502,68001000,2S1,2,0,2,NA
202502,68001000,2S2,132,598,-466,0.22
202502,68001000,2S3,52,192,-140,0.27
202502,68001000,3,1276,410,866,3.11
202502,68001000,3S1,0,5,-5,0
202502,68001000,3S2,462,656,-194,0.7
202502,68001000,3S3,2677,6293,-3616,0.43
202502,68001000,3S4,1,0,1,NA
202502,68001000,4,0,4,-4,0
202502,68001000,CA,1864,3870,-2006,0.48
202502,68001000,V2,17,382,-365,0.04
202502,68001000,V3,19,2,17,9.5
202502,68001002,2,0,3,-3,0
202502,68001002,2S2,3,0,3,NA
202502,68001002,2S3,3,1,2,3
202502,68001005,3S3,10,0,10,NA
202502,68001006,2,3,0,3,NA
202502,68001006,3,0,3,-3,0
202502,68001006,3S3,0,19,-19,0
202502,68001010,2,10,42,-32,0.24
202502,68001010,3,1,10,-9,0.1
202502,68001010,3S3,3,25,-22,0.12
202502,68051000,2,37,164,-127,0.23
202502,68051000,2S2,0,1,-1,0
202502,68051000,2S3,0,1,-1,0
202502,68051000,3,0,38,-38,0
202502,68051000,3S3,3,1,2,3
202502,68051000,CA,1,8,-7,0.12
202502,68077000,2,99,659,-560,0.15
202502,68077000,2S2,0,18,-18,0
202502,68077000,2S3,1,1,0,1
202502,68077000,3,6,22,-16,0.27
202502,68077000,3S2,10,18,-8,0.56
202502,68077000,3S3,1,170,-169,0.01
202502,68077000,3S4,2,0,2,NA
202502,68077000,CA,5,79,-74,0.06
202502,68077000,V2,0,17,-17,0
202502,68077001,2,0,1,-1,0
202502,68079000,2,2,45,-43,0.04
202502,68079000,CA,1,8,-7,0.12
202502,68081000,2,1531,2770,-1239,0.55
202502,68081000,2R2,0,57,-57,0
202502,68081000,2S2,8,96,-88,0.08
202502,68081000,2S3,39,39,0,1
202502,68081000,3,151,485,-334,0.31
202502,68081000,3R3,0,1,-1,0
202502,68081000,3S1,11,4,7,2.75
202502,68081000,3S2,498,486,12,1.02
202502,68081000,3S3,5866,3461,2405,1.69
202502,68081000,3S3S2,11,12,-1,0.92
202502,68081000,3S4,0,8,-8,0
202502,68081000,4,0,14,-14,0
202502,68081000,CA,251,623,-372,0.4
202502,68081000,V2,47,24,23,1.96
202502,68081000,V3,95,108,-13,0.88
202502,68081001,2,5,4,1,1.25
202502,68081001,2S3,3,0,3,NA
202502,68081001,3,1,2,-1,0.5
202502,68081001,3S2,0,3,-3,0
202502,68081001,3S3,6,10,-4,0.6
202502,68081001,CA,0,3,-3,0
202502,68081002,3S2,1,3,-2,0.33
202502,68081002,3S3,1,2,-1,0.5
202502,68081002,3S3S2,1,1,0,1
202502,68081002,CA,0,3,-3,0
202502,68081003,2,10,12,-2,0.83
202502,68081003,3S2,1,0,1,NA
202502,68081003,3S3,23,61,-38,0.38
202502,68081003,CA,1,4,-3,0.25
202502,68081006,2,0,1,-1,0
202502,68081009,3S3,1,2,-1,0.5
202502,68081010,2,3,2,1,1.5
202502,68081010,3,0,1,-1,0
202502,68081010,3S2,14,9,5,1.56
202502,68081010,3S3,406,240,166,1.69
202502,68081010,3S3S2,3,3,0,1
202502,68081010,CA,1,0,1,NA
202502,68092000,2,158,26,132,6.08
202502,68092000,3,22,27,-5,0.81
202502,68092000,3S2,12,21,-9,0.57
202502,68092000,3S3,555,567,-12,0.98
202502,68092000,CA,0,13,-13,0
202502,68092000,V2,2,11,-9,0.18
202502,68092000,V3,10,25,-15,0.4
202502,68092003,3S3,11,41,-30,0.27
202502,68092005,2,0,2,-2,0
202502,68101000,2,4,18,-14,0.22
202502,68101000,CA,0,4,-4,0
202502,68101010,2,9,10,-1,0.9
202502,68121000,2,0,6,-6,0
202502,68121000,CA,0,14,-14,0
202502,68132000,2,0,2,-2,0
202502,68132000,CA,0,7,-7,0
202502,68147000,2,10,44,-34,0.23
202502,68147000,3S3,20,2,18,10
202502,68147000,CA,0,1,-1,0
202502,68152000,2,0,1,-1,0
202502,68152002,2,0,1,-1,0
202502,68160000,2,0,1,-1,0
202502,68162000,2,0,14,-14,0
202502,68162000,2S3,0,1,-1,0
202502,68162000,3,0,1,-1,0
202502,68162000,3S2,3,0,3,NA
202502,68162000,3S3,7,6,1,1.17
202502,68162000,CA,16,25,-9,0.64
202502,68167000,2,3,84,-81,0.04
202502,68167000,3,0,1,-1,0
202502,68167000,3S3,0,2,-2,0
202502,68167000,CA,0,9,-9,0
202502,68169000,3S2,0,1,-1,0
202502,68176000,2,0,1,-1,0
202502,68179000,2,0,4,-4,0
202502,68179000,V2,0,2,-2,0
202502,68179007,2,0,1,-1,0
202502,68190000,2,73,224,-151,0.33
202502,68190000,2S2,6,2,4,3
202502,68190000,2S3,3,0,3,NA
202502,68190000,3,16,13,3,1.23
202502,68190000,3S2,178,35,143,5.09
202502,68190000,3S3,2498,509,1989,4.91
202502,68190000,3S4,0,1,-1,0
202502,68190000,CA,0,58,-58,0
202502,68190000,V2,1,0,1,NA
202502,68190000,V3,0,11,-11,0
202502,68190002,2,12,9,3,1.33
202502,68190002,2R2,2,0,2,NA
202502,68190002,3,2,2,0,1
202502,68190002,3S2,2,2,0,1
202502,68190002,3S3,0,3,-3,0
202502,68190002,CA,2,1,1,2
202502,68190003,2,65,0,65,NA
202502,68190003,3,4,0,4,NA
202502,68190003,3S2,6,2,4,3
202502,68190003,3S3,66,15,51,4.4
202502,68190004,2,0,1,-1,0
202502,68190004,3S3,0,1,-1,0
202502,68207000,2,0,5,-5,0
202502,68207000,3S3,0,3,-3,0
202502,68209000,2,4,14,-10,0.29
202502,68211000,2,2,6,-4,0.33
202502,68211000,CA,0,3,-3,0
202502,68217000,CA,1,3,-2,0.33
202502,68229000,2,11,78,-67,0.14
202502,68229000,2R2,2,0,2,NA
202502,68229000,3,0,11,-11,0
202502,68229000,3S2,1,0,1,NA
202502,68229000,3S3,286,0,286,NA
202502,68229000,CA,0,5,-5,0
202502,68229000,V4,1,0,1,NA
202502,68235000,2,12,49,-37,0.24
202502,68235000,3,3,4,-1,0.75
202502,68235000,3S3,2,0,2,NA
202502,68235000,CA,0,24,-24,0
202502,68235007,2,0,1,-1,0
202502,68250000,2,0,2,-2,0
202502,68250003,CA,0,1,-1,0
202502,68255000,2,15,179,-164,0.08
202502,68255000,3,5,16,-11,0.31
202502,68255000,3S3,2,8,-6,0.25
202502,68255000,CA,10,38,-28,0.26
202502,68255000,V2,0,8,-8,0
202502,68255000,V3,0,1,-1,0
202502,68266000,2,0,5,-5,0
202502,68266000,3S3,17,0,17,NA
202502,68271000,2,0,20,-20,0
202502,68271000,CA,0,6,-6,0
202502,68271006,2,0,2,-2,0
202502,68276000,2,2607,5108,-2501,0.51
202502,68276000,2R2,1,0,1,NA
202502,68276000,2R3,0,11,-11,0
202502,68276000,2S2,2,27,-25,0.07
202502,68276000,2S3,3,4,-1,0.75
202502,68276000,3,180,77,103,2.34
202502,68276000,3S2,228,50,178,4.56
202502,68276000,3S3,88,169,-81,0.52
202502,68276000,CA,866,988,-122,0.88
202502,68276000,V2,324,0,324,NA
202502,68276011,3S3,0,2,-2,0
202502,68276013,CA,0,10,-10,0
202502,68276014,2,0,4,-4,0
202502,68296000,2,2,2,0,1
202502,68298000,2,0,4,-4,0
202502,68298000,V2,0,2,-2,0
202502,68307000,2,10993,4837,6156,2.27
202502,68307000,2B1,0,2,-2,0
202502,68307000,2R2,0,3,-3,0
202502,68307000,2R3,0,2,-2,0
202502,68307000,2S1,0,1,-1,0
202502,68307000,2S2,62,150,-88,0.41
202502,68307000,2S3,12,39,-27,0.31
202502,68307000,3,737,310,427,2.38
202502,68307000,3S1,2,2,0,1
202502,68307000,3S2,800,692,108,1.16
202502,68307000,3S3,878,3681,-2803,0.24
202502,68307000,3S4,0,1,-1,0
202502,68307000,4,19,0,19,NA
202502,68307000,CA,3794,491,3303,7.73
202502,68307000,V2,35,26,9,1.35
202502,68307000,V3,3,32,-29,0.09
202502,68307007,2,0,21,-21,0
202502,68307007,3,0,3,-3,0
202502,68307007,3S3,0,2,-2,0
202502,68307007,V2,0,1,-1,0
202502,68307018,2,0,1,-1,0
202502,68307018,3,0,1,-1,0
202502,68307018,3S2,11,1,10,11
202502,68307018,3S3,1,0,1,NA
202502,68318000,2,0,7,-7,0
202502,68318000,3,0,9,-9,0
202502,68318000,CA,0,6,-6,0
202502,68320000,2,0,7,-7,0
202502,68320000,3S3,0,1,-1,0
202502,68320000,CA,1,0,1,NA
202502,68320000,V2,0,2,-2,0
202502,68322000,2,0,5,-5,0
202502,68324000,2,0,18,-18,0
202502,68324000,3,0,1,-1,0
202502,68324000,3S3,1,0,1,NA
202502,68324000,V2,0,1,-1,0
202502,68327000,2,0,7,-7,0
202502,68327000,3S3,0,2,-2,0
202502,68344000,2,0,7,-7,0
202502,68344000,V2,0,3,-3,0
202502,68368000,2,5,11,-6,0.45
202502,68368000,3,0,1,-1,0
202502,68368000,3S2,1,0,1,NA
202502,68370000,2,0,1,-1,0
202502,68370000,CA,0,1,-1,0
202502,68377000,2,1,22,-21,0.05
202502,68377000,3,0,4,-4,0
202502,68377000,3S3,0,2,-2,0
202502,68377000,CA,0,1,-1,0
202502,68385000,2,16,57,-41,0.28
202502,68385000,3,34,22,12,1.55
202502,68385000,3S2,3,1,2,3
202502,68385000,3S3,257,0,257,NA
202502,68385000,CA,38,64,-26,0.59
202502,68385000,V2,108,0,108,NA
202502,68385000,V3,167,0,167,NA
202502,68385000,V4,25,0,25,NA
202502,68385012,2,0,2,-2,0
202502,68385012,CA,0,5,-5,0
202502,68397000,2,0,6,-6,0
202502,68397001,2,0,1,-1,0
202502,68406000,2,1334,1787,-453,0.75
202502,68406000,2B1,0,1,-1,0
202502,68406000,2S2,3,48,-45,0.06
202502,68406000,2S3,2,7,-5,0.29
202502,68406000,3,146,135,11,1.08
202502,68406000,3S2,97,57,40,1.7
202502,68406000,3S3,51,276,-225,0.18
202502,68406000,CA,579,266,313,2.18
202502,68406000,V2,19,9,10,2.11
202502,68406000,V3,0,72,-72,0
202502,68406003,2,1,0,1,NA
202502,68406008,V2,0,4,-4,0
202502,68406009,3S2,1,0,1,NA
202502,68406015,3S3,0,1,-1,0
202502,68418000,2,881,1117,-236,0.79
202502,68418000,3,0,348,-348,0
202502,68418000,3S2,0,180,-180,0
202502,68418000,3S3,13,33,-20,0.39
202502,68418000,CA,4,35,-31,0.11
202502,68418000,V2,1,17,-16,0.06
202502,68432000,2,19,195,-176,0.1
202502,68432000,3,1,6,-5,0.17
202502,68432000,3S2,25,0,25,NA
202502,68432000,3S3,32,20,12,1.6
202502,68432000,CA,7,29,-22,0.24
202502,68444000,2,0,7,-7,0
202502,68444000,3S3,0,1,-1,0
202502,68444000,CA,0,9,-9,0
202502,68464000,2,3,94,-91,0.03
202502,68464000,3,3,0,3,NA
202502,68464000,CA,0,3,-3,0
202502,68468000,2,0,1,-1,0
202502,68498000,2,2,4,-2,0.5
202502,68498000,V2,0,5,-5,0
202502,68500000,2,19,149,-130,0.13
202502,68500000,3,2,13,-11,0.15
202502,68500000,3S3,1,13,-12,0.08
202502,68500000,CA,1,13,-12,0.08
202502,68500000,V2,0,20,-20,0
202502,68502000,2,0,7,-7,0
202502,68502000,CA,0,4,-4,0
202502,68522000,2,0,1,-1,0
202502,68522000,CA,1,1,0,1
202502,68524000,2,0,12,-12,0
202502,68524000,CA,18,26,-8,0.69
202502,68533000,2,2,58,-56,0.03
202502,68533000,CA,0,2,-2,0
202502,68547000,2,1214,2093,-879,0.58
202502,68547000,2S2,10,44,-34,0.23
202502,68547000,2S3,0,5,-5,0
202502,68547000,3,135,152,-17,0.89
202502,68547000,3S2,36,15,21,2.4
202502,68547000,3S3,967,413,554,2.34
202502,68547000,CA,213,557,-344,0.38
202502,68547000,V2,0,6,-6,0
202502,68547003,2,0,1,-1,0
202502,68547007,2,1,0,1,NA
202502,68547008,2,1,0,1,NA
202502,68547008,3S2,0,1,-1,0
202502,68547008,3S3,1,0,1,NA
202502,68547009,2S2,0,1,-1,0
202502,68547011,3S3,286,2,284,143
202502,68547015,3S3,0,3,-3,0
202502,68549000,2,0,105,-105,0
202502,68549000,3,0,1,-1,0
202502,68549000,3S3,16,57,-41,0.28
202502,68549000,CA,0,2,-2,0
202502,68549000,V2,0,3,-3,0
202502,68572000,2,2,89,-87,0.02
202502,68572000,3,0,4,-4,0
202502,68572000,3S2,1,0,1,NA
202502,68572000,3S3,92,89,3,1.03
202502,68572000,CA,1,12,-11,0.08
202502,68572003,2,0,3,-3,0
202502,68573000,2,7,40,-33,0.17
202502,68573000,2S2,0,2,-2,0
202502,68573000,3,0,21,-21,0
202502,68573000,3S2,2,0,2,NA
202502,68573000,3S3,113,5,108,22.6
202502,68573000,3S3S2,4,6,-2,0.67
202502,68573000,CA,0,7,-7,0
202502,68573000,V2,9,9,0,1
202502,68573000,V3,91,2,89,45.5
202502,68573001,2,3,0,3,NA
202502,68573002,3S2,0,1,-1,0
202502,68573002,CA,0,4,-4,0
202502,68575000,2,16,152,-136,0.11
202502,68575000,2R2,0,1,-1,0
202502,68575000,2S1,0,3,-3,0
202502,68575000,2S2,0,13,-13,0
202502,68575000,2S3,1,6,-5,0.17
202502,68575000,3,6,8,-2,0.75
202502,68575000,3S1,0,1,-1,0
202502,68575000,3S2,61,1,60,61
202502,68575000,3S3,529,125,404,4.23
202502,68575000,3S4,0,15,-15,0
202502,68575000,CA,3,44,-41,0.07
202502,68575000,V2,22,6,16,3.67
202502,68575000,V3,16,78,-62,0.21
202502,68575000,V3R3,3,0,3,NA
202502,68575001,2,0,1,-1,0
202502,68575015,2,0,3,-3,0
202502,68575015,CA,0,2,-2,0
202502,68575024,2,0,2,-2,0
202502,68575024,CA,0,1,-1,0
202502,68615000,2,215,711,-496,0.3
202502,68615000,2S2,1,1,0,1
202502,68615000,2S3,1,1,0,1
202502,68615000,3,144,47,97,3.06
202502,68615000,3R3,1,0,1,NA
202502,68615000,3S2,85,49,36,1.73
202502,68615000,3S3,60,31,29,1.94
202502,68615000,CA,0,35,-35,0
202502,68615000,V2,0,3,-3,0
202502,68615000,V3,16,0,16,NA
202502,68615006,3,1,0,1,NA
202502,68615013,3S3,5,1,4,5
202502,68615013,CA,0,4,-4,0
202502,68615017,2,2,1,1,2
202502,68615031,2,3,0,3,NA
202502,68615031,3,16,0,16,NA
202502,68615031,CA,0,1,-1,0
202502,68615031,V2,1,0,1,NA
202502,68615031,V3,1,0,1,NA
202502,68655000,2,678,306,372,2.22
202502,68655000,2R3,0,1,-1,0
202502,68655000,2S2,3,2,1,1.5
202502,68655000,2S3,2,0,2,NA
202502,68655000,3,113,329,-216,0.34
202502,68655000,3S1,1,1,0,1
202502,68655000,3S2,7,4,3,1.75
202502,68655000,3S3,224,199,25,1.13
202502,68655000,3S3S2,0,1,-1,0
202502,68655000,3S4,1,0,1,NA
202502,68655000,4,0,16,-16,0
202502,68655000,CA,9,115,-106,0.08
202502,68655000,V2,18,2,16,9
202502,68655000,V3,93,18,75,5.17
202502,68655001,3S3,3,0,3,NA
202502,68669000,2,0,23,-23,0
202502,68669000,3S3,0,9,-9,0
202502,68673001,V2,0,4,-4,0
202502,68673003,2,0,1,-1,0
202502,68679000,2,134,957,-823,0.14
202502,68679000,2B1,0,2,-2,0
202502,68679000,2S2,1,1,0,1
202502,68679000,3,5,29,-24,0.17
202502,68679000,3S2,0,9,-9,0
202502,68679000,3S3,199,442,-243,0.45
202502,68679000,CA,38,205,-167,0.19
202502,68679000,V2,0,1,-1,0
202502,68684000,2,0,2,-2,0
202502,68686000,2,0,10,-10,0
202502,68686000,CA,0,12,-12,0
202502,68689000,2,9,82,-73,0.11
202502,68689000,2R2,2,0,2,NA
202502,68689000,3,3,14,-11,0.21
202502,68689000,3S2,12,15,-3,0.8
202502,68689000,3S3,61,13,48,4.69
202502,68689000,CA,16,87,-71,0.18
202502,68689000,V2,0,6,-6,0
202502,68689000,V3,0,15,-15,0
202502,68689012,2,1,3,-2,0.33
202502,68689012,3S3,4,1,3,4
202502,68689012,CA,18,41,-23,0.44
202502,68689024,2,24,6,18,4
202502,68689024,3,13,0,13,NA
202502,68689024,3S2,1,0,1,NA
202502,68689024,3S3,138,3,135,46
202502,68705000,2,0,12,-12,0
202502,68705000,3R3,0,1,-1,0
202502,68705000,3S3,0,1,-1,0
202502,68720000,2,0,26,-26,0
202502,68720000,3,1,0,1,NA
202502,68720000,CA,0,1,-1,0
202502,68745000,2,12,14,-2,0.86
202502,68745000,3,0,71,-71,0
202502,68745000,3S2,2,0,2,NA
202502,68745000,3S3,74,0,74,NA
202502,68745009,2,0,1,-1,0
202502,68755000,2,85,474,-389,0.18
202502,68755000,3,5,10,-5,0.5
202502,68755000,3S2,0,1,-1,0
202502,68755000,3S3,15,74,-59,0.2
202502,68755000,CA,27,148,-121,0.18
202502,68755000,V2,82,0,82,NA
202502,68770000,2,9,33,-24,0.27
202502,68770000,2R2,0,2,-2,0
202502,68770000,3,0,16,-16,0
202502,68770000,3S2,0,1,-1,0
202502,68770000,3S3,0,2,-2,0
202502,68770000,CA,0,11,-11,0
202502,68770000,V2,0,1,-1,0
202502,68770001,3,0,1,-1,0
202502,68770003,2,3,3,0,1
202502,68770008,CA,1,0,1,NA
202502,68773000,2,0,2,-2,0
202502,68773000,CA,0,1,-1,0
202502,68820000,2,119,75,44,1.59
202502,68820000,3,0,3,-3,0
202502,68820000,3S3,2,0,2,NA
202502,68820000,CA,0,7,-7,0
202502,68820001,2,0,17,-17,0
202502,68820001,3S3,1,2,-1,0.5
202502,68820001,CA,0,7,-7,0
202502,68855000,2,4,46,-42,0.09
202502,68855000,3S3,5,0,5,NA
202502,68855000,V2,0,11,-11,0
202502,68861000,2,6,182,-176,0.03
202502,68861000,2S2,1,1,0,1
202502,68861000,3,1,2,-1,0.5
202502,68861000,3S2,3,4,-1,0.75
202502,68861000,3S3,6,53,-47,0.11
202502,68861000,CA,7,40,-33,0.17
202502,68861000,V2,0,4,-4,0
202502,68867000,CA,0,1,-1,0
202502,68872000,2,6,107,-101,0.06
202502,68872000,3S3,0,1,-1,0
202502,68872000,CA,0,3,-3,0
202502,68872000,V2,0,15,-15,0
202502,68895000,2,41,193,-152,0.21
202502,68895000,2S1,1,0,1,NA
202502,68895000,3,11,30,-19,0.37
202502,68895000,3S3,0,1,-1,0
202502,68895000,CA,15,34,-19,0.44
202502,70001000,2,1449,3092,-1643,0.47
202502,70001000,2B2,0,23,-23,0
202502,70001000,2R2,0,10,-10,0
202502,70001000,2S2,8,91,-83,0.09
202502,70001000,2S3,8,30,-22,0.27
202502,70001000,3,23,230,-207,0.1
202502,70001000,3S2,121,306,-185,0.4
202502,70001000,3S3,109,612,-503,0.18
202502,70001000,3S4,1,1,0,1
202502,70001000,4,0,12,-12,0
202502,70001000,CA,326,500,-174,0.65
202502,70001000,V3R3,1,0,1,NA
202502,70001001,2,1,6,-5,0.17
202502,70001002,2,0,4,-4,0
202502,70001003,2,0,1,-1,0
202502,70001005,2,2,1,1,2
202502,70001007,2,0,6,-6,0
202502,70001019,2,1,0,1,NA
202502,70110000,2,6,18,-12,0.33
202502,70110000,3,0,3,-3,0
202502,70110000,3S3,0,2,-2,0
202502,70110000,CA,0,1,-1,0
202502,70124000,2,9,27,-18,0.33
202502,70124000,3,0,1,-1,0
202502,70124000,3S2,8,1,7,8
202502,70124000,3S3,0,6,-6,0
202502,70124000,CA,0,1,-1,0
202502,70204000,2,4,9,-5,0.44
202502,70204000,CA,0,2,-2,0
202502,70215000,2,264,330,-66,0.8
202502,70215000,2B2,0,2,-2,0
202502,70215000,2R2,0,1,-1,0
202502,70215000,2S2,2,4,-2,0.5
202502,70215000,2S3,1,4,-3,0.25
202502,70215000,3,4,19,-15,0.21
202502,70215000,3S2,17,10,7,1.7
202502,70215000,3S3,227,368,-141,0.62
202502,70215000,CA,49,82,-33,0.6
202502,70221000,2,17,204,-187,0.08
202502,70221000,2B2,0,5,-5,0
202502,70221000,2R2,0,2,-2,0
202502,70221000,2S2,1,2,-1,0.5
202502,70221000,2S3,1,1,0,1
202502,70221000,3,0,21,-21,0
202502,70221000,3S2,6,0,6,NA
202502,70221000,3S3,11,16,-5,0.69
202502,70221000,CA,4,27,-23,0.15
202502,70221005,CA,0,2,-2,0
202502,70230000,2,2,7,-5,0.29
202502,70230000,3,0,1,-1,0
202502,70230000,3S2,1,0,1,NA
202502,70230000,CA,0,2,-2,0
202502,70233000,2,3,7,-4,0.43
202502,70233000,2S2,0,1,-1,0
202502,70233000,2S3,0,1,-1,0
202502,70233000,3,0,5,-5,0
202502,70233000,3S3,3,9,-6,0.33
202502,70233000,CA,0,2,-2,0
202502,70233000,V3,1,0,1,NA
202502,70233013,2,0,1,-1,0
202502,70233013,CA,0,1,-1,0
202502,70235000,2,17,99,-82,0.17
202502,70235000,CA,0,8,-8,0
202502,70235000,V3,1,0,1,NA
202502,70235008,3S3,0,43,-43,0
202502,70265000,2,6,75,-69,0.08
202502,70265000,3,0,29,-29,0
202502,70265000,3S2,1,3,-2,0.33
202502,70265000,3S3,0,3,-3,0
202502,70265000,CA,2,14,-12,0.14
202502,70400000,2,19,67,-48,0.28
202502,70400000,2S2,3,0,3,NA
202502,70400000,2S3,1,1,0,1
202502,70400000,3,4,14,-10,0.29
202502,70400000,3S1,2,1,1,2
202502,70400000,3S2,8,7,1,1.14
202502,70400000,3S3,9,10,-1,0.9
202502,70400000,3S4,3,1,2,3
202502,70400000,CA,0,1,-1,0
202502,70418000,2,4,15,-11,0.27
202502,70418000,3,0,2,-2,0
202502,70418000,3S3,0,2,-2,0
202502,70418000,CA,3,7,-4,0.43
202502,70418004,CA,1,0,1,NA
202502,70418005,2,1,0,1,NA
202502,70429000,2,26,68,-42,0.38
202502,70429000,2S2,0,1,-1,0
202502,70429000,2S3,1,1,0,1
202502,70429000,3,3,23,-20,0.13
202502,70429000,3S3,0,7,-7,0
202502,70429000,4,0,3,-3,0
202502,70429000,CA,1,16,-15,0.06
202502,70429005,2,0,2,-2,0
202502,70429014,2,0,2,-2,0
202502,70429015,2,0,1,-1,0
202502,70473000,2,0,10,-10,0
202502,70473000,3S2,0,5,-5,0
202502,70473000,3S3,0,3,-3,0
202502,70473000,4,0,1,-1,0
202502,70473000,CA,0,4,-4,0
202502,70473005,3S2,0,14,-14,0
202502,70508000,2,13,62,-49,0.21
202502,70508000,2R2,0,1,-1,0
202502,70508000,2S1,2,0,2,NA
202502,70508000,2S2,2,1,1,2
202502,70508000,3S1,7,5,2,1.4
202502,70508000,3S2,4,4,0,1
202502,70508000,3S3,5,9,-4,0.56
202502,70508000,3S4,1,3,-2,0.33
202502,70508000,CA,1,12,-11,0.08
202502,70508011,2,0,1,-1,0
202502,70523000,2,11,20,-9,0.55
202502,70523000,2S3,0,1,-1,0
202502,70523000,3,0,7,-7,0
202502,70523000,3S2,0,4,-4,0
202502,70523000,3S3,0,6,-6,0
202502,70523000,CA,0,3,-3,0
202502,70523000,V3R3,1,0,1,NA
202502,70670000,2,68,141,-73,0.48
202502,70670000,2B2,0,1,-1,0
202502,70670000,2S2,1,0,1,NA
202502,70670000,3,0,1,-1,0
202502,70670000,3S2,0,1,-1,0
202502,70670000,3S3,2,2,0,1
202502,70670000,3S4,1,0,1,NA
202502,70670000,CA,18,29,-11,0.62
202502,70670000,V3R3,0,1,-1,0
202502,70678000,2,5,43,-38,0.12
202502,70678000,2S2,0,1,-1,0
202502,70678000,3,0,2,-2,0
202502,70678000,3S2,1,2,-1,0.5
202502,70678000,3S3,1,1,0,1
202502,70678000,CA,0,3,-3,0
202502,70678010,2,0,1,-1,0
202502,70702000,2,0,24,-24,0
202502,70702000,CA,2,5,-3,0.4
202502,70702004,2,0,4,-4,0
202502,70708000,2,88,277,-189,0.32
202502,70708000,2B2,0,1,-1,0
202502,70708000,2R2,8,5,3,1.6
202502,70708000,2S2,4,8,-4,0.5
202502,70708000,2S3,4,10,-6,0.4
202502,70708000,3,6,25,-19,0.24
202502,70708000,3S2,6,7,-1,0.86
202502,70708000,3S3,20,82,-62,0.24
202502,70708000,3S4,0,4,-4,0
202502,70708000,4,0,2,-2,0
202502,70708000,CA,4,57,-53,0.07
202502,70708003,2,54,1,53,54
202502,70708003,2S2,0,1,-1,0
202502,70708006,2,1,0,1,NA
202502,70708006,2R2,1,1,0,1
202502,70708006,3S3,0,20,-20,0
202502,70708017,3S2,2,0,2,NA
202502,70708017,CA,0,1,-1,0
202502,70713000,2,73,164,-91,0.45
202502,70713000,2B2,0,1,-1,0
202502,70713000,2R2,0,1,-1,0
202502,70713000,2S2,0,3,-3,0
202502,70713000,3,0,37,-37,0
202502,70713000,3S2,6,2,4,3
202502,70713000,3S3,1,4,-3,0.25
202502,70713000,CA,2,31,-29,0.06
202502,70713002,2,1,0,1,NA
202502,70713003,2,0,4,-4,0
202502,70713010,2,0,3,-3,0
202502,70713022,2,0,2,-2,0
202502,70717000,2,16,29,-13,0.55
202502,70717000,2S1,1,0,1,NA
202502,70717000,2S2,0,4,-4,0
202502,70717000,3,1,6,-5,0.17
202502,70717000,3R3,1,0,1,NA
202502,70717000,3S1,9,0,9,NA
202502,70717000,3S2,23,13,10,1.77
202502,70717000,3S3,43,15,28,2.87
202502,70717000,3S4,3,0,3,NA
202502,70717000,CA,2,5,-3,0.4
202502,70717000,V3,1,0,1,NA
202502,70717002,2,0,1,-1,0
202502,70742000,2,15,101,-86,0.15
202502,70742000,2S2,0,1,-1,0
202502,70742000,3R3,0,1,-1,0
202502,70742000,3S3,0,2,-2,0
202502,70742000,CA,1,16,-15,0.06
202502,70742005,2,0,1,-1,0
202502,70771000,2,3,4,-1,0.75
202502,70771000,2S3,2,2,0,1
202502,70771000,3,0,7,-7,0
202502,70771000,3S3,0,7,-7,0
202502,70771000,CA,0,3,-3,0
202502,70771007,2,0,1,-1,0
202502,70771013,2,19,8,11,2.38
202502,70771013,CA,0,2,-2,0
202502,70771017,2,1,0,1,NA
202502,70771026,2,0,2,-2,0
202502,70771026,2S2,0,1,-1,0
202502,70820000,2,11,165,-154,0.07
202502,70820000,2S2,0,1,-1,0
202502,70820000,2S3,3,0,3,NA
202502,70820000,3,0,22,-22,0
202502,70820000,3S2,0,16,-16,0
202502,70820000,3S3,2647,1429,1218,1.85
202502,70820000,CA,1,29,-28,0.03
202502,70820001,2,0,11,-11,0
202502,70820001,2S2,2,3,-1,0.67
202502,70820001,2S3,1,1,0,1
202502,70820001,3S3,0,1,-1,0
202502,70820001,4,0,1,-1,0
202502,70820008,2,0,2,-2,0
202502,70820008,3S2,0,73,-73,0
202502,70820008,3S3,0,521,-521,0
202502,70820008,V3,0,15,-15,0
202502,70823000,2,689,86,603,8.01
202502,70823000,2B2,0,11,-11,0
202502,70823000,2R2,0,2,-2,0
202502,70823000,2S2,2,8,-6,0.25
202502,70823000,2S3,1,0,1,NA
202502,70823000,3,419,15,404,27.93
202502,70823000,3S2,278,79,199,3.52
202502,70823000,3S3,672,277,395,2.43
202502,70823000,CA,0,33,-33,0
202502,70823003,3S3,1,0,1,NA
202502,70823005,2,1,1,0,1
202502,73001000,2,4126,6595,-2469,0.63
202502,73001000,2B1,0,1,-1,0
202502,73001000,2R2,27,118,-91,0.23
202502,73001000,2S1,0,2,-2,0
202502,73001000,2S2,224,554,-330,0.4
202502,73001000,2S3,29,129,-100,0.22
202502,73001000,3,164,245,-81,0.67
202502,73001000,3S2,604,530,74,1.14
202502,73001000,3S3,3835,2320,1515,1.65
202502,73001000,3S4,0,2,-2,0
202502,73001000,4,0,2,-2,0
202502,73001000,CA,1408,1717,-309,0.82
202502,73001000,V2,0,1,-1,0
202502,73001000,V3,209,2,207,104.5
202502,73001000,V4,0,2,-2,0
202502,73001001,2,1,2,-1,0.5
202502,73001001,CA,0,7,-7,0
202502,73001004,2,0,1,-1,0
202502,73001009,2,1,0,1,NA
202502,73001009,CA,0,1,-1,0
202502,73001011,2,1,0,1,NA
202502,73001022,CA,0,1,-1,0
202502,73001029,2,0,1,-1,0
202502,73001031,2,0,1,-1,0
202502,73001032,2,0,3,-3,0
202502,73001032,3S3,0,13,-13,0
202502,73001039,2,0,1,-1,0
202502,73024000,2,0,7,-7,0
202502,73024000,CA,6,9,-3,0.67
202502,73024004,2,2,4,-2,0.5
202502,73024004,3S3,4,6,-2,0.67
202502,73024004,CA,0,5,-5,0
202502,73026000,2,95,114,-19,0.83
202502,73026000,2S2,1,2,-1,0.5
202502,73026000,2S3,3,4,-1,0.75
202502,73026000,3,0,1,-1,0
202502,73026000,3S2,1,5,-4,0.2
202502,73026000,3S3,12,8,4,1.5
202502,73026000,3S4,0,2,-2,0
202502,73026000,CA,5,15,-10,0.33
202502,73026008,2,0,1,-1,0
202502,73030000,2,18,21,-3,0.86
202502,73030000,2R2,1,0,1,NA
202502,73030000,3,1,2,-1,0.5
202502,73030000,3S2,3,0,3,NA
202502,73030000,3S3,32,9,23,3.56
202502,73030000,CA,0,7,-7,0
202502,73030004,2,0,1,-1,0
202502,73043000,2,1,31,-30,0.03
202502,73043000,CA,0,8,-8,0
202502,73055000,2,42,63,-21,0.67
202502,73055000,2R2,0,1,-1,0
202502,73055000,3S2,26,0,26,NA
202502,73055000,3S3,11,2,9,5.5
202502,73055000,CA,3,5,-2,0.6
202502,73055004,2,1,5,-4,0.2
202502,73055004,2S3,1,1,0,1
202502,73055004,3S3,3,3,0,1
202502,73055004,CA,0,1,-1,0
202502,73067000,2,2,35,-33,0.06
202502,73067000,3,0,12,-12,0
202502,73067000,3S2,0,2,-2,0
202502,73067000,3S3,1,3,-2,0.33
202502,73067000,CA,25,24,1,1.04
202502,73067007,2,0,18,-18,0
202502,73067007,3,0,1,-1,0
202502,73067007,CA,0,1,-1,0
202502,73124000,2,43,102,-59,0.42
202502,73124000,2S2,1,0,1,NA
202502,73124000,3S2,3,0,3,NA
202502,73124000,3S3,1,7,-6,0.14
202502,73124000,CA,3,34,-31,0.09
202502,73148000,2,6,90,-84,0.07
202502,73148000,2R2,0,3,-3,0
202502,73148000,2S2,0,1,-1,0
202502,73148000,3S2,2,4,-2,0.5
202502,73148000,3S3,2,10,-8,0.2
202502,73148000,4,0,1,-1,0
202502,73148000,CA,1,51,-50,0.02
202502,73152000,2,1,11,-10,0.09
202502,73152000,3,1,0,1,NA
202502,73152000,CA,0,1,-1,0
202502,73168000,2,137,374,-237,0.37
202502,73168000,2R2,0,8,-8,0
202502,73168000,2S2,0,1,-1,0
202502,73168000,2S3,0,4,-4,0
202502,73168000,3,148,27,121,5.48
202502,73168000,3S1,0,3,-3,0
202502,73168000,3S2,10,7,3,1.43
202502,73168000,3S3,144,68,76,2.12
202502,73168000,CA,32,110,-78,0.29
202502,73200000,2,415,29,386,14.31
202502,73200000,2S2,52,0,52,NA
202502,73200000,2S3,1,0,1,NA
202502,73200000,3,116,63,53,1.84
202502,73200000,3S2,0,26,-26,0
202502,73200000,3S3,67,77,-10,0.87
202502,73200000,CA,0,13,-13,0
202502,73200000,V3,0,250,-250,0
202502,73200001,2,132,5,127,26.4
202502,73200001,2S2,46,0,46,NA
202502,73200001,3,84,0,84,NA
202502,73200001,3S2,4,1,3,4
202502,73200001,3S3,49,60,-11,0.82
202502,73200001,CA,0,2,-2,0
202502,73200010,2,1,0,1,NA
202502,73200010,3S3,0,1,-1,0
202502,73217000,2,4,41,-37,0.1
202502,73217000,2S2,4,4,0,1
202502,73217000,2S3,1,1,0,1
202502,73217000,3,1,3,-2,0.33
202502,73217000,3S2,1,1,0,1
202502,73217000,3S3,5,6,-1,0.83
202502,73217000,CA,0,5,-5,0
202502,73217001,2,1,4,-3,0.25
202502,73226000,2,15,24,-9,0.62
202502,73226000,CA,0,6,-6,0
202502,73226003,2,0,1,-1,0
202502,73236000,2,4,36,-32,0.11
202502,73236000,CA,0,9,-9,0
202502,73268000,2,573,832,-259,0.69
202502,73268000,2R2,11,5,6,2.2
202502,73268000,2S2,10,29,-19,0.34
202502,73268000,2S3,2,6,-4,0.33
202502,73268000,3,76,18,58,4.22
202502,73268000,3S2,27,14,13,1.93
202502,73268000,3S3,895,259,636,3.46
202502,73268000,4,1,1,0,1
202502,73268000,CA,85,277,-192,0.31
202502,73268000,V2,2,0,2,NA
202502,73268001,2,25,14,11,1.79
202502,73268001,2S2,1,1,0,1
202502,73268001,3,0,1,-1,0
202502,73268001,3S2,1,0,1,NA
202502,73268001,3S3,19,10,9,1.9
202502,73268001,CA,7,2,5,3.5
202502,73270000,2,0,3,-3,0
202502,73270000,CA,0,3,-3,0
202502,73270004,2,0,2,-2,0
202502,73270004,2S2,1,0,1,NA
202502,73270004,CA,0,1,-1,0
202502,73275000,2,235,292,-57,0.8
202502,73275000,2R2,0,1,-1,0
202502,73275000,2S2,0,3,-3,0
202502,73275000,3,15,5,10,3
202502,73275000,3S2,26,41,-15,0.63
202502,73275000,3S3,39,89,-50,0.44
202502,73275000,CA,6,97,-91,0.06
202502,73283000,2,38,248,-210,0.15
202502,73283000,2R2,0,1,-1,0
202502,73283000,3,1,11,-10,0.09
202502,73283000,3S3,3,68,-65,0.04
202502,73283000,CA,4,50,-46,0.08
202502,73283003,2,0,1,-1,0
202502,73319000,2,21,163,-142,0.13
202502,73319000,2R2,0,5,-5,0
202502,73319000,2S3,1,0,1,NA
202502,73319000,3,0,58,-58,0
202502,73319000,3S2,5,3,2,1.67
202502,73319000,3S3,2,4,-2,0.5
202502,73319000,3S4,0,1,-1,0
202502,73319000,CA,0,44,-44,0
202502,73319000,V3,1,1,0,1
202502,73347000,2,1,27,-26,0.04
202502,73347000,3S3,12,2,10,6
202502,73347000,CA,0,7,-7,0
202502,73347001,3S3,0,2,-2,0
202502,73347003,2,47,8,39,5.88
202502,73347003,3,8,0,8,NA
202502,73347003,3S3,35,15,20,2.33
202502,73347005,2,3,3,0,1
202502,73347005,3S3,0,1,-1,0
202502,73347005,CA,0,1,-1,0
202502,73349000,2,10,238,-228,0.04
202502,73349000,2R2,0,3,-3,0
202502,73349000,2S2,0,3,-3,0
202502,73349000,2S3,0,2,-2,0
202502,73349000,3,1,16,-15,0.06
202502,73349000,3S2,2,3,-1,0.67
202502,73349000,3S3,108,174,-66,0.62
202502,73349000,CA,5,77,-72,0.06
202502,73352000,2,2,40,-38,0.05
202502,73352000,CA,1,21,-20,0.05
202502,73352002,2,0,2,-2,0
202502,73352002,3S3,0,1,-1,0
202502,73408000,2,14,136,-122,0.1
202502,73408000,2R2,0,2,-2,0
202502,73408000,2S1,0,1,-1,0
202502,73408000,2S2,1,4,-3,0.25
202502,73408000,3,9,4,5,2.25
202502,73408000,3S2,3,1,2,3
202502,73408000,3S3,23,63,-40,0.37
202502,73408000,3S4,1,0,1,NA
202502,73408000,CA,5,41,-36,0.12
202502,73408000,V3,0,1,-1,0
202502,73408002,2,0,1,-1,0
202502,73408002,3S3,0,1,-1,0
202502,73411000,2,44,249,-205,0.18
202502,73411000,2S2,1,0,1,NA
202502,73411000,3,3,35,-32,0.09
202502,73411000,3S2,3,1,2,3
202502,73411000,3S3,5,21,-16,0.24
202502,73411000,CA,5,52,-47,0.1
202502,73411000,V3,4,9,-5,0.44
202502,73411009,2,0,4,-4,0
202502,73411009,3,0,2,-2,0
202502,73443000,2,272,450,-178,0.6
202502,73443000,2R2,0,1,-1,0
202502,73443000,2S2,8,9,-1,0.89
202502,73443000,2S3,1,3,-2,0.33
202502,73443000,3,37,24,13,1.54
202502,73443000,3S2,16,11,5,1.45
202502,73443000,3S3,390,175,215,2.23
202502,73443000,4,3,2,1,1.5
202502,73443000,CA,17,69,-52,0.25
202502,73443000,V3,0,1,-1,0
202502,73443003,2,0,1,-1,0
202502,73449000,2,55,457,-402,0.12
202502,73449000,2R2,0,2,-2,0
202502,73449000,2S2,2,4,-2,0.5
202502,73449000,2S3,1,2,-1,0.5
202502,73449000,3,0,16,-16,0
202502,73449000,3S2,2,3,-1,0.67
202502,73449000,3S3,2,56,-54,0.04
202502,73449000,3S4,1,1,0,1
202502,73449000,4,0,1,-1,0
202502,73449000,CA,6,230,-224,0.03
202502,73461000,2,1,13,-12,0.08
202502,73461000,CA,0,1,-1,0
202502,73483000,2,29,156,-127,0.19
202502,73483000,2R2,0,3,-3,0
202502,73483000,2S2,0,3,-3,0
202502,73483000,3,0,5,-5,0
202502,73483000,3S3,0,2,-2,0
202502,73483000,CA,0,9,-9,0
202502,73504000,2,2,69,-67,0.03
202502,73504000,2R2,0,6,-6,0
202502,73504000,3,63,15,48,4.2
202502,73504000,3S2,1,1,0,1
202502,73504000,3S3,33,2,31,16.5
202502,73504000,CA,2,10,-8,0.2
202502,73504008,3S2,1,0,1,NA
202502,73520000,2,0,14,-14,0
202502,73520000,CA,3,7,-4,0.43
202502,73547000,2,77,22,55,3.5
202502,73547000,2S2,1,0,1,NA
202502,73547000,3,3,3,0,1
202502,73547000,3S2,2,4,-2,0.5
202502,73547000,3S3,91,13,78,7
202502,73547000,CA,0,18,-18,0
202502,73547002,2,19,4,15,4.75
202502,73547002,2S2,0,1,-1,0
202502,73547002,3S3,1,10,-9,0.1
202502,73547002,CA,9,0,9,NA
202502,73555000,2,11,82,-71,0.13
202502,73555000,3,5,3,2,1.67
202502,73555000,3S2,0,1,-1,0
202502,73555000,CA,11,29,-18,0.38
202502,73555002,2,0,5,-5,0
202502,73555005,3S3,1,1,0,1
202502,73563000,2,3,52,-49,0.06
202502,73563000,3,0,2,-2,0
202502,73563000,CA,1,6,-5,0.17
202502,73563000,V3,0,2,-2,0
202502,73585000,2,13,87,-74,0.15
202502,73585000,2R2,0,6,-6,0
202502,73585000,3,47,19,28,2.47
202502,73585000,3S2,1,2,-1,0.5
202502,73585000,3S3,119,32,87,3.72
202502,73585000,CA,1,20,-19,0.05
202502,73616000,2,1,55,-54,0.02
202502,73616000,3,1,1,0,1
202502,73616000,CA,0,2,-2,0
202502,73616001,2,3,2,1,1.5
202502,73622000,2,0,6,-6,0
202502,73622000,CA,24,29,-5,0.83
202502,73624000,2,2,130,-128,0.02
202502,73624000,3,0,1,-1,0
202502,73624000,CA,0,37,-37,0
202502,73671000,2,30,114,-84,0.26
202502,73671000,2R2,0,1,-1,0
202502,73671000,2S2,4,0,4,NA
202502,73671000,3,2,10,-8,0.2
202502,73671000,3S2,777,2,775,388.5
202502,73671000,3S3,511,73,438,7
202502,73671000,3S4,0,3,-3,0
202502,73671000,CA,5,21,-16,0.24
202502,73671000,V2,1,0,1,NA
202502,73671000,V3,1,0,1,NA
202502,73675000,2,1,34,-33,0.03
202502,73675000,CA,0,5,-5,0
202502,73675002,2,0,1,-1,0
202502,73678000,2,7,55,-48,0.13
202502,73678000,3,1,0,1,NA
202502,73678000,3S3,2,1,1,2
202502,73678000,CA,0,15,-15,0
202502,73678004,2,4,0,4,NA
202502,73678004,3,0,14,-14,0
202502,73678004,3S2,3,1,2,3
202502,73678004,3S3,20,0,20,NA
202502,73686000,2,0,10,-10,0
202502,73686000,CA,0,6,-6,0
202502,73770000,2,3,15,-12,0.2
202502,73770000,3,1,1,0,1
202502,73770000,3S2,10,0,10,NA
202502,73770000,3S3,23,3,20,7.67
202502,73770000,4,6,0,6,NA
202502,73770000,CA,0,3,-3,0
202502,73770000,V2,11,0,11,NA
202502,73770000,V3,323,0,323,NA
202502,73770000,V4,40,0,40,NA
202502,73854000,2,8,6,2,1.33
202502,73854000,CA,0,5,-5,0
202502,73854000,V3,2,0,2,NA
202502,73861000,2,21,84,-63,0.25
202502,73861000,2R2,0,1,-1,0
202502,73861000,2S2,1,2,-1,0.5
202502,73861000,3,10,1,9,10
202502,73861000,3S2,0,1,-1,0
202502,73861000,3S3,114,44,70,2.59
202502,73861000,CA,2,9,-7,0.22
202502,73870000,2,15,11,4,1.36
202502,73870000,2S2,0,1,-1,0
202502,73870000,CA,0,1,-1,0
202502,73873000,2,24,41,-17,0.59
202502,73873000,CA,0,1,-1,0
202502,76001000,2,13920,26043,-12123,0.53
202502,76001000,2B1,1,17,-16,0.06
202502,76001000,2B2,1,7,-6,0.14
202502,76001000,2R2,3,23,-20,0.13
202502,76001000,2R3,0,25,-25,0
202502,76001000,2S1,0,15,-15,0
202502,76001000,2S2,709,2480,-1771,0.29
202502,76001000,2S3,183,658,-475,0.28
202502,76001000,3,113,963,-850,0.12
202502,76001000,3R3,0,9,-9,0
202502,76001000,3S1,8,2,6,4
202502,76001000,3S2,1304,1477,-173,0.88
202502,76001000,3S3,2294,5522,-3228,0.42
202502,76001000,3S4,2,1,1,2
202502,76001000,4,1,8,-7,0.12
202502,76001000,CA,4201,9187,-4986,0.46
202502,76001000,V2,68,0,68,NA
202502,76001001,2,1,0,1,NA
202502,76001004,2,1,0,1,NA
202502,76001005,2,1,0,1,NA
202502,76001013,2,0,208,-208,0
202502,76001013,3S2,0,1,-1,0
202502,76001013,CA,0,342,-342,0
202502,76001016,2,0,6,-6,0
202502,76001019,2,2,6,-4,0.33
202502,76001019,2S2,0,1,-1,0
202502,76001019,3S3,1,29,-28,0.03
202502,76001043,2,0,1,-1,0
202502,76020000,2,51,147,-96,0.35
202502,76020000,2S2,0,1,-1,0
202502,76020000,3,0,42,-42,0
202502,76020000,3S3,1,10,-9,0.1
202502,76020000,CA,0,30,-30,0
202502,76020003,2,0,1,-1,0
202502,76020003,2S2,0,1,-1,0
202502,76036000,2,105,121,-16,0.87
202502,76036000,2S2,0,5,-5,0
202502,76036000,3,0,30,-30,0
202502,76036000,3S2,5,3,2,1.67
202502,76036000,3S3,11,68,-57,0.16
202502,76036000,CA,0,69,-69,0
202502,76036001,2,0,1,-1,0
202502,76041000,2,57,179,-122,0.32
202502,76041000,2S2,0,1,-1,0
202502,76041000,3,0,6,-6,0
202502,76041000,3S2,2,3,-1,0.67
202502,76041000,3S3,3,46,-43,0.07
202502,76041000,CA,2,114,-112,0.02
202502,76054000,2,23,14,9,1.64
202502,76054000,3,0,1,-1,0
202502,76054000,CA,1,15,-14,0.07
202502,76100000,2,11,64,-53,0.17
202502,76100000,3S3,4,5,-1,0.8
202502,76100000,CA,2,14,-12,0.14
202502,76100004,2,0,4,-4,0
202502,76100007,2,2,2,0,1
202502,76100009,2,2,1,1,2
202502,76100010,CA,0,1,-1,0
202502,76109000,2,4984,3447,1537,1.45
202502,76109000,2B1,0,1,-1,0
202502,76109000,2S1,44,29,15,1.52
202502,76109000,2S2,13493,5960,7533,2.26
202502,76109000,2S3,3979,2111,1868,1.88
202502,76109000,3,164,58,106,2.83
202502,76109000,3S1,5,5,0,1
202502,76109000,3S2,3667,2251,1416,1.63
202502,76109000,3S3,33169,10451,22718,3.17
202502,76109000,3S4,28,12,16,2.33
202502,76109000,4,43,17,26,2.53
202502,76109000,CA,1110,834,276,1.33
202502,76109000,V4,13,1,12,13
202502,76109006,2,1,12,-11,0.08
202502,76109006,3S3,0,10,-10,0
202502,76109006,CA,1,3,-2,0.33
202502,76109008,2,10,5,5,2
202502,76109008,2S2,1,0,1,NA
202502,76109008,3S3,17,0,17,NA
202502,76109008,CA,0,4,-4,0
202502,76109009,2,25,1,24,25
202502,76109009,3,0,1,-1,0
202502,76109009,3S3,51,1,50,51
202502,76109009,CA,7,1,6,7
202502,76109015,2,53,1,52,53
202502,76109015,3S3,10,0,10,NA
202502,76109015,CA,0,1,-1,0
202502,76109054,2,2,0,2,NA
202502,76109056,2,0,1,-1,0
202502,76109056,3S3,0,4,-4,0
202502,76109066,2,0,1,-1,0
202502,76109076,2,1,1,0,1
202502,76109076,3S3,75,0,75,NA
202502,76109076,CA,0,1,-1,0
202502,76109078,2,2,2,0,1
202502,76109078,3,0,1,-1,0
202502,76109078,3S3,16,2,14,8
202502,76111000,2,4341,3574,767,1.21
202502,76111000,2R2,6,2,4,3
202502,76111000,2R3,0,1,-1,0
202502,76111000,2S1,0,1,-1,0
202502,76111000,2S2,65,98,-33,0.66
202502,76111000,2S3,49,49,0,1
202502,76111000,3,756,86,670,8.79
202502,76111000,3R3,0,1,-1,0
202502,76111000,3S2,583,144,439,4.05
202502,76111000,3S3,2550,5520,-2970,0.46
202502,76111000,4,4,4,0,1
202502,76111000,CA,639,542,97,1.18
202502,76111000,V2,0,4,-4,0
202502,76111000,V3,2,0,2,NA
202502,76111000,V4,0,4,-4,0
202502,76111001,2,0,1,-1,0
202502,76111002,CA,0,2,-2,0
202502,76111005,2,0,2,-2,0
202502,76111020,2,3,0,3,NA
202502,76111022,2,0,1,-1,0
202502,76113000,2,183,543,-360,0.34
202502,76113000,2R2,0,1,-1,0
202502,76113000,2S2,16,49,-33,0.33
202502,76113000,2S3,11,26,-15,0.42
202502,76113000,3,29,26,3,1.12
202502,76113000,3S2,238,57,181,4.18
202502,76113000,3S3,245,317,-72,0.77
202502,76113000,4,1,0,1,NA
202502,76113000,CA,28,182,-154,0.15
202502,76113000,V3,0,1,-1,0
202502,76113001,2,0,3,-3,0
202502,76113004,3S2,0,2,-2,0
202502,76113004,3S3,0,1,-1,0
202502,76113011,2,0,1,-1,0
202502,76113011,3,1,0,1,NA
202502,76113013,2,3,8,-5,0.38
202502,76113013,2S2,0,1,-1,0
202502,76113016,3S2,0,1,-1,0
202502,76122000,2,16,271,-255,0.06
202502,76122000,2S2,1,0,1,NA
202502,76122000,2S3,4,0,4,NA
202502,76122000,3,0,5,-5,0
202502,76122000,3S2,1,0,1,NA
202502,76122000,3S3,13,28,-15,0.46
202502,76122000,CA,5,115,-110,0.04
202502,76122009,2,0,1,-1,0
202502,76126000,2,12,160,-148,0.07
202502,76126000,2R2,0,1,-1,0
202502,76126000,2S2,0,4,-4,0
202502,76126000,3,1,13,-12,0.08
202502,76126000,3S2,0,1,-1,0
202502,76126000,CA,2,102,-100,0.02
202502,76126006,2,0,1,-1,0
202502,76126013,2,0,5,-5,0
202502,76126013,3,0,9,-9,0
202502,76126013,3S2,2,1,1,2
202502,76130000,2,1570,2704,-1134,0.58
202502,76130000,2S1,44,0,44,NA
202502,76130000,2S2,116,38,78,3.05
202502,76130000,2S3,54,14,40,3.86
202502,76130000,3,323,108,215,2.99
202502,76130000,3S1,39,0,39,NA
202502,76130000,3S2,311,193,118,1.61
202502,76130000,3S3,642,1239,-597,0.52
202502,76130000,3S4,1,0,1,NA
202502,76130000,4,2,0,2,NA
202502,76130000,CA,580,426,154,1.36
202502,76130000,V2,0,1,-1,0
202502,76130002,3S3,0,11,-11,0
202502,76130003,2,0,2,-2,0
202502,76130003,CA,0,1,-1,0
202502,76130004,2,1,5,-4,0.2
202502,76130004,CA,0,1,-1,0
202502,76130006,2,0,1,-1,0
202502,76130007,2,11,8,3,1.38
202502,76130007,3S3,2,1,1,2
202502,76130008,2,326,41,285,7.95
202502,76130008,2R3,0,2,-2,0
202502,76130008,2S2,2,14,-12,0.14
202502,76130008,2S3,8,3,5,2.67
202502,76130008,3,10,31,-21,0.32
202502,76130008,3S2,28,14,14,2
202502,76130008,3S3,29,8,21,3.62
202502,76130008,CA,561,11,550,51
202502,76130009,3S3,20,0,20,NA
202502,76130016,2,0,5,-5,0
202502,76130016,3,0,1,-1,0
202502,76130016,CA,0,3,-3,0
202502,76147000,2,1544,2071,-527,0.75
202502,76147000,2R2,0,6,-6,0
202502,76147000,2R3,0,4,-4,0
202502,76147000,2S2,13,80,-67,0.16
202502,76147000,2S3,22,20,2,1.1
202502,76147000,3,58,157,-99,0.37
202502,76147000,3S2,40,32,8,1.25
202502,76147000,3S3,1198,1972,-774,0.61
202502,76147000,3S4,0,1,-1,0
202502,76147000,4,1,0,1,NA
202502,76147000,CA,47,618,-571,0.08
202502,76147000,V3,11,0,11,NA
202502,76147002,2,2,1,1,2
202502,76147002,3S3,1,0,1,NA
202502,76147002,CA,1,0,1,NA
202502,76147010,2,227,150,77,1.51
202502,76147010,2S2,0,1,-1,0
202502,76147010,3,3,1,2,3
202502,76147010,3S2,3,0,3,NA
202502,76147010,3S3,71,24,47,2.96
202502,76147010,CA,30,1,29,30
202502,76147010,V2,5,0,5,NA
202502,76233000,2,166,235,-69,0.71
202502,76233000,2S2,3,2,1,1.5
202502,76233000,2S3,0,1,-1,0
202502,76233000,3,1,1,0,1
202502,76233000,3S2,114,2,112,57
202502,76233000,3S3,131,5,126,26.2
202502,76233000,CA,0,154,-154,0
202502,76233002,2,0,1,-1,0
202502,76233004,2,1,0,1,NA
202502,76233004,2S2,0,1,-1,0
202502,76233004,3S2,0,1,-1,0
202502,76233005,2,0,2,-2,0
202502,76233009,2,0,4,-4,0
202502,76233011,2,0,10,-10,0
202502,76233011,CA,0,9,-9,0
202502,76233012,2,0,2,-2,0
202502,76233017,2,18,23,-5,0.78
202502,76233017,2S2,1,0,1,NA
202502,76233017,2S3,3,3,0,1
202502,76233017,3S3,4,3,1,1.33
202502,76233017,4,1,0,1,NA
202502,76233017,CA,1,5,-4,0.2
202502,76233024,2,0,1,-1,0
202502,76233025,3S3,1,0,1,NA
202502,76243000,2,4,8,-4,0.5
202502,76243000,CA,0,3,-3,0
202502,76243009,2,0,1,-1,0
202502,76243010,2S2,1,0,1,NA
202502,76246000,2,2,24,-22,0.08
202502,76246000,CA,1,13,-12,0.08
202502,76248000,2,230,522,-292,0.44
202502,76248000,2R3,0,1,-1,0
202502,76248000,2S2,1,12,-11,0.08
202502,76248000,2S3,0,8,-8,0
202502,76248000,3,3,23,-20,0.13
202502,76248000,3S2,361,58,303,6.22
202502,76248000,3S3,849,67,782,12.67
202502,76248000,4,0,1,-1,0
202502,76248000,CA,74,308,-234,0.24
202502,76248001,2,1,4,-3,0.25
202502,76248005,3S3,14,3,11,4.67
202502,76248009,2,1,8,-7,0.12
202502,76248009,3,0,5,-5,0
202502,76248009,3S3,0,1,-1,0
202502,76248009,CA,0,2,-2,0
202502,76250000,2,37,79,-42,0.47
202502,76250000,3,0,3,-3,0
202502,76250000,CA,0,10,-10,0
202502,76250000,V2,0,1,-1,0
202502,76250003,2,0,1,-1,0
202502,76250013,2,0,1,-1,0
202502,76275000,2,96,268,-172,0.36
202502,76275000,2S1,0,2,-2,0
202502,76275000,3,2,12,-10,0.17
202502,76275000,3S1,0,2,-2,0
202502,76275000,3S2,12,0,12,NA
202502,76275000,3S3,234,3,231,78
202502,76275000,4,0,2,-2,0
202502,76275000,CA,2,212,-210,0.01
202502,76275000,V4,1,0,1,NA
202502,76275008,2,1,60,-59,0.02
202502,76275008,2S2,0,1,-1,0
202502,76275008,2S3,0,1,-1,0
202502,76275008,3,0,11,-11,0
202502,76275008,3S3,0,6,-6,0
202502,76275008,CA,0,14,-14,0
202502,76275024,3S2,0,1,-1,0
202502,76306000,2,828,926,-98,0.89
202502,76306000,2S1,0,21,-21,0
202502,76306000,2S2,21,28,-7,0.75
202502,76306000,2S3,2,12,-10,0.17
202502,76306000,3,0,49,-49,0
202502,76306000,3S1,0,14,-14,0
202502,76306000,3S2,0,34,-34,0
202502,76306000,3S3,3,72,-69,0.04
202502,76306000,CA,30,129,-99,0.23
202502,76306001,2,0,3,-3,0
202502,76318000,2,269,292,-23,0.92
202502,76318000,2R2,0,2,-2,0
202502,76318000,2S2,1,14,-13,0.07
202502,76318000,2S3,0,5,-5,0
202502,76318000,3,3,12,-9,0.25
202502,76318000,3S2,9,58,-49,0.16
202502,76318000,3S3,368,66,302,5.58
202502,76318000,CA,1,133,-132,0.01
202502,76318004,V2,1,0,1,NA
202502,76318006,2,1,0,1,NA
202502,76318006,3S3,1,0,1,NA
202502,76318008,2,0,9,-9,0
202502,76318008,3S3,0,23,-23,0
202502,76318008,CA,2,2,0,1
202502,76364000,2,990,2003,-1013,0.49
202502,76364000,2R2,0,4,-4,0
202502,76364000,2S1,0,4,-4,0
202502,76364000,2S2,5,49,-44,0.1
202502,76364000,2S3,4,23,-19,0.17
202502,76364000,3,34,72,-38,0.47
202502,76364000,3R3,0,1,-1,0
202502,76364000,3S1,0,4,-4,0
202502,76364000,3S2,13,109,-96,0.12
202502,76364000,3S3,79,424,-345,0.19
202502,76364000,4,0,1,-1,0
202502,76364000,CA,140,962,-822,0.15
202502,76364000,V4,0,2,-2,0
202502,76364002,2,0,1,-1,0
202502,76364004,2,0,3,-3,0
202502,76364009,CA,0,1,-1,0
202502,76364010,2,0,9,-9,0
202502,76364013,2,0,18,-18,0
202502,76364015,2,0,1,-1,0
202502,76364021,2,0,1,-1,0
202502,76364021,3S3,1,0,1,NA
202502,76377000,2,9,58,-49,0.16
202502,76377000,2S2,1,0,1,NA
202502,76377000,CA,0,26,-26,0
202502,76377001,2,0,7,-7,0
202502,76377004,2,1,1,0,1
202502,76400000,2,90,323,-233,0.28
202502,76400000,2S2,1,4,-3,0.25
202502,76400000,2S3,2,4,-2,0.5
202502,76400000,3,10,49,-39,0.2
202502,76400000,3S2,30,4,26,7.5
202502,76400000,3S3,39,172,-133,0.23
202502,76400000,CA,0,73,-73,0
202502,76400006,3S3,0,1,-1,0
202502,76400007,2,27,36,-9,0.75
202502,76400007,3S3,0,8,-8,0
202502,76400007,CA,1,3,-2,0.33
202502,76403000,2,164,96,68,1.71
202502,76403000,2R2,0,2,-2,0
202502,76403000,3,202,16,186,12.62
202502,76403000,3S2,18,0,18,NA
202502,76403000,3S3,20,2,18,10
202502,76403000,4,0,1,-1,0
202502,76403000,CA,0,9,-9,0
202502,76403007,2,0,6,-6,0
202502,76403007,3,0,1,-1,0
202502,76403007,3S3,3,7,-4,0.43
202502,76403010,2,0,1,-1,0
202502,76403010,CA,0,2,-2,0
202502,76497000,2,137,56,81,2.45
202502,76497000,3,2,12,-10,0.17
202502,76497000,3S2,2,1,1,2
202502,76497000,3S3,0,7,-7,0
202502,76497000,CA,0,35,-35,0
202502,76520000,2,10448,4788,5660,2.18
202502,76520000,2B1,0,4,-4,0
202502,76520000,2B2,0,1,-1,0
202502,76520000,2R2,84,0,84,NA
202502,76520000,2R3,0,8,-8,0
202502,76520000,2S1,2,21,-19,0.1
202502,76520000,2S2,1251,2260,-1009,0.55
202502,76520000,2S3,366,402,-36,0.91
202502,76520000,3,246,255,-9,0.96
202502,76520000,3S1,0,14,-14,0
202502,76520000,3S2,818,1177,-359,0.69
202502,76520000,3S3,3560,3509,51,1.01
202502,76520000,3S4,6,9,-3,0.67
202502,76520000,CA,1480,1495,-15,0.99
202502,76520000,V2,0,68,-68,0
202502,76520001,2,0,4,-4,0
202502,76520001,3S3,0,1,-1,0
202502,76520002,2,1,3,-2,0.33
202502,76520002,2S1,0,4,-4,0
202502,76520002,2S2,0,8,-8,0
202502,76520002,2S3,0,3,-3,0
202502,76520002,3,0,12,-12,0
202502,76520002,3S1,0,4,-4,0
202502,76520002,3S2,0,14,-14,0
202502,76520002,3S3,1,6,-5,0.17
202502,76520002,CA,1,1,0,1
202502,76520004,3S2,1,1,0,1
202502,76520004,3S3,2,1,1,2
202502,76520005,2,0,8,-8,0
202502,76520007,CA,0,1,-1,0
202502,76520009,CA,0,4,-4,0
202502,76520010,2,9,2,7,4.5
202502,76520010,3S3,6,2,4,3
202502,76520014,2,0,2,-2,0
202502,76520014,4,0,1,-1,0
202502,76520016,2,2,2,0,1
202502,76520022,2,0,12,-12,0
202502,76520022,3S3,0,4,-4,0
202502,76520023,2,0,7,-7,0
202502,76520024,2,305,50,255,6.1
202502,76520024,2S1,7,10,-3,0.7
202502,76520024,2S2,524,1137,-613,0.46
202502,76520024,2S3,3,0,3,NA
202502,76520024,3S2,6,0,6,NA
202502,76520024,CA,11,0,11,NA
202502,76520026,2,112,66,46,1.7
202502,76520026,2S2,1,2,-1,0.5
202502,76520026,2S3,0,1,-1,0
202502,76520026,3,6,3,3,2
202502,76520026,3S2,16,10,6,1.6
202502,76520026,3S3,6,20,-14,0.3
202502,76520026,4,0,1,-1,0
202502,76520026,CA,6,37,-31,0.16
202502,76520028,2,1,2,-1,0.5
202502,76520028,CA,3,0,3,NA
202502,76520029,2,0,1,-1,0
202502,76520029,3S2,40,0,40,NA
202502,76520029,3S3,1,0,1,NA
202502,76520038,2,49,21,28,2.33
202502,76520038,3,0,3,-3,0
202502,76520038,3S2,1,13,-12,0.08
202502,76520038,3S3,2,32,-30,0.06
202502,76563000,2,159,316,-157,0.5
202502,76563000,2R2,0,4,-4,0
202502,76563000,2S2,0,9,-9,0
202502,76563000,3,2,7,-5,0.29
202502,76563000,3S2,3,4,-1,0.75
202502,76563000,3S3,364,102,262,3.57
202502,76563000,4,0,1,-1,0
202502,76563000,CA,4,152,-148,0.03
202502,76563016,2,1,0,1,NA
202502,76606000,2,186,287,-101,0.65
202502,76606000,2S1,1,0,1,NA
202502,76606000,2S2,0,12,-12,0
202502,76606000,3,2,109,-107,0.02
202502,76606000,3S2,3,20,-17,0.15
202502,76606000,3S3,1,12,-11,0.08
202502,76606000,3S4,1,0,1,NA
202502,76606000,CA,0,83,-83,0
202502,76606004,2,0,1,-1,0
202502,76616000,2,64,93,-29,0.69
202502,76616000,2R2,0,1,-1,0
202502,76616000,2S2,2,0,2,NA
202502,76616000,3,4,2,2,2
202502,76616000,3S2,15,0,15,NA
202502,76616000,3S3,225,22,203,10.23
202502,76616000,4,0,1,-1,0
202502,76616000,CA,1,40,-39,0.03
202502,76616000,V2,0,2,-2,0
202502,76616000,V3,0,4,-4,0
202502,76616009,2,2,8,-6,0.25
202502,76622000,2,214,346,-132,0.62
202502,76622000,2R3,0,1,-1,0
202502,76622000,2S2,0,3,-3,0
202502,76622000,3,1,16,-15,0.06
202502,76622000,3S2,1,6,-5,0.17
202502,76622000,3S3,43,42,1,1.02
202502,76622000,4,1,1,0,1
202502,76622000,CA,8,146,-138,0.05
202502,76622005,2,40,224,-184,0.18
202502,76622005,2B1,0,2,-2,0
202502,76622005,2S1,9,0,9,NA
202502,76622005,2S2,9,5,4,1.8
202502,76622005,2S3,3,0,3,NA
202502,76622005,3,49,0,49,NA
202502,76622005,3S1,14,0,14,NA
202502,76622005,3S2,13,0,13,NA
202502,76622005,3S3,26,82,-56,0.32
202502,76622005,CA,2,10,-8,0.2
202502,76670000,2,44,94,-50,0.47
202502,76670000,2S2,0,10,-10,0
202502,76670000,2S3,0,1,-1,0
202502,76670000,3,2,10,-8,0.2
202502,76670000,3S2,2,5,-3,0.4
202502,76670000,3S3,52,122,-70,0.43
202502,76670000,CA,1,21,-20,0.05
202502,76670007,2,5,10,-5,0.5
202502,76670012,3,0,1,-1,0
202502,76670015,CA,0,2,-2,0
202502,76736000,2,150,321,-171,0.47
202502,76736000,3,0,12,-12,0
202502,76736000,3S2,11,2,9,5.5
202502,76736000,3S3,5,20,-15,0.25
202502,76736000,CA,0,350,-350,0
202502,76736004,2,1,4,-3,0.25
202502,76823000,2,9,131,-122,0.07
202502,76823000,3,0,2,-2,0
202502,76823000,3S3,0,1,-1,0
202502,76823000,CA,3,53,-50,0.06
202502,76823006,2,0,1,-1,0
202502,76823006,CA,0,1,-1,0
202502,76828000,2,31,156,-125,0.2
202502,76828000,2R2,0,1,-1,0
202502,76828000,3,0,15,-15,0
202502,76828000,3S2,0,1,-1,0
202502,76828000,3S3,0,7,-7,0
202502,76828000,CA,0,57,-57,0
202502,76828004,2,0,2,-2,0
202502,76828017,CA,0,1,-1,0
202502,76834000,2,887,2833,-1946,0.31
202502,76834000,2R2,0,18,-18,0
202502,76834000,2R3,0,5,-5,0
202502,76834000,2S1,1,4,-3,0.25
202502,76834000,2S2,14,118,-104,0.12
202502,76834000,2S3,14,34,-20,0.41
202502,76834000,3,35,70,-35,0.5
202502,76834000,3S1,0,6,-6,0
202502,76834000,3S2,162,59,103,2.75
202502,76834000,3S3,705,1244,-539,0.57
202502,76834000,3S4,0,2,-2,0
202502,76834000,4,1,0,1,NA
202502,76834000,CA,620,874,-254,0.71
202502,76834000,V3,1,0,1,NA
202502,76834002,2,1,1,0,1
202502,76834010,2,0,5,-5,0
202502,76845000,2,4,28,-24,0.14
202502,76845000,CA,0,31,-31,0
202502,76863000,2,2,21,-19,0.1
202502,76863000,CA,0,45,-45,0
202502,76869000,2,35,101,-66,0.35
202502,76869000,2S2,0,1,-1,0
202502,76869000,2S3,1,1,0,1
202502,76869000,3,7,0,7,NA
202502,76869000,3S2,0,2,-2,0
202502,76869000,3S3,40,1077,-1037,0.04
202502,76869000,CA,2,73,-71,0.03
202502,76869000,V2,13,0,13,NA
202502,76869004,2,0,2,-2,0
202502,76869006,2,0,2,-2,0
202502,76890000,2,981,256,725,3.83
202502,76890000,2S2,2277,2588,-311,0.88
202502,76890000,2S3,288,235,53,1.23
202502,76890000,3,53,28,25,1.89
202502,76890000,3S2,28,269,-241,0.1
202502,76890000,3S3,643,1093,-450,0.59
202502,76890000,4,10,2,8,5
202502,76890000,CA,3,61,-58,0.05
202502,76890000,V4,0,1,-1,0
202502,76890006,2,27,12,15,2.25
202502,76890006,2S2,0,1,-1,0
202502,76890006,3,7,1,6,7
202502,76890006,3S2,0,1,-1,0
202502,76890006,3S3,19,1,18,19
202502,76890006,CA,0,2,-2,0
202502,76890006,V3,0,1,-1,0
202502,76892000,2,35288,7573,27715,4.66
202502,76892000,2B1,0,2,-2,0
202502,76892000,2B2,0,5,-5,0
202502,76892000,2R2,3,0,3,NA
202502,76892000,2R3,11,30,-19,0.37
202502,76892000,2S1,4,50,-46,0.08
202502,76892000,2S2,1549,2470,-921,0.63
202502,76892000,2S3,501,750,-249,0.67
202502,76892000,3,1395,162,1233,8.61
202502,76892000,3R3,0,3,-3,0
202502,76892000,3S1,0,20,-20,0
202502,76892000,3S2,2502,2961,-459,0.84
202502,76892000,3S3,8144,9272,-1128,0.88
202502,76892000,3S4,14,3,11,4.67
202502,76892000,4,17,5,12,3.4
202502,76892000,CA,10510,1204,9306,8.73
202502,76892000,V4,4,0,4,NA
202502,76892002,2,0,22,-22,0
202502,76892002,3S3,0,3,-3,0
202502,76892002,CA,0,2,-2,0
202502,76892004,2,120,155,-35,0.77
202502,76892004,3,1,7,-6,0.14
202502,76892004,3S2,9,0,9,NA
202502,76892004,3S3,26,9,17,2.89
202502,76892004,4,2,2,0,1
202502,76892004,CA,4,6,-2,0.67
202502,76892005,2,53,1,52,53
202502,76892005,3,6,0,6,NA
202502,76892005,3S2,13,0,13,NA
202502,76892005,3S3,101,15,86,6.73
202502,76892005,CA,0,1,-1,0
202502,76892008,2,128,0,128,NA
202502,76892008,2S2,2,0,2,NA
202502,76892008,3,7,0,7,NA
202502,76892008,3S3,47,0,47,NA
202502,76892010,2,1,1,0,1
202502,76892010,2S2,0,6,-6,0
202502,76892010,3S3,1,2,-1,0.5
202502,76892012,2,0,8,-8,0
202502,76892017,2,298,5,293,59.6
202502,76892017,2S2,0,1,-1,0
202502,76892017,3S2,7,16,-9,0.44
202502,76892017,3S3,16,57,-41,0.28
202502,76892017,CA,158,0,158,NA
202502,76895000,2,93,494,-401,0.19
202502,76895000,2R2,0,14,-14,0
202502,76895000,2R3,0,1,-1,0
202502,76895000,2S2,5,19,-14,0.26
202502,76895000,2S3,1,4,-3,0.25
202502,76895000,3,5,6,-1,0.83
202502,76895000,3S1,1,0,1,NA
202502,76895000,3S2,68,38,30,1.79
202502,76895000,3S3,557,146,411,3.82
202502,76895000,4,0,1,-1,0
202502,76895000,CA,1,174,-173,0.01
202502,76895002,2,194,393,-199,0.49
202502,76895002,2R2,0,1,-1,0
202502,76895002,2S2,38,14,24,2.71
202502,76895002,2S3,20,20,0,1
202502,76895002,3,6,1,5,6
202502,76895002,3S2,93,87,6,1.07
202502,76895002,3S3,288,242,46,1.19
202502,76895002,4,1,0,1,NA
202502,76895002,CA,1,47,-46,0.02
202502,76895002,V2,0,5,-5,0
202502,76895003,3S3,0,1,-1,0
202502,76895005,2,0,1,-1,0
202502,76895007,2,0,2,-2,0
202502,81001000,2,213,2319,-2106,0.09
202502,81001000,2S2,0,10,-10,0
202502,81001000,3,16,50,-34,0.32
202502,81001000,3S1,1,0,1,NA
202502,81001000,3S2,5,8,-3,0.62
202502,81001000,3S3,45,397,-352,0.11
202502,81001000,CA,15,48,-33,0.31
202502,81001000,V2,0,7,-7,0
202502,81001000,V3,3,37,-34,0.08
202502,81001003,2,0,2,-2,0
202502,81065000,2,46,205,-159,0.22
202502,81065000,2S2,1,1,0,1
202502,81065000,3,3,11,-8,0.27
202502,81065000,3S2,2,4,-2,0.5
202502,81065000,3S3,19,15,4,1.27
202502,81065000,CA,3,15,-12,0.2
202502,81065000,V3,4,0,4,NA
202502,81065008,2,0,22,-22,0
202502,81065009,2,0,3,-3,0
202502,81065009,CA,0,1,-1,0
202502,81065017,2,5,16,-11,0.31
202502,81065017,CA,0,2,-2,0
202502,81220000,2,0,5,-5,0
202502,81220000,CA,0,1,-1,0
202502,81220000,V2,0,1,-1,0
202502,81300000,2,8,89,-81,0.09
202502,81300000,3,0,4,-4,0
202502,81300000,3S3,0,9,-9,0
202502,81300000,CA,0,3,-3,0
202502,81300002,3S3,0,2,-2,0
202502,81591000,2,4,3,1,1.33
202502,81591000,3,0,1,-1,0
202502,81591000,3S3,0,3,-3,0
202502,81591000,CA,0,1,-1,0
202502,81736000,2,174,1034,-860,0.17
202502,81736000,3,131,14,117,9.36
202502,81736000,3S2,0,2,-2,0
202502,81736000,3S3,10,93,-83,0.11
202502,81736000,4,9,0,9,NA
202502,81736000,CA,11,25,-14,0.44
202502,81736000,V2,8,0,8,NA
202502,81736000,V3,33,0,33,NA
202502,81736008,2,0,5,-5,0
202502,81794000,2,120,616,-496,0.19
202502,81794000,2S2,2,0,2,NA
202502,81794000,2S3,4,1,3,4
202502,81794000,3,11,19,-8,0.58
202502,81794000,3S1,2,0,2,NA
202502,81794000,3S2,22,2,20,11
202502,81794000,3S3,1403,44,1359,31.89
202502,81794000,3S4,0,1,-1,0
202502,81794000,CA,4,54,-50,0.07
202502,81794000,V2,3,0,3,NA
202502,81794000,V3,21,1,20,21
202502,81794004,2,2,2,0,1
202502,81794004,CA,2,2,0,1
202502,81794006,2,0,1,-1,0
202502,81794010,2,0,6,-6,0
202502,81794010,CA,0,1,-1,0
202502,81794019,2,0,3,-3,0
202502,85001000,2,1163,3280,-2117,0.35
202502,85001000,2R2,1,2,-1,0.5
202502,85001000,2R3,1,9,-8,0.11
202502,85001000,2S1,3,1,2,3
202502,85001000,2S2,123,197,-74,0.62
202502,85001000,2S3,43,85,-42,0.51
202502,85001000,3,181,273,-92,0.66
202502,85001000,3S1,18,28,-10,0.64
202502,85001000,3S2,459,1021,-562,0.45
202502,85001000,3S3,2930,3636,-706,0.81
202502,85001000,3S4,14,23,-9,0.61
202502,85001000,4,4,3,1,1.33
202502,85001000,4S2,8,2,6,4
202502,85001000,CA,344,630,-286,0.55
202502,85001000,V2,133,0,133,NA
202502,85001000,V3,782,19,763,41.16
202502,85001000,V4,0,1,-1,0
202502,85001001,2,0,3,-3,0
202502,85001001,3S1,0,5,-5,0
202502,85001001,3S2,0,3,-3,0
202502,85001001,3S3,44,19,25,2.32
202502,85001002,2,5,13,-8,0.38
202502,85001002,2S2,0,2,-2,0
202502,85001002,2S3,1,0,1,NA
202502,85001002,3,8,0,8,NA
202502,85001002,3S2,8,39,-31,0.21
202502,85001002,3S3,87,239,-152,0.36
202502,85001002,CA,0,1,-1,0
202502,85001002,V2,4,0,4,NA
202502,85001002,V3,102,1,101,102
202502,85001002,V4,7,0,7,NA
202502,85001003,2,1,7,-6,0.14
202502,85001003,2S2,1,1,0,1
202502,85001003,3S2,18,4,14,4.5
202502,85001003,3S3,33,5,28,6.6
202502,85001003,CA,0,3,-3,0
202502,85001003,V3,0,4,-4,0
202502,85001005,3S3,0,1,-1,0
202502,85001006,2,1,0,1,NA
202502,85001006,CA,1,3,-2,0.33
202502,85001007,3S3,6,2,4,3
202502,85001009,2,0,3,-3,0
202502,85001009,3S3,0,2,-2,0
202502,85010000,2,112,243,-131,0.46
202502,85010000,2S2,2,4,-2,0.5
202502,85010000,2S3,1,4,-3,0.25
202502,85010000,3,191,73,118,2.62
202502,85010000,3S1,5,2,3,2.5
202502,85010000,3S2,352,877,-525,0.4
202502,85010000,3S3,937,683,254,1.37
202502,85010000,3S4,1,5,-4,0.2
202502,85010000,CA,2,58,-56,0.03
202502,85010000,V2,5,83,-78,0.06
202502,85010000,V3,52,277,-225,0.19
202502,85010000,V4,3,22,-19,0.14
202502,85010001,3S2,14,0,14,NA
202502,85010001,3S3,215,8,207,26.88
202502,85010001,CA,0,2,-2,0
202502,85010005,2,1,2,-1,0.5
202502,85010005,3S3,0,3,-3,0
202502,85010005,4S2,1,0,1,NA
202502,85010005,V3,0,1,-1,0
202502,85010010,3S2,1,0,1,NA
202502,85010010,3S3,13,0,13,NA
202502,85015000,2,1,1,0,1
202502,85015000,3,0,2,-2,0
202502,85015000,3S2,0,3,-3,0
202502,85125000,2,56,88,-32,0.64
202502,85125000,2S2,0,1,-1,0
202502,85125000,3,5,4,1,1.25
202502,85125000,3S2,1,11,-10,0.09
202502,85125000,3S3,1,46,-45,0.02
202502,85125000,CA,1,8,-7,0.12
202502,85125000,V3,0,9,-9,0
202502,85125004,3S3,0,1,-1,0
202502,85125005,CA,0,1,-1,0
202502,85139000,2,15,133,-118,0.11
202502,85139000,2S1,0,1,-1,0
202502,85139000,2S2,1,4,-3,0.25
202502,85139000,2S3,2,3,-1,0.67
202502,85139000,3,4,29,-25,0.14
202502,85139000,3S1,0,2,-2,0
202502,85139000,3S2,80,116,-36,0.69
202502,85139000,3S3,417,398,19,1.05
202502,85139000,3S4,5,3,2,1.67
202502,85139000,CA,3,48,-45,0.06
202502,85139000,V2,0,20,-20,0
202502,85139000,V3,0,102,-102,0
202502,85139003,3S3,1,0,1,NA
202502,85139005,3S2,1,1,0,1
202502,85139005,3S3,2,1,1,2
202502,85162000,2,16,120,-104,0.13
202502,85162000,2S2,4,1,3,4
202502,85162000,2S3,0,2,-2,0
202502,85162000,3,27,22,5,1.23
202502,85162000,3S1,0,1,-1,0
202502,85162000,3S2,8,546,-538,0.01
202502,85162000,3S3,37,1943,-1906,0.02
202502,85162000,4,1,2,-1,0.5
202502,85162000,CA,1,27,-26,0.04
202502,85162004,3S3,1,57,-56,0.02
202502,85225000,2,10,30,-20,0.33
202502,85225000,2S3,1,0,1,NA
202502,85225000,3,6,8,-2,0.75
202502,85225000,3S1,0,2,-2,0
202502,85225000,3S2,2,3,-1,0.67
202502,85225000,3S3,147,30,117,4.9
202502,85225000,4,1,0,1,NA
202502,85225000,V3,17,61,-44,0.28
202502,85225006,2,1,0,1,NA
202502,85225009,2,11,5,6,2.2
202502,85225009,2S2,0,8,-8,0
202502,85225009,3,1,0,1,NA
202502,85225009,CA,4,5,-1,0.8
202502,85225016,2,1,3,-2,0.33
202502,85225016,2S2,0,1,-1,0
202502,85225016,3S3,2,2,0,1
202502,85230000,2,29,165,-136,0.18
202502,85230000,2S1,0,2,-2,0
202502,85230000,2S2,7,20,-13,0.35
202502,85230000,2S3,8,18,-10,0.44
202502,85230000,3,11,84,-73,0.13
202502,85230000,3S1,0,1,-1,0
202502,85230000,3S2,403,27,376,14.93
202502,85230000,3S3,1280,201,1079,6.37
202502,85230000,3S4,2,0,2,NA
202502,85230000,4,0,1,-1,0
202502,85230000,4S2,0,3,-3,0
202502,85230000,CA,4,20,-16,0.2
202502,85230000,V2,11,50,-39,0.22
202502,85230000,V3,68,657,-589,0.1
202502,85230000,V4,0,7,-7,0
202502,85230003,2,0,1,-1,0
202502,85230003,3S2,119,0,119,NA
202502,85230003,3S3,48,0,48,NA
202502,85230006,3S3,12,0,12,NA
202502,85250000,2,112,446,-334,0.25
202502,85250000,2S1,2,0,2,NA
202502,85250000,2S2,5,5,0,1
202502,85250000,2S3,0,3,-3,0
202502,85250000,3,5,17,-12,0.29
202502,85250000,3S1,22,0,22,NA
202502,85250000,3S2,165,34,131,4.85
202502,85250000,3S3,255,180,75,1.42
202502,85250000,3S4,3,1,2,3
202502,85250000,4S2,0,3,-3,0
202502,85250000,CA,19,70,-51,0.27
202502,85250000,V3,0,30,-30,0
202502,85250001,3S3,4,0,4,NA
202502,85250002,3S2,5,0,5,NA
202502,85250003,3S3,24,0,24,NA
202502,85250005,2,0,1,-1,0
202502,85263000,2,41,115,-74,0.36
202502,85263000,2S2,2,3,-1,0.67
202502,85263000,2S3,0,1,-1,0
202502,85263000,3,1,5,-4,0.2
202502,85263000,3S1,0,2,-2,0
202502,85263000,3S2,15,5,10,3
202502,85263000,3S3,298,73,225,4.08
202502,85263000,CA,3,9,-6,0.33
202502,85263000,V2,0,3,-3,0
202502,85263000,V3,2,32,-30,0.06
202502,85263001,2,0,1,-1,0
202502,85263002,2,0,1,-1,0
202502,85279000,CA,0,1,-1,0
202502,85300000,2,1,7,-6,0.14
202502,85300000,2S2,0,1,-1,0
202502,85300000,3,0,2,-2,0
202502,85300000,3S3,0,1,-1,0
202502,85300000,CA,0,1,-1,0
202502,85300001,2,2,4,-2,0.5
202502,85300001,2S2,1,3,-2,0.33
202502,85300001,3,1,2,-1,0.5
202502,85300001,3S3,0,5,-5,0
202502,85300001,CA,0,19,-19,0
202502,85315000,2,0,6,-6,0
202502,85315000,3S2,0,1,-1,0
202502,85325000,2,23,66,-43,0.35
202502,85325000,2S2,5,5,0,1
202502,85325000,2S3,3,1,2,3
202502,85325000,3,9,11,-2,0.82
202502,85325000,3S2,52,12,40,4.33
202502,85325000,3S3,193,64,129,3.02
202502,85325000,CA,3,2,1,1.5
202502,85325000,V3,0,23,-23,0
202502,85325002,3S3,1,0,1,NA
202502,85400000,2,6,6,0,1
202502,85400000,CA,0,3,-3,0
202502,85400000,V3,0,1,-1,0
202502,85410000,2,76,215,-139,0.35
202502,85410000,2S2,9,6,3,1.5
202502,85410000,2S3,5,5,0,1
202502,85410000,3,29,128,-99,0.23
202502,85410000,3S1,0,1,-1,0
202502,85410000,3S2,241,1275,-1034,0.19
202502,85410000,3S3,937,3401,-2464,0.28
202502,85410000,3S4,2,1,1,2
202502,85410000,4,0,7,-7,0
202502,85410000,CA,12,71,-59,0.17
202502,85410000,V2,15,12,3,1.25
202502,85410000,V3,52,6,46,8.67
202502,85410001,3S2,0,6,-6,0
202502,85410001,3S3,0,244,-244,0
202502,85410002,3S2,0,3,-3,0
202502,85410002,3S3,0,4,-4,0
202502,85410004,2S3,1,0,1,NA
202502,85410005,3S2,0,9,-9,0
202502,85410005,3S3,0,28,-28,0
202502,85430000,2,20,79,-59,0.25
202502,85430000,2S1,0,2,-2,0
202502,85430000,2S2,5,7,-2,0.71
202502,85430000,2S3,1,5,-4,0.2
202502,85430000,3,1,7,-6,0.14
202502,85430000,3S1,0,21,-21,0
202502,85430000,3S2,11,26,-15,0.42
202502,85430000,3S3,20,49,-29,0.41
202502,85430000,3S4,2,1,1,2
202502,85430000,4S2,1,3,-2,0.33
202502,85430000,CA,1,20,-19,0.05
202502,85430000,V2,0,1,-1,0
202502,85430000,V3,0,71,-71,0
202502,85430001,3,0,1,-1,0
202502,85430001,3S2,1,1,0,1
202502,85430001,V3,0,4,-4,0
202502,85430005,2,0,1,-1,0
202502,85430006,3S3,0,2,-2,0
202502,85440000,2,81,458,-377,0.18
202502,85440000,2B2,0,2,-2,0
202502,85440000,2R2,0,2,-2,0
202502,85440000,2S2,43,25,18,1.72
202502,85440000,2S3,16,22,-6,0.73
202502,85440000,3,37,94,-57,0.39
202502,85440000,3S1,4,7,-3,0.57
202502,85440000,3S2,302,49,253,6.16
202502,85440000,3S3,488,243,245,2.01
202502,85440000,3S4,10,2,8,5
202502,85440000,CA,20,91,-71,0.22
202502,85440000,V2,4,0,4,NA
202502,85440000,V3,157,0,157,NA
202502,85440001,2,6,5,1,1.2
202502,85440001,2S2,1,1,0,1
202502,85440001,2S3,1,3,-2,0.33
202502,85440001,3,2,2,0,1
202502,85440001,3S2,2,4,-2,0.5
202502,85440001,3S3,12,7,5,1.71
202502,85440001,3S4,1,0,1,NA
202502,85440002,3,0,1,-1,0
202502,85440002,3S3,2,6,-4,0.33
202502,85440002,CA,0,1,-1,0
202502,86001000,2,175,419,-244,0.42
202502,86001000,2R2,0,8,-8,0
202502,86001000,2S2,0,40,-40,0
202502,86001000,2S3,1,11,-10,0.09
202502,86001000,3,54,29,25,1.86
202502,86001000,3S1,0,2,-2,0
202502,86001000,3S2,1,2,-1,0.5
202502,86001000,3S3,6,169,-163,0.04
202502,86001000,CA,94,124,-30,0.76
202502,86001000,V2,1,0,1,NA
202502,86001004,2,0,1,-1,0
202502,86001004,3,21,2,19,10.5
202502,86001004,CA,1,1,0,1
202502,86219000,2,0,3,-3,0
202502,86320000,2,88,163,-75,0.54
202502,86320000,2R2,0,7,-7,0
202502,86320000,2S1,1,0,1,NA
202502,86320000,2S2,0,5,-5,0
202502,86320000,2S3,0,1,-1,0
202502,86320000,3,162,17,145,9.53
202502,86320000,3S1,11,2,9,5.5
202502,86320000,3S2,14,188,-174,0.07
202502,86320000,3S3,79,344,-265,0.23
202502,86320000,3S4,2,0,2,NA
202502,86320000,CA,1,44,-43,0.02
202502,86320000,V2,1,0,1,NA
202502,86320008,2,0,2,-2,0
202502,86320010,2,0,1,-1,0
202502,86320012,CA,0,4,-4,0
202502,86568000,2,117,729,-612,0.16
202502,86568000,2R2,0,7,-7,0
202502,86568000,2S2,0,12,-12,0
202502,86568000,2S3,0,8,-8,0
202502,86568000,3,9,146,-137,0.06
202502,86568000,3S2,234,63,171,3.71
202502,86568000,3S3,507,590,-83,0.86
202502,86568000,3S4,1,2,-1,0.5
202502,86568000,4,0,1,-1,0
202502,86568000,CA,25,93,-68,0.27
202502,86568003,2,0,1,-1,0
202502,86568012,2,1,5,-4,0.2
202502,86568012,3S4,0,1,-1,0
202502,86568013,2,2,56,-54,0.04
202502,86568013,3,0,1,-1,0
202502,86568013,3S3,42,9,33,4.67
202502,86568013,CA,0,14,-14,0
202502,86568014,2,1,1,0,1
202502,86568015,2,0,1,-1,0
202502,86568016,2,0,4,-4,0
202502,86568016,3S2,8,0,8,NA
202502,86568016,3S3,1,0,1,NA
202502,86568016,CA,0,2,-2,0
202502,86568017,3S2,10,0,10,NA
202502,86568017,3S3,24,0,24,NA
202502,86568017,CA,1,1,0,1
202502,86568019,2,0,3,-3,0
202502,86568019,3S2,0,1,-1,0
202502,86568019,3S3,1,0,1,NA
202502,86568019,CA,1,0,1,NA
202502,86568021,3S2,1,0,1,NA
202502,86568021,3S3,3,0,3,NA
202502,86568026,2,7,1,6,7
202502,86568026,2S3,1,0,1,NA
202502,86568026,3S2,2,1,1,2
202502,86568026,3S3,10,0,10,NA
202502,86568026,CA,2,0,2,NA
202502,86569000,2,1,31,-30,0.03
202502,86569000,3,51,25,26,2.04
202502,86569000,3S3,0,6,-6,0
202502,86569000,CA,0,22,-22,0
202502,86571000,2,5,45,-40,0.11
202502,86571000,3S3,0,3,-3,0
202502,86571000,CA,0,2,-2,0
202502,86571000,V2,0,1,-1,0
202502,86573000,2,0,11,-11,0
202502,86573000,3,0,2,-2,0
202502,86573001,2,0,1,-1,0
202502,86573007,2,0,1,-1,0
202502,86749000,2,10,67,-57,0.15
202502,86749000,3,3,4,-1,0.75
202502,86749000,3S3,7,13,-6,0.54
202502,86749000,4,0,4,-4,0
202502,86749000,CA,2,25,-23,0.08
202502,86749003,2,0,3,-3,0
202502,86749006,2,0,3,-3,0
202502,86749006,3S3,0,2,-2,0
202502,86755000,2,3,23,-20,0.13
202502,86755000,2S2,0,7,-7,0
202502,86755000,2S3,0,6,-6,0
202502,86755000,3,1,0,1,NA
202502,86755000,3S2,1,2,-1,0.5
202502,86755000,3S3,0,4,-4,0
202502,86755000,CA,0,32,-32,0
202502,86757000,2,1,76,-75,0.01
202502,86757000,2S1,0,1,-1,0
202502,86757000,3,4,163,-159,0.02
202502,86757000,3S1,2,10,-8,0.2
202502,86757000,3S2,5,73,-68,0.07
202502,86757000,3S3,7,655,-648,0.01
202502,86757000,3S4,0,1,-1,0
202502,86757000,CA,1,19,-18,0.05
202502,86757001,2,0,5,-5,0
202502,86757001,3S3,0,2,-2,0
202502,86760000,2,0,1,-1,0
202502,86760000,3S3,0,2,-2,0
202502,86760000,CA,0,13,-13,0
202502,86865000,2,38,605,-567,0.06
202502,86865000,2S2,0,2,-2,0
202502,86865000,2S3,0,2,-2,0
202502,86865000,3,16,4,12,4
202502,86865000,3S2,2,1,1,2
202502,86865000,3S3,3,66,-63,0.05
202502,86865000,CA,4,32,-28,0.12
202502,86865005,2,0,1,-1,0
202502,86865017,2,0,2,-2,0
202502,86865017,CA,0,16,-16,0
202502,86865021,3S3,0,2,-2,0
202502,86885000,2,27,173,-146,0.16
202502,86885000,2S2,0,1,-1,0
202502,86885000,2S3,1,0,1,NA
202502,86885000,3,18,118,-100,0.15
202502,86885000,3S1,1,2,-1,0.5
202502,86885000,3S2,82,3,79,27.33
202502,86885000,3S3,633,91,542,6.96
202502,86885000,CA,30,47,-17,0.64
202502,86885001,3,56,4,52,14
202502,86885001,3S2,2,0,2,NA
202502,86885001,3S3,29,0,29,NA
202502,86885009,2,0,1,-1,0
202502,86885010,2,0,1,-1,0
202502,88001000,2,0,3,-3,0
202502,88001000,3,0,1,-1,0
202502,88001000,3S3,0,2,-2,0
202502,88564000,2,0,2,-2,0
202502,91001000,2,1,48,-47,0.02
202502,91001000,3S3,0,5,-5,0
202502,91001000,CA,0,1,-1,0
202502,91460000,2,0,2,-2,0
202502,91540000,2,0,1,-1,0
202502,94001000,2,0,19,-19,0
202502,94001000,3,0,10,-10,0
202502,94001000,3S2,0,12,-12,0
202502,94001000,3S3,0,17,-17,0
202502,94883000,CA,0,1,-1,0
202502,95001000,2,120,1453,-1333,0.08
202502,95001000,2B2,0,2,-2,0
202502,95001000,2S2,2,11,-9,0.18
202502,95001000,2S3,0,2,-2,0
202502,95001000,3,5,51,-46,0.1
202502,95001000,3S2,0,6,-6,0
202502,95001000,3S3,3,377,-374,0.01
202502,95001000,4,0,2,-2,0
202502,95001000,CA,32,354,-322,0.09
202502,95001000,V3,0,17,-17,0
202502,95015000,2,1,33,-32,0.03
202502,95015000,3,0,7,-7,0
202502,95015000,3S3,0,6,-6,0
202502,95015000,CA,0,3,-3,0
202502,95025000,2,3,27,-24,0.11
202502,95025000,3,0,1,-1,0
202502,95025000,3S3,0,3,-3,0
202502,95025000,CA,0,2,-2,0
202502,95025001,2,0,1,-1,0
202502,95200000,3S3,1,0,1,NA
202502,97001000,2,0,16,-16,0
202502,97001000,3,0,6,-6,0
202502,97001000,3S3,0,8,-8,0
202502,97001000,CA,0,3,-3,0
202502,99001000,2,14,61,-47,0.23
202502,99001000,2S3,0,2,-2,0
202502,99001000,3,1,41,-40,0.02
202502,99001000,3S2,0,21,-21,0
202502,99001000,3S3,0,116,-116,0
202502,99001000,CA,0,6,-6,0
202502,99001001,3S3,3,0,3,NA
202502,99001002,3,0,2,-2,0
202502,99524000,2,5,63,-58,0.08
202502,99524000,3,0,18,-18,0
202502,99524000,3S2,9,0,9,NA
202502,99524000,3S3,11,8,3,1.38
202502,99524000,CA,0,27,-27,0
202502,99524000,V2,0,7,-7,0
202502,99524000,V3,0,23,-23,0
202502,99524001,3,1,1,0,1
202502,99524001,CA,0,1,-1,0
202502,99624000,2,2,46,-44,0.04
202502,99624000,2S2,0,1,-1,0
202502,99624000,3,1,5,-4,0.2
202502,99624000,3S2,4,0,4,NA
202502,99624000,3S3,25,2,23,12.5
202502,99624000,V2,0,1,-1,0
202502,99773000,2,0,17,-17,0
202502,99773000,3,1,22,-21,0.05
202502,99773000,3S2,2,2,0,1
202502,99773000,3S3,93,69,24,1.35
202502,99773000,CA,0,1,-1,0
202502,99773000,V3,1,0,1,NA
202502,99773001,2,0,1,-1,0
202502,99773002,2,0,1,-1,0
202502,99773002,3S3,46,46,0,1
202502,99773013,2,0,1,-1,0
202502,99773013,3,0,1,-1,0
202502,99773013,3S3,0,1,-1,0
202502,99773015,3,0,1,-1,0
202503,5001000,2,26739,34299,-7560,0.78
202503,5001000,2B1,0,10,-10,0
202503,5001000,2B2,0,3,-3,0
202503,5001000,2R2,2,25,-23,0.08
202503,5001000,2S1,0,9,-9,0
202503,5001000,2S2,1142,2904,-1762,0.39
202503,5001000,2S3,446,1741,-1295,0.26
202503,5001000,3,1793,960,833,1.87
202503,5001000,3S1,5,5,0,1
202503,5001000,3S2,2488,3022,-534,0.82
202503,5001000,3S2S2,1,0,1,NA
202503,5001000,3S3,3573,7952,-4379,0.45
202503,5001000,3S4,3,6,-3,0.5
202503,5001000,4,16,88,-72,0.18
202503,5001000,CA,9610,16629,-7019,0.58
202503,5001000,V2,32,0,32,NA
202503,5001000,V3,50,500,-450,0.1
202503,5001001,2,1,44,-43,0.02
202503,5001001,3,0,1,-1,0
202503,5001001,CA,0,32,-32,0
202503,5001002,2,6,30,-24,0.2
202503,5001002,2S2,1,0,1,NA
202503,5001002,2S3,0,1,-1,0
202503,5001002,3,0,6,-6,0
202503,5001002,3S2,2,1,1,2
202503,5001002,3S3,4,4,0,1
202503,5001002,CA,0,13,-13,0
202503,5001003,2,9,12,-3,0.75
202503,5001003,2S3,1,0,1,NA
202503,5001003,3S2,1,1,0,1
202503,5001003,3S3,17,3,14,5.67
202503,5001003,CA,0,2,-2,0
202503,5001004,2,4,32,-28,0.12
202503,5001004,3S2,0,1,-1,0
202503,5001004,CA,0,6,-6,0
202503,5001009,3S3,17,0,17,NA
202503,5001010,2,0,13,-13,0
202503,5002000,2,55,56,-1,0.98
202503,5002000,2S2,0,13,-13,0
202503,5002000,3,4,31,-27,0.13
202503,5002000,3S2,1,1,0,1
202503,5002000,CA,1,15,-14,0.07
202503,5002000,V2,182,0,182,NA
202503,5002000,V3,0,1,-1,0
202503,5002010,2,0,52,-52,0
202503,5002010,3,0,10,-10,0
202503,5004000,2,2,12,-10,0.17
202503,5004000,3,2,2,0,1
202503,5004000,3S2,0,2,-2,0
202503,5004000,3S3,17,0,17,NA
202503,5004000,CA,0,3,-3,0
202503,5021000,2,2,11,-9,0.18
202503,5021000,3,0,7,-7,0
202503,5021000,3S2,0,5,-5,0
202503,5021000,3S3,22,0,22,NA
202503,5021000,CA,0,13,-13,0
202503,5030000,2,177,483,-306,0.37
202503,5030000,2S2,0,4,-4,0
202503,5030000,2S3,2,15,-13,0.13
202503,5030000,3,7,65,-58,0.11
202503,5030000,3S2,15,25,-10,0.6
202503,5030000,3S3,889,172,717,5.17
202503,5030000,3S4,0,2,-2,0
202503,5030000,CA,12,134,-122,0.09
202503,5030000,V2,0,1,-1,0
202503,5030000,V3,228,3,225,76
202503,5030011,3S3,40,0,40,NA
202503,5031000,2,9,74,-65,0.12
202503,5031000,2S2,0,12,-12,0
202503,5031000,3,49,16,33,3.06
202503,5031000,3S1,2,0,2,NA
202503,5031000,3S2,5,8,-3,0.62
202503,5031000,3S3,2,4,-2,0.5
202503,5031000,3S4,0,3,-3,0
202503,5031000,4,2,0,2,NA
202503,5031000,CA,1,40,-39,0.03
202503,5031000,V2,1,0,1,NA
202503,5031000,V3,268,2,266,134
202503,5031000,V4,31,0,31,NA
202503,5034000,2,23,167,-144,0.14
202503,5034000,3,0,17,-17,0
202503,5034000,3S3,29,39,-10,0.74
202503,5034000,4,0,2,-2,0
202503,5034000,CA,3,45,-42,0.07
202503,5034000,V2,0,4,-4,0
202503,5034006,2,4,0,4,NA
202503,5034007,3S3,0,1,-1,0
202503,5036000,2,12,16,-4,0.75
202503,5036000,3,0,2,-2,0
202503,5036000,CA,0,8,-8,0
202503,5036000,V2,1,4,-3,0.25
202503,5036000,V3,128,0,128,NA
202503,5038000,2,12,37,-25,0.32
202503,5038000,3,3,22,-19,0.14
202503,5038000,3S2,1,0,1,NA
202503,5038000,3S3,0,4,-4,0
202503,5038000,4,3,1,2,3
202503,5038000,CA,2,21,-19,0.1
202503,5038000,V2,0,1,-1,0
202503,5038001,2,0,1,-1,0
202503,5038008,2,5,8,-3,0.62
202503,5038008,3,0,2,-2,0
202503,5038008,3S3,1,5,-4,0.2
202503,5038008,V2,0,3,-3,0
202503,5040000,2,2,68,-66,0.03
202503,5040000,3,0,3,-3,0
202503,5040000,3S2,0,5,-5,0
202503,5040000,3S3,0,1,-1,0
202503,5040000,CA,0,50,-50,0
202503,5040002,2,0,1,-1,0
202503,5040004,2,0,18,-18,0
202503,5040004,3S3,0,3,-3,0
202503,5042000,2,30,289,-259,0.1
202503,5042000,2S2,0,1,-1,0
202503,5042000,3,2,61,-59,0.03
202503,5042000,3S2,1,10,-9,0.1
202503,5042000,3S3,18,69,-51,0.26
202503,5042000,CA,8,109,-101,0.07
202503,5042000,V3,0,7,-7,0
202503,5042001,2,0,3,-3,0
202503,5042001,CA,0,3,-3,0
202503,5044000,2,6,18,-12,0.33
202503,5044000,CA,0,5,-5,0
202503,5044001,2,5,3,2,1.67
202503,5045000,2,398,1714,-1316,0.23
202503,5045000,2R2,0,17,-17,0
202503,5045000,2S1,0,1,-1,0
202503,5045000,2S2,7,45,-38,0.16
202503,5045000,2S3,10,32,-22,0.31
202503,5045000,3,30,126,-96,0.24
202503,5045000,3S2,124,88,36,1.41
202503,5045000,3S3,811,793,18,1.02
202503,5045000,3S4,7,3,4,2.33
202503,5045000,4,1,5,-4,0.2
202503,5045000,CA,185,304,-119,0.61
202503,5045003,3S2,0,1,-1,0
202503,5045003,3S3,13,0,13,NA
202503,5051000,2,44,119,-75,0.37
202503,5051000,2R2,0,1,-1,0
202503,5051000,2S3,0,1,-1,0
202503,5051000,3,1,3,-2,0.33
202503,5051000,3S2,2,1,1,2
202503,5051000,3S3,8,29,-21,0.28
202503,5051000,4,0,1,-1,0
202503,5051000,CA,0,45,-45,0
202503,5055000,2,1,27,-26,0.04
202503,5055000,3,0,1,-1,0
202503,5055000,CA,0,3,-3,0
202503,5055000,V2,0,3,-3,0
202503,5059000,2,9,134,-125,0.07
202503,5059000,3,1,3,-2,0.33
202503,5059000,3S2,0,1,-1,0
202503,5059000,3S3,2,12,-10,0.17
202503,5059000,CA,1,22,-21,0.05
202503,5059000,V2,0,1,-1,0
202503,5059002,2,0,1,-1,0
202503,5079000,2,1721,1029,692,1.67
202503,5079000,2B1,5,0,5,NA
202503,5079000,2R2,5,0,5,NA
202503,5079000,2S2,446,106,340,4.21
202503,5079000,2S3,36,28,8,1.29
202503,5079000,3,223,96,127,2.32
202503,5079000,3S1,6,0,6,NA
202503,5079000,3S2,138,143,-5,0.97
202503,5079000,3S3,1202,796,406,1.51
202503,5079000,3S4,1,0,1,NA
202503,5079000,4,4,3,1,1.33
202503,5079000,CA,134,516,-382,0.26
202503,5079001,2,13,2,11,6.5
202503,5079001,2S2,2,0,2,NA
202503,5079001,2S3,4,0,4,NA
202503,5079001,3,1,0,1,NA
202503,5079001,3S3,14,2,12,7
202503,5079001,CA,10,8,2,1.25
202503,5079013,2,1,0,1,NA
202503,5086000,2,11,32,-21,0.34
202503,5086000,2S2,0,4,-4,0
202503,5086000,3,0,18,-18,0
202503,5086000,CA,0,18,-18,0
202503,5086000,V3,0,7,-7,0
202503,5088000,2,2498,3770,-1272,0.66
202503,5088000,2R3,0,1,-1,0
202503,5088000,2S2,88,194,-106,0.45
202503,5088000,2S3,20,122,-102,0.16
202503,5088000,3,226,230,-4,0.98
202503,5088000,3S1,1,0,1,NA
202503,5088000,3S2,83,200,-117,0.42
202503,5088000,3S3,1936,2572,-636,0.75
202503,5088000,4,58,30,28,1.93
202503,5088000,CA,2413,1491,922,1.62
202503,5088000,V2,1,1,0,1
202503,5088000,V3,569,109,460,5.22
202503,5088004,3S3,0,2,-2,0
202503,5088010,2,0,1,-1,0
202503,5088011,3,0,2,-2,0
202503,5088012,2,0,2,-2,0
202503,5088012,2S2,0,3,-3,0
202503,5088012,CA,0,1,-1,0
202503,5088013,2,46,9,37,5.11
202503,5088013,3,11,1,10,11
202503,5088013,3S3,1,11,-10,0.09
202503,5088013,4,35,0,35,NA
202503,5088017,2,0,1,-1,0
202503,5088017,3S3,0,1,-1,0
202503,5088018,V3,0,191,-191,0
202503,5091000,2,12,12,0,1
202503,5091000,3,0,13,-13,0
202503,5091000,3S3,0,6,-6,0
202503,5091000,4,0,1,-1,0
202503,5091000,CA,0,5,-5,0
202503,5093000,2,1,18,-17,0.06
202503,5093000,3S3,0,9,-9,0
202503,5093000,CA,0,6,-6,0
202503,5093000,V3,0,2,-2,0
202503,5093001,2,0,5,-5,0
202503,5093001,3,3,5,-2,0.6
202503,5093001,3S3,0,1,-1,0
202503,5101000,2,119,180,-61,0.66
202503,5101000,2S2,0,1,-1,0
202503,5101000,3,0,2,-2,0
202503,5101000,3S3,3,73,-70,0.04
202503,5101000,CA,101,48,53,2.1
202503,5107000,2,2,27,-25,0.07
202503,5107000,3,0,2,-2,0
202503,5107000,3S2,2,4,-2,0.5
202503,5107000,CA,0,5,-5,0
202503,5113000,2,51,86,-35,0.59
202503,5113000,2S2,0,1,-1,0
202503,5113000,2S3,9,0,9,NA
202503,5113000,3,13,37,-24,0.35
202503,5113000,3S2,0,102,-102,0
202503,5113000,3S3,71,26,45,2.73
202503,5113000,CA,1,13,-12,0.08
202503,5113000,V3,0,1,-1,0
202503,5120000,2,13,4,9,3.25
202503,5120000,2S2,1,2,-1,0.5
202503,5120000,3,0,2,-2,0
202503,5120000,3S2,3,9,-6,0.33
202503,5120000,3S3,1,6,-5,0.17
202503,5120000,CA,0,7,-7,0
202503,5120000,V3,0,1,-1,0
202503,5120002,3S2,6,3,3,2
202503,5120004,2,0,65,-65,0
202503,5120004,2S2,0,2,-2,0
202503,5120004,3,0,1,-1,0
202503,5120004,3S3,1,2,-1,0.5
202503,5120004,CA,0,74,-74,0
202503,5125000,2,4,17,-13,0.24
202503,5125000,3,5,5,0,1
202503,5125000,CA,1,21,-20,0.05
202503,5129000,2,2485,2046,439,1.21
202503,5129000,2S1,0,1,-1,0
202503,5129000,2S2,282,351,-69,0.8
202503,5129000,2S3,119,133,-14,0.89
202503,5129000,3,86,125,-39,0.69
202503,5129000,3S1,1,1,0,1
202503,5129000,3S2,128,102,26,1.25
202503,5129000,3S3,658,332,326,1.98
202503,5129000,3S4,1,3,-2,0.33
202503,5129000,4,4,2,2,2
202503,5129000,CA,1568,461,1107,3.4
202503,5129000,V2,50,0,50,NA
202503,5129000,V3,47,25,22,1.88
202503,5129005,2,1,4,-3,0.25
202503,5129005,2S2,0,1,-1,0
202503,5129005,3S2,4,12,-8,0.33
202503,5129005,4,1,0,1,NA
202503,5134000,2,1,43,-42,0.02
202503,5134000,3S4,0,1,-1,0
202503,5134000,CA,0,17,-17,0
202503,5138000,2,7,69,-62,0.1
202503,5138000,2S2,0,1,-1,0
202503,5138000,3,2,17,-15,0.12
202503,5138000,3S2,5,25,-20,0.2
202503,5138000,3S3,2,69,-67,0.03
202503,5138000,3S4,2,2,0,1
202503,5138000,4,0,2,-2,0
202503,5138000,CA,0,5,-5,0
202503,5138003,2,0,1,-1,0
202503,5142000,2,0,16,-16,0
202503,5142000,3,1,5,-4,0.2
202503,5142000,CA,0,14,-14,0
202503,5142003,2,0,7,-7,0
202503,5142003,3,0,5,-5,0
202503,5142003,3S3,0,1,-1,0
202503,5142003,CA,0,2,-2,0
202503,5142006,2,6,58,-52,0.1
202503,5142006,3S3,0,7,-7,0
202503,5145000,2,7,19,-12,0.37
202503,5145000,3,2,4,-2,0.5
202503,5145000,CA,0,25,-25,0
202503,5145000,V3,0,1,-1,0
202503,5147000,2,51,245,-194,0.21
202503,5147000,2R2,2,3,-1,0.67
202503,5147000,2S2,4,2,2,2
202503,5147000,2S3,8,56,-48,0.14
202503,5147000,3,4,29,-25,0.14
202503,5147000,3S2,26,14,12,1.86
202503,5147000,3S3,58,431,-373,0.13
202503,5147000,3S4,0,1,-1,0
202503,5147000,CA,61,79,-18,0.77
202503,5147004,2,2,0,2,NA
202503,5147004,2S2,4,0,4,NA
202503,5147004,2S3,6,0,6,NA
202503,5147004,3,2,0,2,NA
202503,5147004,3S2,1,0,1,NA
202503,5147004,3S3,29,0,29,NA
202503,5148000,2,1120,897,223,1.25
202503,5148000,2R2,0,4,-4,0
202503,5148000,2S2,92,47,45,1.96
202503,5148000,2S3,9,19,-10,0.47
202503,5148000,3,8,31,-23,0.26
202503,5148000,3S2,53,21,32,2.52
202503,5148000,3S3,46,116,-70,0.4
202503,5148000,CA,10,379,-369,0.03
202503,5148005,2S3,0,2,-2,0
202503,5148009,2,0,1,-1,0
202503,5150000,2,64,27,37,2.37
202503,5150000,2S3,0,1,-1,0
202503,5150000,3,0,10,-10,0
202503,5150000,3S2,0,1,-1,0
202503,5150000,3S3,0,1,-1,0
202503,5150000,CA,0,7,-7,0
202503,5150000,V3,0,6,-6,0
202503,5154000,2,193,1093,-900,0.18
202503,5154000,2R2,0,15,-15,0
202503,5154000,2S2,3,19,-16,0.16
202503,5154000,2S3,1,20,-19,0.05
202503,5154000,3,6,125,-119,0.05
202503,5154000,3S2,40,45,-5,0.89
202503,5154000,3S2S3,0,1,-1,0
202503,5154000,3S3,102,672,-570,0.15
202503,5154000,3S4,0,6,-6,0
202503,5154000,4,0,1,-1,0
202503,5154000,CA,62,225,-163,0.28
202503,5154003,3S2,0,1,-1,0
202503,5154006,2,0,1,-1,0
202503,5154006,3S2,1,1,0,1
202503,5154007,2,0,8,-8,0
202503,5154015,3S3,5,13,-8,0.38
202503,5154023,2,1,0,1,NA
202503,5154023,3S2,5,13,-8,0.38
202503,5154023,3S3,0,1,-1,0
202503,5154023,V3,1,0,1,NA
202503,5172000,2,260,334,-74,0.78
202503,5172000,2R2,0,13,-13,0
202503,5172000,2S2,2,6,-4,0.33
202503,5172000,2S3,56,1,55,56
202503,5172000,3,4,51,-47,0.08
202503,5172000,3S2,5,6,-1,0.83
202503,5172000,3S3,139,186,-47,0.75
202503,5172000,4,0,1,-1,0
202503,5172000,CA,6,94,-88,0.06
202503,5172003,3S3,0,1,-1,0
202503,5190000,2,11,44,-33,0.25
202503,5190000,2S3,0,1,-1,0
202503,5190000,3,1,1,0,1
202503,5190000,3S2,0,2,-2,0
202503,5190000,3S3,4,19,-15,0.21
202503,5190000,3S4,1,0,1,NA
202503,5190000,CA,2,46,-44,0.04
202503,5197000,2,8,44,-36,0.18
202503,5197000,2S2,0,5,-5,0
202503,5197000,3,1,3,-2,0.33
202503,5197000,3S3,0,5,-5,0
202503,5197000,3S4,1,0,1,NA
202503,5197000,CA,0,33,-33,0
202503,5197000,V3,0,1,-1,0
202503,5197009,V3R2,0,1,-1,0
202503,5206000,2,57,64,-7,0.89
202503,5206000,3,1,3,-2,0.33
202503,5206000,CA,0,2,-2,0
202503,5206000,V2,0,2,-2,0
202503,5209000,2,34,17,17,2
202503,5209000,2S2,0,1,-1,0
202503,5209000,3,3,8,-5,0.38
202503,5209000,3S3,9,17,-8,0.53
202503,5209000,CA,0,14,-14,0
202503,5209004,CA,0,1,-1,0
202503,5209004,V3,0,2,-2,0
202503,5212000,2,1507,1384,123,1.09
202503,5212000,2S2,706,282,424,2.5
202503,5212000,2S3,107,44,63,2.43
202503,5212000,3,38,78,-40,0.49
202503,5212000,3S1,1,1,0,1
202503,5212000,3S2,203,152,51,1.34
202503,5212000,3S3,462,320,142,1.44
202503,5212000,4,1,22,-21,0.05
202503,5212000,CA,701,742,-41,0.94
202503,5212000,V2,3,0,3,NA
202503,5234000,2,2,46,-44,0.04
202503,5234000,2S2,1,0,1,NA
202503,5234000,2S3,0,1,-1,0
202503,5234000,3,0,14,-14,0
202503,5234000,3S3,1,63,-62,0.02
202503,5234000,4,0,1,-1,0
202503,5234000,CA,2,23,-21,0.09
202503,5234000,V3,0,5,-5,0
202503,5234009,2,0,5,-5,0
202503,5234009,3,0,1,-1,0
202503,5234009,3S2,0,1,-1,0
202503,5234009,CA,0,1,-1,0
202503,5234010,3,0,13,-13,0
202503,5234010,V3,0,3,-3,0
202503,5237000,2,131,301,-170,0.44
202503,5237000,2S2,0,3,-3,0
202503,5237000,2S3,1,5,-4,0.2
202503,5237000,3,1,221,-220,0
202503,5237000,3S2,4,10,-6,0.4
202503,5237000,3S3,4,158,-154,0.03
202503,5237000,4,0,1,-1,0
202503,5237000,CA,4,51,-47,0.08
202503,5237000,V3,0,79,-79,0
202503,5237001,2,1,0,1,NA
202503,5240000,2,1,9,-8,0.11
202503,5240000,3S3,0,1,-1,0
202503,5240000,CA,1,5,-4,0.2
202503,5240001,2,1,1,0,1
202503,5240003,2,1,9,-8,0.11
202503,5240003,3,0,3,-3,0
202503,5240007,2,0,4,-4,0
202503,5240007,CA,0,2,-2,0
202503,5250000,2,26,224,-198,0.12
202503,5250000,2S2,0,5,-5,0
202503,5250000,2S3,0,1,-1,0
202503,5250000,3,0,32,-32,0
202503,5250000,3S1,0,1,-1,0
202503,5250000,3S2,10,13,-3,0.77
202503,5250000,3S3,4,99,-95,0.04
202503,5250000,4,0,2,-2,0
202503,5250000,CA,2,46,-44,0.04
202503,5250002,3,0,2,-2,0
202503,5250002,3S2,1,0,1,NA
202503,5250004,2,7,0,7,NA
202503,5250004,3S3,2,0,2,NA
202503,5264000,2,148,340,-192,0.44
202503,5264000,2S2,3,19,-16,0.16
202503,5264000,2S3,2,6,-4,0.33
202503,5264000,3,8,30,-22,0.27
202503,5264000,3S2,20,16,4,1.25
202503,5264000,3S3,25,155,-130,0.16
202503,5264000,CA,1,73,-72,0.01
202503,5264000,V2,0,3,-3,0
202503,5264000,V3,0,5,-5,0
202503,5266000,2,7646,3523,4123,2.17
202503,5266000,2R2,1,0,1,NA
202503,5266000,2S2,1600,343,1257,4.66
202503,5266000,2S3,438,158,280,2.77
202503,5266000,3,91,144,-53,0.63
202503,5266000,3S2,226,318,-92,0.71
202503,5266000,3S3,469,1339,-870,0.35
202503,5266000,4,0,1,-1,0
202503,5266000,CA,1435,1790,-355,0.8
202503,5266001,2,9,153,-144,0.06
202503,5266001,3,0,1,-1,0
202503,5266001,3S2,3,0,3,NA
202503,5266001,CA,1,13,-12,0.08
202503,5282000,2,45,118,-73,0.38
202503,5282000,2S2,0,14,-14,0
202503,5282000,3,1,10,-9,0.1
202503,5282000,3S3,0,1,-1,0
202503,5282000,4,3,0,3,NA
202503,5282000,CA,1,33,-32,0.03
202503,5282000,V2,0,1,-1,0
202503,5282000,V3,0,1,-1,0
202503,5282004,2,0,1,-1,0
202503,5282004,3S2,6,0,6,NA
202503,5282004,3S3,2,0,2,NA
202503,5282005,2,0,1,-1,0
202503,5282005,CA,0,2,-2,0
202503,5284000,2,9,108,-99,0.08
202503,5284000,3,0,14,-14,0
202503,5284000,3S2,2,3,-1,0.67
202503,5284000,3S3,11,33,-22,0.33
202503,5284000,4,0,1,-1,0
202503,5284000,CA,2,39,-37,0.05
202503,5284006,2,0,2,-2,0
202503,5306000,2,3,22,-19,0.14
202503,5306000,3,0,1,-1,0
202503,5306000,3S3,0,7,-7,0
202503,5306000,CA,0,11,-11,0
202503,5308000,2,8033,2922,5111,2.75
202503,5308000,2R2,9,1,8,9
202503,5308000,2S2,195,665,-470,0.29
202503,5308000,2S3,92,159,-67,0.58
202503,5308000,3,569,169,400,3.37
202503,5308000,3S2,273,544,-271,0.5
202503,5308000,3S3,2226,3093,-867,0.72
202503,5308000,3S4,2,2,0,1
202503,5308000,4,34,5,29,6.8
202503,5308000,CA,3090,712,2378,4.34
202503,5308000,V2,1,5,-4,0.2
202503,5308000,V3,287,341,-54,0.84
202503,5308000,V4,3,66,-63,0.05
202503,5308012,2,0,2,-2,0
202503,5310000,2,46,25,21,1.84
202503,5310000,2S2,0,1,-1,0
202503,5310000,3,1,5,-4,0.2
202503,5310000,3S2,0,1,-1,0
202503,5310000,3S3,0,8,-8,0
202503,5310000,CA,46,28,18,1.64
202503,5310000,V3,0,1,-1,0
202503,5310003,2,1304,357,947,3.65
202503,5310003,2S2,8,56,-48,0.14
202503,5310003,2S3,40,123,-83,0.33
202503,5310003,3,9,4,5,2.25
202503,5310003,3S2,0,6,-6,0
202503,5310003,3S3,21,70,-49,0.3
202503,5310003,4,0,1,-1,0
202503,5310003,CA,441,37,404,11.92
202503,5313000,2,2,41,-39,0.05
202503,5313000,2S2,0,18,-18,0
202503,5313000,3S2,0,1,-1,0
202503,5313000,CA,0,61,-61,0
202503,5315000,2,3,21,-18,0.14
202503,5315000,2S2,0,2,-2,0
202503,5315000,3,0,4,-4,0
202503,5315000,3S4,0,2,-2,0
202503,5315000,CA,0,8,-8,0
202503,5315000,V3,0,2,-2,0
202503,5318000,2,6439,2512,3927,2.56
202503,5318000,2R2,0,10,-10,0
202503,5318000,2S2,193,363,-170,0.53
202503,5318000,2S3,38,104,-66,0.37
202503,5318000,3,276,152,124,1.82
202503,5318000,3S2,142,197,-55,0.72
202503,5318000,3S3,1192,799,393,1.49
202503,5318000,4,0,1,-1,0
202503,5318000,CA,958,637,321,1.5
202503,5318000,V2,0,192,-192,0
202503,5318000,V3,0,240,-240,0
202503,5318000,V4,1,17,-16,0.06
202503,5318003,2,356,0,356,NA
202503,5318003,2S2,63,0,63,NA
202503,5318003,2S3,18,0,18,NA
202503,5318003,3S2,5,0,5,NA
202503,5318003,3S3,257,0,257,NA
202503,5321000,2,4,119,-115,0.03
202503,5321000,2S2,1,24,-23,0.04
202503,5321000,3,2,4,-2,0.5
202503,5321000,3S2,0,1,-1,0
202503,5321000,3S3,0,1,-1,0
202503,5321000,CA,3,52,-49,0.06
202503,5321000,V2,0,3,-3,0
202503,5321000,V3,0,2,-2,0
202503,5347000,2,2,13,-11,0.15
202503,5347000,3,0,9,-9,0
202503,5347000,CA,0,5,-5,0
202503,5347003,2,0,3,-3,0
202503,5347003,V2,0,1,-1,0
202503,5347007,2S2,1,0,1,NA
202503,5347007,3S3,2,0,2,NA
202503,5353000,2,12,63,-51,0.19
202503,5353000,2S2,2,2,0,1
202503,5353000,3S2,0,3,-3,0
202503,5353000,3S3,0,21,-21,0
202503,5353000,CA,0,10,-10,0
202503,5360000,2,14014,7484,6530,1.87
202503,5360000,2B1,0,2,-2,0
202503,5360000,2R2,2,5,-3,0.4
202503,5360000,2R3,0,1,-1,0
202503,5360000,2S1,23,8,15,2.88
202503,5360000,2S2,268,467,-199,0.57
202503,5360000,2S3,175,361,-186,0.48
202503,5360000,3,424,416,8,1.02
202503,5360000,3S1,1,6,-5,0.17
202503,5360000,3S2,163,718,-555,0.23
202503,5360000,3S3,1963,4334,-2371,0.45
202503,5360000,3S4,4,3,1,1.33
202503,5360000,4,20,29,-9,0.69
202503,5360000,CA,5393,2055,3338,2.62
202503,5360001,2,1,5,-4,0.2
202503,5360001,2S2,1,3,-2,0.33
202503,5360001,2S3,1,3,-2,0.33
202503,5360003,2,0,7,-7,0
202503,5360006,2,0,40,-40,0
202503,5360006,CA,0,35,-35,0
202503,5360007,3S3,0,1,-1,0
202503,5361000,2,32,84,-52,0.38
202503,5361000,2S2,1,19,-18,0.05
202503,5361000,2S3,0,1,-1,0
202503,5361000,3,10,13,-3,0.77
202503,5361000,3S2,0,3,-3,0
202503,5361000,3S3,2,34,-32,0.06
202503,5361000,3S4,0,4,-4,0
202503,5361000,CA,0,48,-48,0
202503,5361000,V3,0,2,-2,0
202503,5364000,2,21,193,-172,0.11
202503,5364000,2S3,1,0,1,NA
202503,5364000,3,1,27,-26,0.04
202503,5364000,3S2,1,2,-1,0.5
202503,5364000,3S3,55,33,22,1.67
202503,5364000,CA,1,86,-85,0.01
202503,5368000,2,35,48,-13,0.73
202503,5368000,2S2,0,27,-27,0
202503,5368000,3,0,9,-9,0
202503,5368000,3S2,1,0,1,NA
202503,5368000,3S3,22,3,19,7.33
202503,5368000,CA,1,41,-40,0.02
202503,5368007,3S3,0,1,-1,0
202503,5376000,2,1445,1582,-137,0.91
202503,5376000,2S2,35,52,-17,0.67
202503,5376000,2S3,8,11,-3,0.73
202503,5376000,3,27,44,-17,0.61
202503,5376000,3S2,0,22,-22,0
202503,5376000,3S3,44,371,-327,0.12
202503,5376000,CA,69,452,-383,0.15
202503,5376003,2,0,4,-4,0
202503,5376004,3,1,0,1,NA
202503,5380000,2,10648,2850,7798,3.74
202503,5380000,2R2,44,0,44,NA
202503,5380000,2S2,444,433,11,1.03
202503,5380000,2S3,84,149,-65,0.56
202503,5380000,3,41,123,-82,0.33
202503,5380000,3S2,276,389,-113,0.71
202503,5380000,3S3,364,1054,-690,0.35
202503,5380000,4,1,1,0,1
202503,5380000,CA,5441,1099,4342,4.95
202503,5380000,V3,16,51,-35,0.31
202503,5380001,2,21,85,-64,0.25
202503,5380001,2S2,0,17,-17,0
202503,5380001,3,0,5,-5,0
202503,5380001,3S2,1,1,0,1
202503,5380001,3S3,0,1,-1,0
202503,5380001,CA,5,2,3,2.5
202503,5380002,3S3,0,1,-1,0
202503,5380005,2,130,53,77,2.45
202503,5380005,2S2,2,6,-4,0.33
202503,5380005,2S3,5,14,-9,0.36
202503,5380005,3,8,1,7,8
202503,5380005,3S2,1,2,-1,0.5
202503,5380005,3S3,34,13,21,2.62
202503,5380005,CA,0,3,-3,0
202503,5380010,2,0,1,-1,0
202503,5380010,3S3,0,3,-3,0
202503,5390000,2,70,60,10,1.17
202503,5390000,3,0,9,-9,0
202503,5390000,3S2,7,8,-1,0.88
202503,5390000,3S3,4,19,-15,0.21
202503,5390000,CA,5,23,-18,0.22
202503,5390000,V3,0,1,-1,0
202503,5400000,2,162,320,-158,0.51
202503,5400000,2R2,0,1,-1,0
202503,5400000,2S2,1,2,-1,0.5
202503,5400000,2S3,0,3,-3,0
202503,5400000,3,24,17,7,1.41
202503,5400000,3S2,13,3,10,4.33
202503,5400000,3S3,146,98,48,1.49
202503,5400000,4,4,0,4,NA
202503,5400000,CA,5,219,-214,0.02
202503,5400000,V2,0,5,-5,0
202503,5400000,V3,268,19,249,14.11
202503,5400000,V4,26,0,26,NA
202503,5400001,2,0,3,-3,0
202503,5400001,3S3,0,1,-1,0
202503,5400002,2,0,26,-26,0
202503,5400002,V2,0,4,-4,0
202503,5411000,2,4,24,-20,0.17
202503,5411000,CA,0,13,-13,0
202503,5411001,2,0,10,-10,0
202503,5411007,2,0,1,-1,0
202503,5411007,CA,0,1,-1,0
202503,5411008,2,0,4,-4,0
202503,5411008,2S2,0,1,-1,0
202503,5411008,3,1,0,1,NA
202503,5411008,3S3,0,6,-6,0
202503,5425000,2,33,65,-32,0.51
202503,5425000,2S3,1,0,1,NA
202503,5425000,3,3,46,-43,0.07
202503,5425000,3S2,0,7,-7,0
202503,5425000,3S3,5,7,-2,0.71
202503,5425000,4,1,26,-25,0.04
202503,5425000,CA,2,9,-7,0.22
202503,5425000,V3,0,14,-14,0
202503,5425001,2,0,1,-1,0
202503,5425001,3S2,0,1,-1,0
202503,5425005,2,5,7,-2,0.71
202503,5425005,3,2,3,-1,0.67
202503,5425005,3S3,56,0,56,NA
202503,5425005,CA,0,2,-2,0
202503,5440000,2,1994,1040,954,1.92
202503,5440000,2R2,0,15,-15,0
202503,5440000,2S2,2,12,-10,0.17
202503,5440000,2S3,7,9,-2,0.78
202503,5440000,3,59,54,5,1.09
202503,5440000,3S2,34,23,11,1.48
202503,5440000,3S3,65,708,-643,0.09
202503,5440000,4,0,12,-12,0
202503,5440000,CA,96,458,-362,0.21
202503,5440000,V2,47,0,47,NA
202503,5440000,V3,4,56,-52,0.07
202503,5467000,2,2,7,-5,0.29
202503,5467000,2S2,0,6,-6,0
202503,5467000,CA,0,14,-14,0
202503,5475000,2,0,2,-2,0
202503,5480000,2,2,69,-67,0.03
202503,5480000,2S3,1,0,1,NA
202503,5480000,3,1,11,-10,0.09
202503,5480000,3S2,2,4,-2,0.5
202503,5480000,3S3,2,46,-44,0.04
202503,5480000,CA,0,19,-19,0
202503,5480004,2,0,6,-6,0
202503,5480004,3,0,3,-3,0
202503,5480004,3S2,0,1,-1,0
202503,5480006,2,0,1,-1,0
202503,5480006,3,0,16,-16,0
202503,5483000,2,1,32,-31,0.03
202503,5483000,3S2,1,1,0,1
202503,5483000,CA,0,7,-7,0
202503,5483000,V2,0,5,-5,0
202503,5483001,2,0,4,-4,0
202503,5483001,V2,0,3,-3,0
202503,5483012,2,0,4,-4,0
202503,5483012,3,0,7,-7,0
202503,5490000,2,96,230,-134,0.42
202503,5490000,2R2,0,3,-3,0
202503,5490000,2S2,1,1,0,1
202503,5490000,3,6,17,-11,0.35
202503,5490000,3S2,6,1,5,6
202503,5490000,3S3,4,12,-8,0.33
202503,5490000,CA,1,63,-62,0.02
202503,5490001,2,0,2,-2,0
202503,5490002,3,1,0,1,NA
202503,5490005,2,0,2,-2,0
202503,5490006,CA,0,1,-1,0
202503,5490008,CA,0,1,-1,0
202503,5495000,2,15,82,-67,0.18
202503,5495000,2R2,0,1,-1,0
202503,5495000,2S2,0,2,-2,0
202503,5495000,3,0,12,-12,0
202503,5495000,3S2,5,9,-4,0.56
202503,5495000,3S3,2,18,-16,0.11
202503,5495000,CA,1,15,-14,0.07
202503,5501000,2,0,3,-3,0
202503,5501000,3S3,0,2,-2,0
202503,5501000,CA,0,1,-1,0
202503,5501002,V2,0,1,-1,0
202503,5541000,2,9,47,-38,0.19
202503,5541000,2S2,0,29,-29,0
202503,5541000,3,0,7,-7,0
202503,5541000,3S3,0,3,-3,0
202503,5541000,CA,1,41,-40,0.02
202503,5541000,V3,0,1,-1,0
202503,5541001,2,12,25,-13,0.48
202503,5541001,3,2,5,-3,0.4
202503,5541001,3S2,0,1,-1,0
202503,5541001,3S3,0,5,-5,0
202503,5541001,CA,0,10,-10,0
202503,5543000,2,2,10,-8,0.2
202503,5543000,3,0,1,-1,0
202503,5576000,2,3,7,-4,0.43
202503,5576000,CA,0,9,-9,0
202503,5579000,2,79,339,-260,0.23
202503,5579000,3,15,128,-113,0.12
202503,5579000,3S2,7,12,-5,0.58
202503,5579000,3S2S3,1,0,1,NA
202503,5579000,3S3,146,109,37,1.34
202503,5579000,3S4,1,0,1,NA
202503,5579000,CA,115,106,9,1.08
202503,5579000,V3,0,1,-1,0
202503,5579002,3S2,1,0,1,NA
202503,5579005,2,0,4,-4,0
202503,5585000,2,10,91,-81,0.11
202503,5585000,3,6,5,1,1.2
202503,5585000,3S2,5,2,3,2.5
202503,5585000,3S3,116,9,107,12.89
202503,5585000,CA,3,26,-23,0.12
202503,5585003,2,0,16,-16,0
202503,5585003,2S2,0,1,-1,0
202503,5585003,3S2,5,1,4,5
202503,5585003,3S3,163,61,102,2.67
202503,5585003,CA,0,20,-20,0
202503,5585003,V3,0,1,-1,0
202503,5585004,2,104,32,72,3.25
202503,5585004,3,0,1,-1,0
202503,5585004,CA,3,18,-15,0.17
202503,5591000,2,21,148,-127,0.14
202503,5591000,2S2,2,3,-1,0.67
202503,5591000,2S3,4,0,4,NA
202503,5591000,3,18,24,-6,0.75
202503,5591000,3S2,14,12,2,1.17
202503,5591000,3S3,460,120,340,3.83
202503,5591000,CA,2,59,-57,0.03
202503,5591000,V3,0,3,-3,0
202503,5591000,V4,0,1,-1,0
202503,5591002,2,0,12,-12,0
202503,5591002,3,0,3,-3,0
202503,5591002,3S3,3,0,3,NA
202503,5591002,CA,1,3,-2,0.33
202503,5591002,V3,0,2,-2,0
202503,5591004,2,48,66,-18,0.73
202503,5591004,2S2,1,0,1,NA
202503,5591004,2S3,1,2,-1,0.5
202503,5591004,3,25,30,-5,0.83
202503,5591004,3S3,217,54,163,4.02
202503,5591004,3S4,0,1,-1,0
202503,5591004,4,12,0,12,NA
202503,5591004,CA,10,52,-42,0.19
202503,5591004,V3,0,17,-17,0
202503,5604000,2,10,92,-82,0.11
202503,5604000,2S2,0,6,-6,0
202503,5604000,3,2,81,-79,0.02
202503,5604000,3S1,0,1,-1,0
202503,5604000,3S2,3,12,-9,0.25
202503,5604000,3S3,1,16,-15,0.06
202503,5604000,CA,1,22,-21,0.05
202503,5604000,V3,0,9,-9,0
202503,5604001,3S2,0,1,-1,0
202503,5604001,V3,0,2,-2,0
202503,5604003,3S1,1,0,1,NA
202503,5604003,3S2,2,1,1,2
202503,5604005,3,0,15,-15,0
202503,5604005,3S2,0,27,-27,0
202503,5604005,V3,0,5,-5,0
202503,5607000,2,206,559,-353,0.37
202503,5607000,2R2,0,13,-13,0
202503,5607000,2S2,3,0,3,NA
202503,5607000,2S3,0,9,-9,0
202503,5607000,3,3,24,-21,0.12
202503,5607000,3S2,4,5,-1,0.8
202503,5607000,3S3,9,62,-53,0.15
202503,5607000,CA,5,260,-255,0.02
202503,5607000,V2,0,1,-1,0
202503,5607003,2,1,1,0,1
202503,5607004,2,2,0,2,NA
202503,5607007,2,0,4,-4,0
202503,5607007,3,1,0,1,NA
202503,5607008,2,1,2,-1,0.5
202503,5607008,CA,0,4,-4,0
202503,5615000,2,6954,7035,-81,0.99
202503,5615000,2R2,2,1,1,2
202503,5615000,2S2,654,507,147,1.29
202503,5615000,2S3,166,333,-167,0.5
202503,5615000,3,209,220,-11,0.95
202503,5615000,3S1,1,8,-7,0.12
202503,5615000,3S2,516,679,-163,0.76
202503,5615000,3S3,970,2646,-1676,0.37
202503,5615000,3S4,1,5,-4,0.2
202503,5615000,4,0,4,-4,0
202503,5615000,CA,2299,2792,-493,0.82
202503,5615000,V2,1,2,-1,0.5
202503,5615000,V3,0,6,-6,0
202503,5615001,2,1,0,1,NA
202503,5615010,2,9,46,-37,0.2
202503,5615010,3,1,4,-3,0.25
202503,5615010,3S3,0,1,-1,0
202503,5615010,CA,2,12,-10,0.17
202503,5615010,V2,0,2,-2,0
202503,5615011,2,0,1,-1,0
202503,5615012,2,0,2,-2,0
202503,5615013,2,0,1,-1,0
202503,5628000,2,3,23,-20,0.13
202503,5628000,3,0,3,-3,0
202503,5628000,3S3,0,1,-1,0
202503,5628000,CA,0,15,-15,0
202503,5628001,2,2,0,2,NA
202503,5628001,3,1,2,-1,0.5
202503,5631000,2,4849,2530,2319,1.92
202503,5631000,2R2,0,1,-1,0
202503,5631000,2S1,0,1,-1,0
202503,5631000,2S2,49,105,-56,0.47
202503,5631000,2S3,34,160,-126,0.21
202503,5631000,3,411,270,141,1.52
202503,5631000,3S2,195,383,-188,0.51
202503,5631000,3S3,503,748,-245,0.67
202503,5631000,4,2,16,-14,0.12
202503,5631000,CA,2469,1018,1451,2.43
202503,5631000,V2,0,40,-40,0
202503,5631000,V3,27,191,-164,0.14
202503,5631000,V4,0,12,-12,0
202503,5631002,2,0,2,-2,0
202503,5631002,3S2,0,1,-1,0
202503,5631008,3S3,1,16,-15,0.06
202503,5642000,2,20,44,-24,0.45
202503,5642000,3,0,8,-8,0
202503,5642000,3S2,3,0,3,NA
202503,5642000,3S3,36,14,22,2.57
202503,5642000,CA,1,30,-29,0.03
202503,5642010,2,0,1,-1,0
202503,5642010,3S3,0,1,-1,0
202503,5647000,2,2,15,-13,0.13
202503,5647000,2S2,0,7,-7,0
202503,5647000,3,1,8,-7,0.12
202503,5647000,3S3,0,5,-5,0
202503,5647000,CA,0,4,-4,0
202503,5647000,V3,0,1,-1,0
202503,5649000,2,5,82,-77,0.06
202503,5649000,2S2,0,14,-14,0
202503,5649000,2S3,2,0,2,NA
202503,5649000,3,0,16,-16,0
202503,5649000,3S2,1,1,0,1
202503,5649000,3S3,1,3,-2,0.33
202503,5649000,CA,0,104,-104,0
202503,5649000,V3,0,11,-11,0
202503,5649001,2,0,6,-6,0
202503,5649001,CA,0,14,-14,0
202503,5649012,2,0,4,-4,0
202503,5649012,CA,0,3,-3,0
202503,5652000,2,1,3,-2,0.33
202503,5652000,3,0,7,-7,0
202503,5652000,3S2,1,0,1,NA
202503,5652000,3S3,350,230,120,1.52
202503,5652000,CA,0,1,-1,0
202503,5652000,V3,0,4,-4,0
202503,5652010,2,6,4,2,1.5
202503,5652010,3,6,0,6,NA
202503,5652010,3S2,1,1,0,1
202503,5652010,3S3,259,5,254,51.8
202503,5652010,CA,0,2,-2,0
202503,5652010,V3,5,0,5,NA
202503,5656000,2,18,123,-105,0.15
202503,5656000,2S2,1,0,1,NA
202503,5656000,3,2,9,-7,0.22
202503,5656000,3S2,1,2,-1,0.5
202503,5656000,3S3,0,8,-8,0
202503,5656000,CA,1,46,-45,0.02
202503,5656000,V2,0,3,-3,0
202503,5658000,2,1,19,-18,0.05
202503,5658000,3,1,1,0,1
202503,5658000,3S3,0,20,-20,0
202503,5658000,CA,0,3,-3,0
202503,5659000,2,42,59,-17,0.71
202503,5659000,2S3,1,0,1,NA
202503,5659000,3,2,4,-2,0.5
202503,5659000,3S2,49,0,49,NA
202503,5659000,3S3,9,17,-8,0.53
202503,5659000,4,0,2,-2,0
202503,5659000,CA,1,7,-6,0.14
202503,5660000,2,4,27,-23,0.15
202503,5660000,2S2,0,12,-12,0
202503,5660000,3,0,4,-4,0
202503,5660000,3S2,1,2,-1,0.5
202503,5660000,3S3,9,0,9,NA
202503,5660000,CA,0,58,-58,0
202503,5660000,V3,0,6,-6,0
202503,5660012,2,0,16,-16,0
202503,5660012,2S2,3,5,-2,0.6
202503,5660012,3S3,3,0,3,NA
202503,5660013,2,0,5,-5,0
202503,5660013,CA,0,9,-9,0
202503,5664000,2,146,721,-575,0.2
202503,5664000,2S2,0,4,-4,0
202503,5664000,2S3,2,1,1,2
202503,5664000,3,50,44,6,1.14
202503,5664000,3S2,169,48,121,3.52
202503,5664000,3S3,466,507,-41,0.92
202503,5664000,CA,2,116,-114,0.02
202503,5664005,2,10,10,0,1
202503,5664005,3,0,1,-1,0
202503,5664005,3S2,0,1,-1,0
202503,5664005,3S3,0,9,-9,0
202503,5665000,2,66,155,-89,0.43
202503,5665000,2S2,2,0,2,NA
202503,5665000,3,1,21,-20,0.05
202503,5665000,3S3,0,1,-1,0
202503,5665000,CA,2,18,-16,0.11
202503,5667000,2,3,60,-57,0.05
202503,5667000,2S2,0,13,-13,0
202503,5667000,CA,0,27,-27,0
202503,5667000,V2,0,9,-9,0
202503,5670000,2,8,46,-38,0.17
202503,5670000,3,0,6,-6,0
202503,5670000,3S2,0,1,-1,0
202503,5670000,3S3,23,17,6,1.35
202503,5670000,CA,0,30,-30,0
202503,5670000,V3,0,2,-2,0
202503,5670003,2,58,2,56,29
202503,5670003,3,0,2,-2,0
202503,5670003,3S3,10,1,9,10
202503,5674000,2,12,142,-130,0.08
202503,5674000,2S3,0,1,-1,0
202503,5674000,3,4,14,-10,0.29
202503,5674000,3S2,0,1,-1,0
202503,5674000,3S3,0,2,-2,0
202503,5674000,CA,1,47,-46,0.02
202503,5674000,V2,0,1,-1,0
202503,5679000,2,3,35,-32,0.09
202503,5679000,2S2,1,0,1,NA
202503,5679000,3,0,3,-3,0
202503,5679000,3R2,0,1,-1,0
202503,5679000,3S2,8,0,8,NA
202503,5679000,3S3,1,1,0,1
202503,5679000,CA,1,33,-32,0.03
202503,5679000,V2,0,4,-4,0
202503,5679000,V3,0,1,-1,0
202503,5679004,2,1,0,1,NA
202503,5679004,3,1,0,1,NA
202503,5686000,2,584,762,-178,0.77
202503,5686000,2S2,0,1,-1,0
202503,5686000,2S3,0,2,-2,0
202503,5686000,3,24,110,-86,0.22
202503,5686000,3S2,48,20,28,2.4
202503,5686000,3S3,429,523,-94,0.82
202503,5686000,CA,2,116,-114,0.02
202503,5686000,V3,0,47,-47,0
202503,5686001,2,0,14,-14,0
202503,5686001,3,0,6,-6,0
202503,5686001,4,0,1,-1,0
202503,5686001,V3,0,1,-1,0
202503,5686004,2,1,0,1,NA
202503,5686004,3,0,3,-3,0
202503,5686011,2,0,5,-5,0
202503,5686011,2R2,0,11,-11,0
202503,5686011,3,0,2,-2,0
202503,5686011,3S3,17,6,11,2.83
202503,5690000,2,87,99,-12,0.88
202503,5690000,3,5,21,-16,0.24
202503,5690000,3S2,1,1,0,1
202503,5690000,3S3,30,6,24,5
202503,5690000,CA,6,13,-7,0.46
202503,5690001,2,143,11,132,13
202503,5690001,CA,0,1,-1,0
202503,5690004,2,1,23,-22,0.04
202503,5690004,CA,0,2,-2,0
202503,5690010,2,1,4,-3,0.25
202503,5690010,3,0,3,-3,0
202503,5690010,3S3,0,1,-1,0
202503,5697000,2,68,602,-534,0.11
202503,5697000,2S2,0,1,-1,0
202503,5697000,2S3,0,1,-1,0
202503,5697000,3,9,27,-18,0.33
202503,5697000,3S2,10,4,6,2.5
202503,5697000,3S3,52,119,-67,0.44
202503,5697000,CA,4,231,-227,0.02
202503,5697000,V3,0,3,-3,0
202503,5736000,2,10,372,-362,0.03
202503,5736000,2S3,0,2,-2,0
202503,5736000,3,1,77,-76,0.01
202503,5736000,3S2,3,3,0,1
202503,5736000,3S3,1,12,-11,0.08
202503,5736000,4,0,5,-5,0
202503,5736000,CA,0,125,-125,0
202503,5736000,V3,0,21,-21,0
202503,5736002,3S2,0,4,-4,0
202503,5756000,2,30,258,-228,0.12
202503,5756000,3,71,20,51,3.55
202503,5756000,3S2,37,2,35,18.5
202503,5756000,3S3,584,111,473,5.26
202503,5756000,3S4,1,1,0,1
202503,5756000,CA,2,124,-122,0.02
202503,5756000,V2,0,6,-6,0
202503,5756000,V3,40,6,34,6.67
202503,5756005,2,0,3,-3,0
202503,5756005,3S2,0,1,-1,0
202503,5756005,CA,0,5,-5,0
202503,5756030,2,3,15,-12,0.2
202503,5756030,3,2,2,0,1
202503,5756030,3S2,2,1,1,2
202503,5756030,3S3,5,0,5,NA
202503,5756033,2,105,8,97,13.12
202503,5756033,2S2,5,0,5,NA
202503,5756033,3,350,1,349,350
202503,5756033,3S2,858,12,846,71.5
202503,5756033,3S3,3987,1100,2887,3.62
202503,5756033,4,3,0,3,NA
202503,5756033,V3,140,4,136,35
202503,5761000,2,5,55,-50,0.09
202503,5761000,3,2,1,1,2
202503,5761000,3S2,1,0,1,NA
202503,5761000,3S3,3,9,-6,0.33
202503,5761000,CA,1,34,-33,0.03
202503,5761000,V2,0,2,-2,0
202503,5761002,2,4,0,4,NA
202503,5761002,2S2,4,0,4,NA
202503,5761002,2S3,6,1,5,6
202503,5789000,2,121,133,-12,0.91
202503,5789000,2S2,4,28,-24,0.14
202503,5789000,3,1,4,-3,0.25
202503,5789000,3S2,2,0,2,NA
202503,5789000,3S3,0,1,-1,0
202503,5789000,CA,0,39,-39,0
202503,5789000,V3,0,1,-1,0
202503,5789001,2,0,2,-2,0
202503,5789001,3S3,0,2,-2,0
202503,5789002,2,1,0,1,NA
202503,5789002,CA,0,1,-1,0
202503,5790000,2,23,81,-58,0.28
202503,5790000,2R2,0,12,-12,0
202503,5790000,2S2,1,0,1,NA
202503,5790000,2S3,4,1,3,4
202503,5790000,3,7,12,-5,0.58
202503,5790000,3S2,4,5,-1,0.8
202503,5790000,3S3,10,9,1,1.11
202503,5790000,3S4,6,0,6,NA
202503,5790000,CA,5,23,-18,0.22
202503,5790002,2,0,1,-1,0
202503,5790002,3,0,1,-1,0
202503,5790003,2,0,2,-2,0
202503,5790003,3S2,1,2,-1,0.5
202503,5790004,2,0,1,-1,0
202503,5792000,2,2,9,-7,0.22
202503,5792000,2S2,0,2,-2,0
202503,5792000,3,0,1,-1,0
202503,5792000,3S2,0,7,-7,0
202503,5792000,3S3,0,6,-6,0
202503,5792000,CA,0,12,-12,0
202503,5792000,V3,0,1,-1,0
202503,5809000,2,29,44,-15,0.66
202503,5809000,2S2,0,9,-9,0
202503,5809000,3,0,43,-43,0
202503,5809000,3S3,189,0,189,NA
202503,5809000,4,0,1,-1,0
202503,5809000,CA,0,34,-34,0
202503,5809000,V3,0,1,-1,0
202503,5819000,2,3,22,-19,0.14
202503,5819000,2S3,0,1,-1,0
202503,5819000,3,3,11,-8,0.27
202503,5819000,3S2,0,47,-47,0
202503,5819000,3S3,0,57,-57,0
202503,5819000,4,0,3,-3,0
202503,5819000,CA,0,3,-3,0
202503,5819000,V3,0,3,-3,0
202503,5819002,3S2,0,7,-7,0
202503,5837000,2,74,635,-561,0.12
202503,5837000,2R2,0,4,-4,0
202503,5837000,2S2,10,34,-24,0.29
202503,5837000,2S3,9,8,1,1.12
202503,5837000,3,7,54,-47,0.13
202503,5837000,3S2,45,13,32,3.46
202503,5837000,3S3,149,712,-563,0.21
202503,5837000,4,0,3,-3,0
202503,5837000,CA,7,139,-132,0.05
202503,5837001,2,8,10,-2,0.8
202503,5837001,3,0,2,-2,0
202503,5837001,3S2,0,1,-1,0
202503,5837001,3S3,0,2,-2,0
202503,5837002,2,1,2,-1,0.5
202503,5837002,3,0,13,-13,0
202503,5837002,3S2,0,153,-153,0
202503,5837002,3S3,0,106,-106,0
202503,5837002,CA,0,1,-1,0
202503,5837008,3S3,0,1,-1,0
202503,5837012,2,0,1,-1,0
202503,5842000,2,0,36,-36,0
202503,5842000,3,1,2,-1,0.5
202503,5842000,3S3,0,2,-2,0
202503,5842000,4,0,1,-1,0
202503,5842000,CA,0,22,-22,0
202503,5847000,2,53,166,-113,0.32
202503,5847000,3,11,17,-6,0.65
202503,5847000,3S2,2,4,-2,0.5
202503,5847000,3S3,4,39,-35,0.1
202503,5847000,CA,0,74,-74,0
202503,5854000,2,4,31,-27,0.13
202503,5854000,3,0,10,-10,0
202503,5854000,3S2,0,1,-1,0
202503,5854000,3S3,0,16,-16,0
202503,5854000,CA,0,5,-5,0
202503,5854002,2,3,7,-4,0.43
202503,5854002,3,0,2,-2,0
202503,5854002,3S2,2,1,1,2
202503,5854002,3S3,0,1,-1,0
202503,5854002,CA,0,21,-21,0
202503,5856000,2,50,27,23,1.85
202503,5856000,3,24,16,8,1.5
202503,5856000,3S2,2,1,1,2
202503,5856000,3S3,0,4,-4,0
202503,5856000,CA,0,17,-17,0
202503,5856000,V2,0,2,-2,0
202503,5856000,V3,86,0,86,NA
202503,5856000,V4,34,0,34,NA
202503,5858000,2,9,67,-58,0.13
202503,5858000,2S2,0,1,-1,0
202503,5858000,3,7,30,-23,0.23
202503,5858000,3S1,2,1,1,2
202503,5858000,3S2,18,46,-28,0.39
202503,5858000,3S3,17,44,-27,0.39
202503,5858000,CA,1,28,-27,0.04
202503,5858000,V3,0,1,-1,0
202503,5861000,2,1,36,-35,0.03
202503,5861000,2S2,0,8,-8,0
202503,5861000,3,0,7,-7,0
202503,5861000,3S3,0,4,-4,0
202503,5861000,CA,0,40,-40,0
202503,5861000,V2,0,1,-1,0
202503,5861000,V3,0,4,-4,0
202503,5861002,2,10,16,-6,0.62
202503,5861002,2S2,4,0,4,NA
202503,5861002,3,0,2,-2,0
202503,5861002,3S2,0,2,-2,0
202503,5861002,3S3,10,23,-13,0.43
202503,5861002,3S4,1,2,-1,0.5
202503,5861002,4,23,1,22,23
202503,5861002,CA,0,13,-13,0
202503,5861002,V2,0,1,-1,0
202503,5873000,2,0,2,-2,0
202503,5873000,3S3,0,1,-1,0
202503,5873006,2,0,1,-1,0
202503,5873006,3S3,0,2,-2,0
202503,5885000,2,4,14,-10,0.29
202503,5885000,3,2,9,-7,0.22
202503,5885000,3S2,0,1,-1,0
202503,5885000,3S3,38,0,38,NA
202503,5885000,CA,0,8,-8,0
202503,5885000,V3,0,6,-6,0
202503,5887000,2,188,513,-325,0.37
202503,5887000,2S2,0,1,-1,0
202503,5887000,2S3,0,7,-7,0
202503,5887000,3,109,12,97,9.08
202503,5887000,3S2,77,39,38,1.97
202503,5887000,3S3,373,476,-103,0.78
202503,5887000,4,4,0,4,NA
202503,5887000,CA,8,95,-87,0.08
202503,5887000,V2,3,0,3,NA
202503,5887007,2,34,14,20,2.43
202503,5887007,2R2,0,11,-11,0
202503,5887007,3,0,2,-2,0
202503,5887007,3S3,20,18,2,1.11
202503,5887007,CA,0,2,-2,0
202503,5890000,2,56,85,-29,0.66
202503,5890000,3,1,36,-35,0.03
202503,5890000,3S2,1,1,0,1
202503,5890000,3S3,2,67,-65,0.03
202503,5890000,CA,0,27,-27,0
202503,5890000,V2,0,1,-1,0
202503,5890000,V3,0,17,-17,0
202503,5893000,2,40,88,-48,0.45
202503,5893000,2S2,2,4,-2,0.5
202503,5893000,2S3,0,3,-3,0
202503,5893000,3,3,2,1,1.5
202503,5893000,3S1,1,0,1,NA
202503,5893000,3S2,5,1,4,5
202503,5893000,3S3,29,44,-15,0.66
202503,5893000,3S3S2,1,2,-1,0.5
202503,5893000,CA,27,51,-24,0.53
202503,5893000,V3,0,1,-1,0
202503,5893001,3S3,0,1,-1,0
202503,5893001,V3,0,7,-7,0
202503,5893003,2,8,0,8,NA
202503,5893003,CA,0,5,-5,0
202503,5893005,V3,0,1,-1,0
202503,5895000,2,5,110,-105,0.05
202503,5895000,2R2,0,14,-14,0
202503,5895000,3,0,11,-11,0
202503,5895000,3S1,0,2,-2,0
202503,5895000,3S2,4,5,-1,0.8
202503,5895000,3S3,1,55,-54,0.02
202503,5895000,4,0,1,-1,0
202503,5895000,CA,0,29,-29,0
202503,5895004,3S3,0,1,-1,0
202503,8001000,2,21742,22020,-278,0.99
202503,8001000,2B1,11,10,1,1.1
202503,8001000,2R2,57,43,14,1.33
202503,8001000,2S1,5,4,1,1.25
202503,8001000,2S2,1099,2385,-1286,0.46
202503,8001000,2S3,652,1251,-599,0.52
202503,8001000,3,693,884,-191,0.78
202503,8001000,3S1,5,2,3,2.5
202503,8001000,3S2,2245,2913,-668,0.77
202503,8001000,3S2S3,1,0,1,NA
202503,8001000,3S3,14681,17335,-2654,0.85
202503,8001000,3S4,12,17,-5,0.71
202503,8001000,4,59,9,50,6.56
202503,8001000,CA,4814,5117,-303,0.94
202503,8001000,V2,34,46,-12,0.74
202503,8001000,V3,134,125,9,1.07
202503,8001000,V4,7,13,-6,0.54
202503,8001001,2,231,47,184,4.91
202503,8001001,2S2,1,6,-5,0.17
202503,8001001,2S3,54,28,26,1.93
202503,8001001,3,2,1,1,2
202503,8001001,3S2,20,51,-31,0.39
202503,8001001,3S3,107,266,-159,0.4
202503,8001001,CA,0,4,-4,0
202503,8001002,2,1,2,-1,0.5
202503,8001002,3,1,0,1,NA
202503,8001002,3S3,3,2,1,1.5
202503,8001004,2,1,13,-12,0.08
202503,8001004,3,0,1,-1,0
202503,8001004,3S3,3,29,-26,0.1
202503,8078000,2,1107,450,657,2.46
202503,8078000,2S2,536,5,531,107.2
202503,8078000,2S3,10,9,1,1.11
202503,8078000,3,510,18,492,28.33
202503,8078000,3S1,5,0,5,NA
202503,8078000,3S2,17,96,-79,0.18
202503,8078000,3S3,1296,709,587,1.83
202503,8078000,CA,6,172,-166,0.03
202503,8078000,V2,12,16,-4,0.75
202503,8078000,V3,0,1,-1,0
202503,8078001,2,57,127,-70,0.45
202503,8078001,3,0,10,-10,0
202503,8078001,3S2,0,1,-1,0
202503,8078001,CA,0,6,-6,0
202503,8078003,2,0,13,-13,0
202503,8137000,2,2,80,-78,0.03
202503,8137000,3S3,1,0,1,NA
202503,8137000,CA,0,45,-45,0
202503,8137001,2,0,1,-1,0
202503,8141000,2,17,38,-21,0.45
202503,8141000,2S2,11,69,-58,0.16
202503,8141000,2S3,1,2,-1,0.5
202503,8141000,3,7,2,5,3.5
202503,8141000,3S2,1,0,1,NA
202503,8141000,3S3,10,5,5,2
202503,8141000,CA,1,24,-23,0.04
202503,8141001,CA,0,10,-10,0
202503,8296000,2,8859,2231,6628,3.97
202503,8296000,2B1,0,5,-5,0
202503,8296000,2R2,245,11,234,22.27
202503,8296000,2S2,245,438,-193,0.56
202503,8296000,2S3,159,207,-48,0.77
202503,8296000,3,319,125,194,2.55
202503,8296000,3S1,4,0,4,NA
202503,8296000,3S2,380,451,-71,0.84
202503,8296000,3S3,2246,2170,76,1.04
202503,8296000,3S4,3,7,-4,0.43
202503,8296000,4,8,2,6,4
202503,8296000,CA,2352,416,1936,5.65
202503,8296000,V3,0,7,-7,0
202503,8296001,2,0,72,-72,0
202503,8372000,2,7,162,-155,0.04
202503,8372000,2S3,0,1,-1,0
202503,8372000,3S2,1,2,-1,0.5
202503,8372000,3S3,1,20,-19,0.05
202503,8372000,3S4,3,3,0,1
202503,8372000,CA,0,52,-52,0
202503,8372002,CA,0,1,-1,0
202503,8372003,2S2,0,1,-1,0
202503,8372003,CA,0,1,-1,0
202503,8372004,2,5,15,-10,0.33
202503,8372004,3S3,0,1,-1,0
202503,8372004,CA,0,24,-24,0
202503,8372006,2,0,1,-1,0
202503,8421000,2,276,260,16,1.06
202503,8421000,2S2,1,0,1,NA
202503,8421000,2S3,6,4,2,1.5
202503,8421000,3,0,1,-1,0
202503,8421000,3S2,12,15,-3,0.8
202503,8421000,3S3,165,9,156,18.33
202503,8421000,3S4,2,0,2,NA
202503,8421000,CA,0,100,-100,0
202503,8421000,V3,5,0,5,NA
202503,8421000,V3R3,1,0,1,NA
202503,8421001,2,1,7,-6,0.14
202503,8421001,2S2,0,1,-1,0
202503,8421001,3S2,1,1,0,1
202503,8421001,3S3,2,7,-5,0.29
202503,8421001,3S4,0,4,-4,0
202503,8421001,CA,0,5,-5,0
202503,8421002,2,0,3,-3,0
202503,8433000,2,14323,2123,12200,6.75
202503,8433000,2R2,8,4,4,2
202503,8433000,2S2,153,311,-158,0.49
202503,8433000,2S3,90,209,-119,0.43
202503,8433000,3,176,130,46,1.35
202503,8433000,3S2,298,336,-38,0.89
202503,8433000,3S3,2683,2253,430,1.19
202503,8433000,3S4,1,1,0,1
202503,8433000,CA,1958,414,1544,4.73
202503,8433000,V2,0,15,-15,0
202503,8433000,V3,13,405,-392,0.03
202503,8433000,V4,0,21,-21,0
202503,8433001,2,51,144,-93,0.35
202503,8433001,2S2,3,0,3,NA
202503,8433001,3,3,15,-12,0.2
202503,8433001,3S2,3,4,-1,0.75
202503,8433001,3S3,24,20,4,1.2
202503,8433001,CA,0,1,-1,0
202503,8433004,3S3,0,7,-7,0
202503,8436000,2,7,79,-72,0.09
202503,8436000,CA,1,59,-58,0.02
202503,8520000,2,61,247,-186,0.25
202503,8520000,2S2,17,123,-106,0.14
202503,8520000,2S3,22,28,-6,0.79
202503,8520000,3,1,4,-3,0.25
202503,8520000,3S2,14,8,6,1.75
202503,8520000,3S3,1635,1455,180,1.12
202503,8520000,CA,5,92,-87,0.05
202503,8520000,V3,1,0,1,NA
202503,8549000,2,2,25,-23,0.08
202503,8549000,3,0,14,-14,0
202503,8549000,CA,3,45,-42,0.07
202503,8549002,2,0,2,-2,0
202503,8549002,2S2,2,0,2,NA
202503,8549002,CA,0,1,-1,0
202503,8549003,2S2,3,0,3,NA
202503,8549003,2S3,6,0,6,NA
202503,8549003,3S3,1,0,1,NA
202503,8558000,2,79,280,-201,0.28
202503,8558000,3,0,22,-22,0
202503,8558000,CA,1,24,-23,0.04
202503,8558001,2,0,13,-13,0
202503,8558001,3,0,13,-13,0
202503,8560000,2,93,181,-88,0.51
202503,8560000,2S2,0,13,-13,0
202503,8560000,2S3,25,114,-89,0.22
202503,8560000,3,6,31,-25,0.19
202503,8560000,3S2,7,26,-19,0.27
202503,8560000,3S3,43,120,-77,0.36
202503,8560000,3S4,1,0,1,NA
202503,8560000,CA,5,60,-55,0.08
202503,8560002,2,1,0,1,NA
202503,8560003,2,1,4,-3,0.25
202503,8560003,3S2,1,1,0,1
202503,8560003,CA,1,0,1,NA
202503,8560004,2,0,2,-2,0
202503,8560004,3S2,0,5,-5,0
202503,8573000,2,79,1177,-1098,0.07
202503,8573000,2S2,1,105,-104,0.01
202503,8573000,2S3,0,7,-7,0
202503,8573000,3,7,49,-42,0.14
202503,8573000,3S2,0,69,-69,0
202503,8573000,3S3,1,368,-367,0
202503,8573000,CA,110,585,-475,0.19
202503,8573000,V2,41,0,41,NA
202503,8573000,V3,166,0,166,NA
202503,8573002,2,5,9,-4,0.56
202503,8573003,2,1,1,0,1
202503,8573007,2,0,1,-1,0
202503,8606000,2,4,58,-54,0.07
202503,8606000,3,0,1,-1,0
202503,8606000,3S2,7,1,6,7
202503,8606000,3S3,15,11,4,1.36
202503,8606000,3S4,0,1,-1,0
202503,8606000,CA,0,53,-53,0
202503,8606004,2,0,2,-2,0
202503,8606004,3S3,1,0,1,NA
202503,8606005,CA,0,1,-1,0
202503,8634000,2,589,456,133,1.29
202503,8634000,2S2,5,9,-4,0.56
202503,8634000,2S3,7,6,1,1.17
202503,8634000,3,190,17,173,11.18
202503,8634000,3S2,15,43,-28,0.35
202503,8634000,3S3,246,493,-247,0.5
202503,8634000,3S4,1,0,1,NA
202503,8634000,CA,2,81,-79,0.02
202503,8634000,V3,146,61,85,2.39
202503,8634000,V3R3,0,1,-1,0
202503,8634000,V4,8,19,-11,0.42
202503,8638000,2,128,820,-692,0.16
202503,8638000,2S2,1,14,-13,0.07
202503,8638000,2S3,147,167,-20,0.88
202503,8638000,3,2,30,-28,0.07
202503,8638000,3S2,28,64,-36,0.44
202503,8638000,3S3,227,308,-81,0.74
202503,8638000,3S4,0,4,-4,0
202503,8638000,CA,12,233,-221,0.05
202503,8638000,V2,15,3,12,5
202503,8638000,V3,1,0,1,NA
202503,8638001,2,0,7,-7,0
202503,8638002,2,6,11,-5,0.55
202503,8638002,2S2,1,0,1,NA
202503,8638002,3,0,2,-2,0
202503,8638002,3S2,5,2,3,2.5
202503,8638002,3S3,5,3,2,1.67
202503,8638002,CA,0,9,-9,0
202503,8638004,CA,0,8,-8,0
202503,8638006,2,0,10,-10,0
202503,8638006,2S3,0,2,-2,0
202503,8638006,3S3,0,1,-1,0
202503,8638010,2,0,1,-1,0
202503,8638010,3S3,0,1,-1,0
202503,8675000,2,2,32,-30,0.06
202503,8675000,CA,0,20,-20,0
202503,8685000,2,58,166,-108,0.35
202503,8685000,2S2,1,1,0,1
202503,8685000,3,0,28,-28,0
202503,8685000,3S2,0,27,-27,0
202503,8685000,3S3,114,40,74,2.85
202503,8685000,CA,1,78,-77,0.01
202503,8685000,V2,5,0,5,NA
202503,8758000,2,4938,3558,1380,1.39
202503,8758000,2R2,12,6,6,2
202503,8758000,2S1,0,3,-3,0
202503,8758000,2S2,50,129,-79,0.39
202503,8758000,2S3,110,222,-112,0.5
202503,8758000,3,137,79,58,1.73
202503,8758000,3S1,0,2,-2,0
202503,8758000,3S2,162,326,-164,0.5
202503,8758000,3S3,900,1151,-251,0.78
202503,8758000,3S4,1,0,1,NA
202503,8758000,4,1,0,1,NA
202503,8758000,CA,2716,902,1814,3.01
202503,8758000,V2,0,55,-55,0
202503,8758000,V3,8,135,-127,0.06
202503,8758000,V4,0,34,-34,0
202503,8770000,2,2,67,-65,0.03
202503,8770000,3S3,0,1,-1,0
202503,8770000,CA,1,12,-11,0.08
202503,8832000,2,10,82,-72,0.12
202503,8832000,2S2,10,11,-1,0.91
202503,8832000,2S3,20,10,10,2
202503,8832000,3S2,5,8,-3,0.62
202503,8832000,3S3,43,47,-4,0.91
202503,8832000,3S4,3,0,3,NA
202503,8832000,CA,2,73,-71,0.03
202503,8849000,2,7,28,-21,0.25
202503,8849000,3,0,1,-1,0
202503,8849000,3S2,0,1,-1,0
202503,8849000,CA,1,34,-33,0.03
202503,11001000,2,68210,76611,-8401,0.89
202503,11001000,2B1,5,3,2,1.67
202503,11001000,2R2,100,96,4,1.04
202503,11001000,2S1,7,9,-2,0.78
202503,11001000,2S2,6009,7561,-1552,0.79
202503,11001000,2S3,3004,2299,705,1.31
202503,11001000,3,1211,2869,-1658,0.42
202503,11001000,3S1,5,15,-10,0.33
202503,11001000,3S2,4441,7811,-3370,0.57
202503,11001000,3S2S3,2,1,1,2
202503,11001000,3S3,10071,20793,-10722,0.48
202503,11001000,3S4,26,63,-37,0.41
202503,11001000,4,40,113,-73,0.35
202503,11001000,CA,21796,46487,-24691,0.47
202503,11001000,V2,107,112,-5,0.96
202503,11001000,V3,97,538,-441,0.18
202503,11001000,V4,906,23,883,39.39
202503,11001001,2,128,101,27,1.27
202503,11001001,2S2,0,1,-1,0
202503,11001001,3S3,12,40,-28,0.3
202503,11001001,CA,0,2,-2,0
202503,11001002,2,0,6,-6,0
202503,11001005,2,0,1,-1,0
202503,11001005,V2,0,1,-1,0
202503,11001006,2,7,19,-12,0.37
202503,11001006,2S2,2,5,-3,0.4
202503,11001006,2S3,1,3,-2,0.33
202503,11001006,3S3,0,4,-4,0
202503,11001006,CA,4,2,2,2
202503,13001000,2,11517,15783,-4266,0.73
202503,13001000,2B1,21,6,15,3.5
202503,13001000,2B2,7,0,7,NA
202503,13001000,2R2,52,47,5,1.11
202503,13001000,2S1,12,1,11,12
202503,13001000,2S2,7475,4259,3216,1.76
202503,13001000,2S3,3181,2329,852,1.37
202503,13001000,3,1171,268,903,4.37
202503,13001000,3S1,2,4,-2,0.5
202503,13001000,3S2,4722,2850,1872,1.66
202503,13001000,3S3,19444,15545,3899,1.25
202503,13001000,3S4,92,26,66,3.54
202503,13001000,4,26,25,1,1.04
202503,13001000,CA,2297,3305,-1008,0.7
202503,13001000,V2,0,37,-37,0
202503,13001000,V3,7,0,7,NA
202503,13001001,2,0,4,-4,0
202503,13001001,3S4,1,1,0,1
202503,13001002,2,2,2,0,1
202503,13001002,3S2,1,2,-1,0.5
202503,13001002,3S3,51,0,51,NA
202503,13001002,CA,1,1,0,1
202503,13001002,V3,2,0,2,NA
202503,13001003,2,5,55,-50,0.09
202503,13001003,2S2,0,1,-1,0
202503,13001003,2S3,0,1,-1,0
202503,13001003,3,0,4,-4,0
202503,13001003,3S2,2,1,1,2
202503,13001003,3S3,2,3,-1,0.67
202503,13001003,CA,9,23,-14,0.39
202503,13001004,2,39,63,-24,0.62
202503,13001004,2S2,3,0,3,NA
202503,13001004,2S3,0,1,-1,0
202503,13001004,3,1,4,-3,0.25
202503,13001004,3S2,3,1,2,3
202503,13001004,3S3,8,31,-23,0.26
202503,13001004,3S4,4,0,4,NA
202503,13001004,CA,2,7,-5,0.29
202503,13001004,V2,4,0,4,NA
202503,13001004,V3,0,2,-2,0
202503,13001005,2,0,3,-3,0
202503,13001008,2,4,5,-1,0.8
202503,13001008,3S3,0,1,-1,0
202503,13001009,2,104,17,87,6.12
202503,13001009,2S1,2,0,2,NA
202503,13001009,2S2,153,2,151,76.5
202503,13001009,2S3,11,0,11,NA
202503,13001009,3,6,0,6,NA
202503,13001009,3S2,14,3,11,4.67
202503,13001009,3S3,110,44,66,2.5
202503,13001009,3S4,0,1,-1,0
202503,13001009,CA,1,33,-32,0.03
202503,13001010,2,35,31,4,1.13
202503,13001010,3,2,2,0,1
202503,13001010,3S2,2,0,2,NA
202503,13001010,3S3,3,4,-1,0.75
202503,13001010,CA,6,16,-10,0.38
202503,13001012,2,2,5,-3,0.4
202503,13001015,2,0,33,-33,0
202503,13001015,2S2,0,2,-2,0
202503,13001015,3S2,0,1,-1,0
202503,13001015,3S3,1,5,-4,0.2
202503,13001019,2,22,9,13,2.44
202503,13001019,3S2,4,0,4,NA
202503,13001019,3S3,0,1,-1,0
202503,13001020,2,1,1,0,1
202503,13001020,3S2,1,0,1,NA
202503,13001020,3S3,2,0,2,NA
202503,13001020,CA,0,7,-7,0
202503,13001025,3S3,2,1,1,2
202503,13001028,2S3,25,0,25,NA
202503,13001028,3S3,629,0,629,NA
202503,13001029,2,7,99,-92,0.07
202503,13001029,2R2,1,0,1,NA
202503,13001029,3,0,3,-3,0
202503,13001029,3S2,0,17,-17,0
202503,13001029,3S3,5,10,-5,0.5
202503,13001029,3S4,2,3,-1,0.67
202503,13001029,CA,1,0,1,NA
202503,13006000,2,17,5,12,3.4
202503,13006000,3,0,3,-3,0
202503,13006000,3S3,0,5,-5,0
202503,13006008,2,0,3,-3,0
202503,13006033,3,0,10,-10,0
202503,13030000,2,0,1,-1,0
202503,13030000,3,0,1,-1,0
202503,13042000,2,3,31,-28,0.1
202503,13042000,2S2,0,1,-1,0
202503,13042000,3,0,1,-1,0
202503,13042000,3S3,1,6,-5,0.17
202503,13042000,CA,0,7,-7,0
202503,13052000,2,482,725,-243,0.66
202503,13052000,2R2,0,2,-2,0
202503,13052000,2S2,1,32,-31,0.03
202503,13052000,2S3,11,118,-107,0.09
202503,13052000,3,275,60,215,4.58
202503,13052000,3S2,187,96,91,1.95
202503,13052000,3S3,59,257,-198,0.23
202503,13052000,3S4,0,3,-3,0
202503,13052000,CA,561,204,357,2.75
202503,13052000,V2,7,0,7,NA
202503,13052001,2,0,2,-2,0
202503,13052001,3S3,2,0,2,NA
202503,13052002,2,40,56,-16,0.71
202503,13052002,2S3,1,0,1,NA
202503,13052002,3,4,12,-8,0.33
202503,13052002,3S3,15,5,10,3
202503,13052002,3S4,1,1,0,1
202503,13052002,CA,4,5,-1,0.8
202503,13052003,2,1,1,0,1
202503,13052003,3,2,1,1,2
202503,13052003,CA,0,3,-3,0
202503,13052004,2,29,0,29,NA
202503,13052004,2S2,8,0,8,NA
202503,13052004,2S3,36,0,36,NA
202503,13052004,3,0,113,-113,0
202503,13052004,3S3,0,2,-2,0
202503,13062000,2,14,39,-25,0.36
202503,13062000,2S3,0,6,-6,0
202503,13062000,3,0,1,-1,0
202503,13062000,3S3,2,0,2,NA
202503,13062000,CA,0,24,-24,0
202503,13074000,2,9,20,-11,0.45
202503,13074000,3,0,19,-19,0
202503,13074000,3S2,0,1,-1,0
202503,13074000,CA,0,3,-3,0
202503,13140000,2,4,142,-138,0.03
202503,13140000,2S2,0,3,-3,0
202503,13140000,3,0,4,-4,0
202503,13140000,3S3,0,8,-8,0
202503,13140000,CA,1,114,-113,0.01
202503,13140004,2,0,5,-5,0
202503,13140004,3S3,0,1,-1,0
202503,13160000,2,2,62,-60,0.03
202503,13160000,2S2,3,1,2,3
202503,13160000,3,0,1,-1,0
202503,13160000,3S2,1,0,1,NA
202503,13160000,3S3,7,9,-2,0.78
202503,13160000,CA,0,7,-7,0
202503,13160000,V3,0,4,-4,0
202503,13188000,2,13,8,5,1.62
202503,13188000,3,0,9,-9,0
202503,13188000,3S2,1,1,0,1
202503,13188000,3S3,3,1,2,3
202503,13188000,CA,0,3,-3,0
202503,13212000,2,14,18,-4,0.78
202503,13212000,2S2,0,1,-1,0
202503,13212000,3S3,3,8,-5,0.38
202503,13212000,CA,0,1,-1,0
202503,13212003,3,0,2,-2,0
202503,13212005,2,0,2,-2,0
202503,13212005,3,0,1,-1,0
202503,13212005,CA,0,1,-1,0
202503,13212009,2,0,3,-3,0
202503,13212009,3,1,0,1,NA
202503,13212009,3S3,1,0,1,NA
202503,13222000,2,21,31,-10,0.68
202503,13222000,2S2,4,1,3,4
202503,13222000,2S3,1,3,-2,0.33
202503,13222000,3,1,1,0,1
202503,13222000,3S2,1,5,-4,0.2
202503,13222000,3S3,65,48,17,1.35
202503,13222000,CA,1,33,-32,0.03
202503,13222000,V2,2,0,2,NA
202503,13244000,2,55,296,-241,0.19
202503,13244000,2S2,1,1,0,1
202503,13244000,3,3,26,-23,0.12
202503,13244000,3S2,1,3,-2,0.33
202503,13244000,3S3,26,77,-51,0.34
202503,13244000,4,0,1,-1,0
202503,13244000,CA,1,115,-114,0.01
202503,13244001,2,0,1,-1,0
202503,13244005,2,0,1,-1,0
202503,13244007,2,1,0,1,NA
202503,13244014,2S3,0,1,-1,0
202503,13244014,CA,0,1,-1,0
202503,13248000,2,1,8,-7,0.12
202503,13248000,3S3,1,0,1,NA
202503,13268000,2,6,1,5,6
202503,13268019,2,0,6,-6,0
202503,13268019,3S3,1,1,0,1
202503,13300000,2,11,6,5,1.83
202503,13300000,3,2,9,-7,0.22
202503,13300000,3S3,2,18,-16,0.11
202503,13300000,CA,0,2,-2,0
202503,13300004,2,0,1,-1,0
202503,13300004,3,0,6,-6,0
202503,13430000,2,304,831,-527,0.37
202503,13430000,2R2,0,20,-20,0
202503,13430000,2S2,7,1,6,7
202503,13430000,2S3,2,1,1,2
202503,13430000,3,80,87,-7,0.92
202503,13430000,3S2,2,6,-4,0.33
202503,13430000,3S3,89,254,-165,0.35
202503,13430000,4,1,0,1,NA
202503,13430000,CA,14,139,-125,0.1
202503,13430002,3S3,0,2,-2,0
202503,13430006,3S3,3,3,0,1
202503,13430006,CA,0,1,-1,0
202503,13430009,2,0,1,-1,0
202503,13430011,2,0,1,-1,0
202503,13430017,2,0,3,-3,0
202503,13430017,3S3,0,15,-15,0
202503,13430023,2,0,3,-3,0
202503,13430032,2,4,0,4,NA
202503,13430032,3S3,2,2,0,1
202503,13430032,CA,0,1,-1,0
202503,13433000,2,71,64,7,1.11
202503,13433000,3,0,12,-12,0
202503,13433000,3S2,0,3,-3,0
202503,13433000,3S3,0,15,-15,0
202503,13433000,CA,1,10,-9,0.1
202503,13433000,V2,5,0,5,NA
202503,13433003,2,10,16,-6,0.62
202503,13433003,3S3,5,0,5,NA
202503,13433003,CA,7,0,7,NA
202503,13433004,2,0,4,-4,0
202503,13433004,3S2,0,1,-1,0
202503,13433009,3S2,2,4,-2,0.5
202503,13440000,2,14,1,13,14
202503,13440000,3,0,1,-1,0
202503,13440004,3S2,1,0,1,NA
202503,13440007,3,0,2,-2,0
202503,13440021,2,0,2,-2,0
202503,13442000,2,108,187,-79,0.58
202503,13442000,2S2,19,0,19,NA
202503,13442000,2S3,62,0,62,NA
202503,13442000,3,1,2,-1,0.5
202503,13442000,3S2,1,0,1,NA
202503,13442000,3S3,99,55,44,1.8
202503,13442000,4,0,1,-1,0
202503,13442000,CA,5,78,-73,0.06
202503,13442008,3S3,4,2,2,2
202503,13458000,2,0,1,-1,0
202503,13458000,3,0,12,-12,0
202503,13458000,3S3,0,5,-5,0
202503,13468000,2,36,272,-236,0.13
202503,13468000,2R2,0,12,-12,0
202503,13468000,2S2,4,0,4,NA
202503,13468000,2S3,2,0,2,NA
202503,13468000,3,11,29,-18,0.38
202503,13468000,3S2,0,1,-1,0
202503,13468000,3S3,0,23,-23,0
202503,13468000,CA,2,59,-57,0.03
202503,13468023,2,0,1,-1,0
202503,13468023,CA,0,3,-3,0
202503,13468024,2,0,12,-12,0
202503,13468028,2,0,23,-23,0
202503,13468040,2,0,2,-2,0
202503,13473000,2,11,12,-1,0.92
202503,13473000,3,0,1,-1,0
202503,13473000,3S2,1,0,1,NA
202503,13473000,3S3,2,3,-1,0.67
202503,13473000,3S4,4,0,4,NA
202503,13473000,CA,0,6,-6,0
202503,13490000,2,0,9,-9,0
202503,13490000,3,4,1,3,4
202503,13490000,3S2,0,4,-4,0
202503,13490000,3S3,1,1,0,1
202503,13549000,2,3,0,3,NA
202503,13549001,3,0,1,-1,0
202503,13580000,2,0,2,-2,0
202503,13580000,3,0,3,-3,0
202503,13580000,3S2,4,6,-2,0.67
202503,13580000,3S3,52,19,33,2.74
202503,13580000,CA,0,1,-1,0
202503,13580000,V3,0,1,-1,0
202503,13580000,V3R3,0,1,-1,0
202503,13580005,3,0,1,-1,0
202503,13600000,2,2,15,-13,0.13
202503,13600000,3S3,2,4,-2,0.5
202503,13600000,CA,0,6,-6,0
202503,13600001,2,0,2,-2,0
202503,13600001,3S2,1,1,0,1
202503,13600001,3S3,2,0,2,NA
202503,13600001,CA,0,1,-1,0
202503,13620000,2,0,2,-2,0
202503,13620000,3S2,1,0,1,NA
202503,13620000,CA,0,5,-5,0
202503,13647000,2,4,25,-21,0.16
202503,13647000,2S2,0,1,-1,0
202503,13647000,3S2,1,0,1,NA
202503,13647000,CA,0,12,-12,0
202503,13647002,2,1,0,1,NA
202503,13647002,3S3,0,1,-1,0
202503,13650000,2,5,2,3,2.5
202503,13650000,CA,0,2,-2,0
202503,13650005,3,0,1,-1,0
202503,13650005,3S3,1,0,1,NA
202503,13654000,2,6,50,-44,0.12
202503,13654000,3S2,1,0,1,NA
202503,13654000,3S3,2,9,-7,0.22
202503,13654000,CA,1,4,-3,0.25
202503,13655000,2,1,0,1,NA
202503,13655000,3,0,14,-14,0
202503,13657000,2,110,159,-49,0.69
202503,13657000,2S2,0,4,-4,0
202503,13657000,2S3,1,3,-2,0.33
202503,13657000,3,0,4,-4,0
202503,13657000,3S2,1,3,-2,0.33
202503,13657000,3S3,1,50,-49,0.02
202503,13657000,4,0,1,-1,0
202503,13657000,CA,1,21,-20,0.05
202503,13657005,3,0,1,-1,0
202503,13667000,2,4,26,-22,0.15
202503,13667000,3,0,28,-28,0
202503,13667000,3S2,1,0,1,NA
202503,13667002,3,0,1,-1,0
202503,13667009,CA,0,1,-1,0
202503,13670000,2,10,148,-138,0.07
202503,13670000,3,3,21,-18,0.14
202503,13670000,3S2,3,4,-1,0.75
202503,13670000,3S3,127,39,88,3.26
202503,13670000,CA,0,10,-10,0
202503,13670000,V3,0,5,-5,0
202503,13673000,2,106,173,-67,0.61
202503,13673000,2S2,8,5,3,1.6
202503,13673000,2S3,8,8,0,1
202503,13673000,3,0,3,-3,0
202503,13673000,3S2,0,1,-1,0
202503,13673000,3S3,3,1,2,3
202503,13673000,CA,1,20,-19,0.05
202503,13673003,2,0,2,-2,0
202503,13673003,3S3,1,0,1,NA
202503,13673003,CA,6,6,0,1
202503,13673005,2,1,0,1,NA
202503,13673005,3S3,0,1,-1,0
202503,13673005,CA,1,2,-1,0.5
202503,13683000,2,184,285,-101,0.65
202503,13683000,2S2,3,2,1,1.5
202503,13683000,2S3,0,6,-6,0
202503,13683000,3,1,2,-1,0.5
202503,13683000,3S2,3,0,3,NA
202503,13683000,3S3,3,10,-7,0.3
202503,13683000,CA,0,14,-14,0
202503,13683000,V2,4,0,4,NA
202503,13688000,2,8,274,-266,0.03
202503,13688000,2S3,0,2,-2,0
202503,13688000,3,0,25,-25,0
202503,13688000,3S2,2,3,-1,0.67
202503,13688000,3S3,0,98,-98,0
202503,13688000,CA,26,54,-28,0.48
202503,13688000,V2,0,1,-1,0
202503,13688000,V3,0,9,-9,0
202503,13688007,3,0,4,-4,0
202503,13744000,2,2,25,-23,0.08
202503,13744000,3,0,5,-5,0
202503,13744000,3S3,0,10,-10,0
202503,13744000,3S4,1,0,1,NA
202503,13744000,CA,1,4,-3,0.25
202503,13744012,2,1,2,-1,0.5
202503,13760000,2,3,21,-18,0.14
202503,13760000,3S3,0,1,-1,0
202503,13760000,CA,10,26,-16,0.38
202503,13760000,V2,1,0,1,NA
202503,13780000,2,3,11,-8,0.27
202503,13780000,3S3,0,2,-2,0
202503,13780000,3S4,1,0,1,NA
202503,13810000,2,0,5,-5,0
202503,13810000,3,0,11,-11,0
202503,13810011,2,0,1,-1,0
202503,13810011,3,0,3,-3,0
202503,13810011,CA,1,0,1,NA
202503,13836000,2,883,1339,-456,0.66
202503,13836000,2R2,0,1,-1,0
202503,13836000,2S2,118,30,88,3.93
202503,13836000,2S3,86,84,2,1.02
202503,13836000,3,19,78,-59,0.24
202503,13836000,3S2,241,180,61,1.34
202503,13836000,3S3,865,779,86,1.11
202503,13836000,3S4,2,2,0,1
202503,13836000,4,0,1,-1,0
202503,13836000,CA,27,382,-355,0.07
202503,13836000,V2,11,0,11,NA
202503,13836001,2,0,1,-1,0
202503,13836003,2,1,1,0,1
202503,13836003,3S3,0,7,-7,0
202503,13838000,2,127,116,11,1.09
202503,13838000,2R2,12,2,10,6
202503,13838000,2S2,54,9,45,6
202503,13838000,2S3,43,15,28,2.87
202503,13838000,3S2,297,217,80,1.37
202503,13838000,3S3,138,99,39,1.39
202503,13838000,3S4,7,9,-2,0.78
202503,13838000,CA,9,25,-16,0.36
202503,13838001,2,11,12,-1,0.92
202503,13873000,2,3,32,-29,0.09
202503,13873000,3S3,1,3,-2,0.33
202503,13873000,4,0,1,-1,0
202503,13873000,CA,0,32,-32,0
202503,13873000,V2,3,0,3,NA
202503,13873001,2,0,3,-3,0
202503,13894000,2,41,48,-7,0.85
202503,13894000,3,1,2,-1,0.5
202503,13894000,3S3,45,15,30,3
202503,13894000,CA,1,4,-3,0.25
202503,15001000,2,1310,3113,-1803,0.42
202503,15001000,2R2,1,13,-12,0.08
202503,15001000,2S2,8,103,-95,0.08
202503,15001000,2S3,3,32,-29,0.09
202503,15001000,3,12,136,-124,0.09
202503,15001000,3S1,2,1,1,2
202503,15001000,3S2,105,242,-137,0.43
202503,15001000,3S2S3,1,0,1,NA
202503,15001000,3S3,332,858,-526,0.39
202503,15001000,3S4,1,0,1,NA
202503,15001000,4,0,1,-1,0
202503,15001000,CA,1474,1298,176,1.14
202503,15001000,V2,1,0,1,NA
202503,15001000,V3,0,294,-294,0
202503,15001007,2,0,5,-5,0
202503,15001007,2S2,0,12,-12,0
202503,15001007,3S3,1,0,1,NA
202503,15022000,2,0,2,-2,0
202503,15022000,CA,0,3,-3,0
202503,15047000,2,0,31,-31,0
202503,15047000,3S3,0,3,-3,0
202503,15047000,CA,17,40,-23,0.42
202503,15047007,2,0,1,-1,0
202503,15047010,2,0,15,-15,0
202503,15051000,2,1,28,-27,0.04
202503,15051000,3,1,1,0,1
202503,15051000,3S3,1,6,-5,0.17
202503,15051000,4,16,0,16,NA
202503,15051000,CA,0,12,-12,0
202503,15051000,V3,73,0,73,NA
202503,15051000,V4,124,0,124,NA
202503,15087000,2,3,67,-64,0.04
202503,15087000,3,0,1,-1,0
202503,15087000,3S2,12,0,12,NA
202503,15087000,3S3,0,17,-17,0
202503,15087000,CA,1,25,-24,0.04
202503,15090000,2,0,1,-1,0
202503,15090000,CA,0,2,-2,0
202503,15092000,CA,0,4,-4,0
202503,15097000,2,0,13,-13,0
202503,15097000,CA,0,3,-3,0
202503,15104000,2,0,21,-21,0
202503,15104000,3S2,0,1,-1,0
202503,15104000,3S3,27,4,23,6.75
202503,15104000,CA,0,15,-15,0
202503,15106000,2,0,4,-4,0
202503,15106000,3S3,5,0,5,NA
202503,15106000,CA,0,6,-6,0
202503,15109000,2,0,7,-7,0
202503,15109000,3S3,1,0,1,NA
202503,15109000,CA,0,9,-9,0
202503,15109001,2,0,2,-2,0
202503,15109002,2,0,1,-1,0
202503,15114000,CA,0,3,-3,0
202503,15131000,2,0,1,-1,0
202503,15131000,CA,0,2,-2,0
202503,15135000,2,0,6,-6,0
202503,15135000,CA,0,5,-5,0
202503,15162000,2,6,22,-16,0.27
202503,15162000,3S2,0,1,-1,0
202503,15162000,CA,1,9,-8,0.11
202503,15172000,2,0,10,-10,0
202503,15172000,CA,0,7,-7,0
202503,15176000,2,55,745,-690,0.07
202503,15176000,2S2,1,0,1,NA
202503,15176000,2S3,0,1,-1,0
202503,15176000,3,1,14,-13,0.07
202503,15176000,3S2,2,13,-11,0.15
202503,15176000,3S3,125,276,-151,0.45
202503,15176000,3S4,0,1,-1,0
202503,15176000,CA,12,261,-249,0.05
202503,15176000,V2,0,1,-1,0
202503,15180000,2,0,8,-8,0
202503,15180000,CA,2,5,-3,0.4
202503,15183000,2,0,9,-9,0
202503,15183000,CA,0,27,-27,0
202503,15185000,2,1,20,-19,0.05
202503,15185000,2S3,1,0,1,NA
202503,15185000,3,0,1,-1,0
202503,15185000,3S2,1,0,1,NA
202503,15185000,3S3,2,1,1,2
202503,15185000,CA,0,6,-6,0
202503,15185000,V2,0,1,-1,0
202503,15187000,2,0,6,-6,0
202503,15187000,3S3,5,0,5,NA
202503,15187000,CA,0,4,-4,0
202503,15189000,2,4,3,1,1.33
202503,15189000,3S3,1,3,-2,0.33
202503,15189000,CA,0,4,-4,0
202503,15204000,2,2,45,-43,0.04
202503,15204000,2S2,0,1,-1,0
202503,15204000,3S2,1,3,-2,0.33
202503,15204000,3S3,2,7,-5,0.29
202503,15204000,CA,0,14,-14,0
202503,15212000,2,0,1,-1,0
202503,15212000,CA,0,2,-2,0
202503,15215000,2,6,0,6,NA
202503,15215000,3S2,3,0,3,NA
202503,15215000,3S3,302,1,301,302
202503,15215000,CA,0,3,-3,0
202503,15218000,2,1,3,-2,0.33
202503,15218000,3S3,1,0,1,NA
202503,15218000,CA,0,1,-1,0
202503,15223000,2,1,24,-23,0.04
202503,15223000,3S3,0,4,-4,0
202503,15224000,2,1,6,-5,0.17
202503,15224000,3,0,1,-1,0
202503,15224000,3S3,0,1,-1,0
202503,15224000,CA,0,10,-10,0
202503,15226000,CA,0,2,-2,0
202503,15232000,2,0,1,-1,0
202503,15232000,CA,0,1,-1,0
202503,15232001,2,0,2,-2,0
202503,15236000,2,1,1,0,1
202503,15236000,3S3,1,0,1,NA
202503,15236000,3S4,1,0,1,NA
202503,15236000,CA,0,4,-4,0
202503,15238000,2,1302,1718,-416,0.76
202503,15238000,2R2,0,8,-8,0
202503,15238000,2S2,7,36,-29,0.19
202503,15238000,2S3,5,21,-16,0.24
202503,15238000,3,81,76,5,1.07
202503,15238000,3S2,18,118,-100,0.15
202503,15238000,3S3,455,619,-164,0.74
202503,15238000,3S4,0,5,-5,0
202503,15238000,4,1,0,1,NA
202503,15238000,CA,543,659,-116,0.82
202503,15238000,V2,5,0,5,NA
202503,15238000,V3,0,1,-1,0
202503,15238002,2,0,5,-5,0
202503,15238008,3S3,0,1,-1,0
202503,15238011,2,0,26,-26,0
202503,15238012,3,0,1,-1,0
202503,15238012,3S3,0,3,-3,0
202503,15244000,2,0,13,-13,0
202503,15244000,CA,0,5,-5,0
202503,15248000,2,0,5,-5,0
202503,15248000,CA,13,17,-4,0.76
202503,15272000,2,0,5,-5,0
202503,15272000,3S2,0,1,-1,0
202503,15272000,CA,0,4,-4,0
202503,15276000,2,0,1,-1,0
202503,15276000,CA,0,2,-2,0
202503,15293000,2,0,7,-7,0
202503,15293000,CA,0,6,-6,0
202503,15296000,2,0,4,-4,0
202503,15296000,3,0,1,-1,0
202503,15296000,CA,0,4,-4,0
202503,15299000,2,26,185,-159,0.14
202503,15299000,3,0,5,-5,0
202503,15299000,CA,39,83,-44,0.47
202503,15299004,2,0,1,-1,0
202503,15317000,2,0,2,-2,0
202503,15317000,CA,0,7,-7,0
202503,15322000,2,6,153,-147,0.04
202503,15322000,3,3,9,-6,0.33
202503,15322000,CA,0,37,-37,0
202503,15322008,2,0,5,-5,0
202503,15322008,3,0,1,-1,0
202503,15322008,CA,0,16,-16,0
202503,15325000,2,0,8,-8,0
202503,15325000,3,0,1,-1,0
202503,15325000,CA,0,3,-3,0
202503,15332000,2,1,3,-2,0.33
202503,15332005,2,0,11,-11,0
202503,15332005,3S3,0,1,-1,0
202503,15362000,2,0,4,-4,0
202503,15362000,3S3,1,0,1,NA
202503,15362000,CA,0,3,-3,0
202503,15367000,2,2,10,-8,0.2
202503,15367000,3S2,2,3,-1,0.67
202503,15367000,CA,0,4,-4,0
202503,15368000,2,0,1,-1,0
202503,15368000,CA,0,3,-3,0
202503,15377000,2,0,6,-6,0
202503,15377000,3S2,1,6,-5,0.17
202503,15377000,3S3,1,9,-8,0.11
202503,15377000,CA,0,2,-2,0
202503,15380000,2,0,43,-43,0
202503,15380000,CA,0,17,-17,0
202503,15401000,2,0,2,-2,0
202503,15401000,CA,0,2,-2,0
202503,15403000,2,0,6,-6,0
202503,15403000,CA,0,4,-4,0
202503,15407000,2,14,248,-234,0.06
202503,15407000,3,4,22,-18,0.18
202503,15407000,3S2,0,2,-2,0
202503,15407000,3S2S3,0,1,-1,0
202503,15407000,3S3,0,18,-18,0
202503,15407000,CA,6,99,-93,0.06
202503,15407000,V3,0,2,-2,0
202503,15425000,2,3,5,-2,0.6
202503,15425000,CA,0,4,-4,0
202503,15442000,2,0,1,-1,0
202503,15442000,CA,0,2,-2,0
202503,15442001,2,0,1,-1,0
202503,15442001,CA,0,1,-1,0
202503,15455000,2,4,42,-38,0.1
202503,15455000,3S3,1,1,0,1
202503,15455000,CA,17,46,-29,0.37
202503,15464000,2,0,3,-3,0
202503,15464000,4,0,1,-1,0
202503,15464000,CA,0,10,-10,0
202503,15464003,2,0,1,-1,0
202503,15466000,2,0,11,-11,0
202503,15466000,CA,1,16,-15,0.06
202503,15469000,2,7,219,-212,0.03
202503,15469000,2R2,0,2,-2,0
202503,15469000,2S2,0,1,-1,0
202503,15469000,2S3,0,2,-2,0
202503,15469000,3,0,1,-1,0
202503,15469000,3S2,0,1,-1,0
202503,15469000,3S3,1,7,-6,0.14
202503,15469000,CA,4,31,-27,0.13
202503,15469000,V3,0,3,-3,0
202503,15476000,2,0,11,-11,0
202503,15476000,CA,0,4,-4,0
202503,15480000,2,1,13,-12,0.08
202503,15480000,CA,0,4,-4,0
202503,15491000,2,641,241,400,2.66
202503,15491000,2S2,0,1,-1,0
202503,15491000,3,186,3,183,62
202503,15491000,3S2,190,72,118,2.64
202503,15491000,3S3,3999,1419,2580,2.82
202503,15491000,3S4,0,7,-7,0
202503,15491000,CA,4,43,-39,0.09
202503,15491000,V2,0,4,-4,0
202503,15491000,V3,16,26,-10,0.62
202503,15491000,V4,68,0,68,NA
202503,15491001,2,251,50,201,5.02
202503,15491001,2S2,1,5,-4,0.2
202503,15491001,3S2,1,12,-11,0.08
202503,15491001,3S3,321,656,-335,0.49
202503,15491001,3S4,0,4,-4,0
202503,15491001,CA,1,9,-8,0.11
202503,15491006,2,0,19,-19,0
202503,15491006,2R2,0,1,-1,0
202503,15491007,2,0,1,-1,0
202503,15494000,2,0,6,-6,0
202503,15494000,CA,0,3,-3,0
202503,15500000,2,26,6,20,4.33
202503,15500000,3,28,0,28,NA
202503,15500000,3S2,0,11,-11,0
202503,15500000,3S3,4,125,-121,0.03
202503,15500000,CA,0,6,-6,0
202503,15507000,2,0,23,-23,0
202503,15507000,3S2,1,0,1,NA
202503,15507000,CA,1,14,-13,0.07
202503,15507000,V2,2,0,2,NA
202503,15507000,V3,16,0,16,NA
202503,15511000,CA,0,5,-5,0
202503,15514000,2,0,3,-3,0
202503,15514000,2S2,1,0,1,NA
202503,15514000,3S3,1,1,0,1
202503,15514000,CA,10,12,-2,0.83
202503,15516000,2,61,276,-215,0.22
202503,15516000,2S1,0,1,-1,0
202503,15516000,2S2,0,1,-1,0
202503,15516000,3,2,9,-7,0.22
202503,15516000,3S2,5,6,-1,0.83
202503,15516000,3S3,47,31,16,1.52
202503,15516000,CA,29,198,-169,0.15
202503,15516000,V3,0,1,-1,0
202503,15516006,2,1,0,1,NA
202503,15518000,2,0,12,-12,0
202503,15518000,2S2,3,0,3,NA
202503,15518000,3,0,1,-1,0
202503,15518000,3S2,4,4,0,1
202503,15518000,3S3,0,6,-6,0
202503,15518000,CA,0,1,-1,0
202503,15518001,2,0,3,-3,0
202503,15522000,2,1,6,-5,0.17
202503,15522000,CA,0,3,-3,0
202503,15531000,2,1,6,-5,0.17
202503,15531000,3S3,0,1,-1,0
202503,15531000,CA,0,4,-4,0
202503,15533000,2,0,1,-1,0
202503,15533000,CA,0,3,-3,0
202503,15537000,2,0,50,-50,0
202503,15537000,2S3,0,1,-1,0
202503,15537000,3,1,36,-35,0.03
202503,15537000,3S2,1,0,1,NA
202503,15537000,3S3,673,9,664,74.78
202503,15537000,4,0,1,-1,0
202503,15537000,CA,1,20,-19,0.05
202503,15537000,V2,2,0,2,NA
202503,15537000,V3,20,56,-36,0.36
202503,15537000,V4,21,0,21,NA
202503,15542000,2,1,13,-12,0.08
202503,15542000,3S2,0,1,-1,0
202503,15542000,3S3,51,15,36,3.4
202503,15542000,CA,0,8,-8,0
202503,15550000,2,0,8,-8,0
202503,15550000,3S3,0,1,-1,0
202503,15550000,CA,0,2,-2,0
202503,15572000,2,125,821,-696,0.15
202503,15572000,2R2,0,13,-13,0
202503,15572000,2S2,7,8,-1,0.88
202503,15572000,2S3,4,0,4,NA
202503,15572000,3,1,58,-57,0.02
202503,15572000,3S1,0,1,-1,0
202503,15572000,3S2,16,258,-242,0.06
202503,15572000,3S3,39,774,-735,0.05
202503,15572000,3S4,3,3,0,1
202503,15572000,CA,12,163,-151,0.07
202503,15572000,V2,0,3,-3,0
202503,15572000,V3,4,10,-6,0.4
202503,15572006,3S2,0,5,-5,0
202503,15572007,2,0,2,-2,0
202503,15572007,3,0,2,-2,0
202503,15572007,3S2,1,0,1,NA
202503,15572007,3S3,0,16,-16,0
202503,15572013,V3,0,1,-1,0
202503,15572014,3S2,0,55,-55,0
202503,15572014,3S3,0,154,-154,0
202503,15580000,2,0,4,-4,0
202503,15580000,CA,1,5,-4,0.2
202503,15599000,2,1,40,-39,0.03
202503,15599000,3,0,2,-2,0
202503,15599000,3S3,0,5,-5,0
202503,15599000,CA,0,9,-9,0
202503,15600000,2,2,31,-29,0.06
202503,15600000,2S2,0,1,-1,0
202503,15600000,3,2,0,2,NA
202503,15600000,3S3,0,3,-3,0
202503,15600000,CA,26,46,-20,0.57
202503,15600000,V3,38,0,38,NA
202503,15600000,V4,110,0,110,NA
202503,15621000,2,0,5,-5,0
202503,15621000,CA,0,1,-1,0
202503,15632000,2,2,8,-6,0.25
202503,15632000,3S3,5,0,5,NA
202503,15632000,CA,0,9,-9,0
202503,15638000,2,1,13,-12,0.08
202503,15638000,3S3,0,1,-1,0
202503,15638000,CA,0,16,-16,0
202503,15646000,2,4,130,-126,0.03
202503,15646000,2S2,1,0,1,NA
202503,15646000,2S3,1,1,0,1
202503,15646000,3,3,3,0,1
202503,15646000,3S1,1,0,1,NA
202503,15646000,3S2,15,6,9,2.5
202503,15646000,3S3,2654,181,2473,14.66
202503,15646000,3S4,1,2,-1,0.5
202503,15646000,4,13,24,-11,0.54
202503,15646000,CA,2,18,-16,0.11
202503,15646000,V2,0,35,-35,0
202503,15646000,V2R3,0,14,-14,0
202503,15646000,V3,64,158,-94,0.41
202503,15646000,V3R2,0,12,-12,0
202503,15646000,V4,49,166,-117,0.3
202503,15646000,V4R2,2,94,-92,0.02
202503,15646001,2,0,1,-1,0
202503,15646001,3S3,6,0,6,NA
202503,15646003,2,0,1,-1,0
202503,15660000,CA,0,21,-21,0
202503,15664000,2,0,25,-25,0
202503,15664000,3S3,0,2,-2,0
202503,15664000,CA,0,5,-5,0
202503,15667000,2,5,29,-24,0.17
202503,15667000,2S2,1,0,1,NA
202503,15667000,3,1,1,0,1
202503,15667000,3S2,2,0,2,NA
202503,15667000,CA,26,35,-9,0.74
202503,15673000,2,0,3,-3,0
202503,15673000,CA,0,3,-3,0
202503,15673000,V3R2,4,0,4,NA
202503,15673000,V4R2,7,0,7,NA
202503,15676000,2,0,20,-20,0
202503,15676000,CA,0,5,-5,0
202503,15681000,CA,0,3,-3,0
202503,15686000,2,29,98,-69,0.3
202503,15686000,3,1,18,-17,0.06
202503,15686000,3S3,0,13,-13,0
202503,15686000,CA,6,14,-8,0.43
202503,15690000,2,7,23,-16,0.3
202503,15690000,3,1,1,0,1
202503,15690000,3S2,0,1,-1,0
202503,15690000,CA,1,5,-4,0.2
202503,15693000,2,8,45,-37,0.18
202503,15693000,3,1,1,0,1
202503,15693000,3S3,2,3,-1,0.67
202503,15693000,CA,0,15,-15,0
202503,15696000,2,0,15,-15,0
202503,15696000,CA,0,15,-15,0
202503,15720000,2,0,3,-3,0
202503,15720000,CA,0,4,-4,0
202503,15723000,CA,0,2,-2,0
202503,15740000,2,0,6,-6,0
202503,15740000,3S3,0,4,-4,0
202503,15740000,CA,0,6,-6,0
202503,15753000,2,3,60,-57,0.05
202503,15753000,3,0,1,-1,0
202503,15753000,3S2,0,2,-2,0
202503,15753000,3S3,0,10,-10,0
202503,15753000,CA,41,78,-37,0.53
202503,15755000,2,1,10,-9,0.1
202503,15755000,CA,0,3,-3,0
202503,15755000,V3R2,46,0,46,NA
202503,15757000,2,26,62,-36,0.42
202503,15757000,3,24,1,23,24
202503,15757000,3S2,11,0,11,NA
202503,15757000,3S3,918,11,907,83.45
202503,15757000,4,12,2,10,6
202503,15757000,CA,0,23,-23,0
202503,15757000,V2,16,4,12,4
202503,15757000,V2R3,14,0,14,NA
202503,15757000,V3,135,4,131,33.75
202503,15757000,V3R2,5,47,-42,0.11
202503,15757000,V4,34,0,34,NA
202503,15757000,V4R2,91,0,91,NA
202503,15757003,3,1,0,1,NA
202503,15757003,3S3,65,0,65,NA
202503,15757003,4,2,0,2,NA
202503,15757003,V2,4,0,4,NA
202503,15757003,V3,2,0,2,NA
202503,15759000,2,543,2575,-2032,0.21
202503,15759000,2R2,0,10,-10,0
202503,15759000,2S2,39,35,4,1.11
202503,15759000,2S3,6,7,-1,0.86
202503,15759000,3,143,141,2,1.01
202503,15759000,3S1,0,1,-1,0
202503,15759000,3S2,413,110,303,3.75
202503,15759000,3S3,2596,840,1756,3.09
202503,15759000,3S4,1,1,0,1
202503,15759000,4,5,0,5,NA
202503,15759000,CA,49,886,-837,0.06
202503,15759000,V2,39,5,34,7.8
202503,15759000,V3,40,22,18,1.82
202503,15759000,V4,6,34,-28,0.18
202503,15761000,2,0,19,-19,0
202503,15761000,CA,0,4,-4,0
202503,15762000,3S3,0,1,-1,0
202503,15762000,CA,0,3,-3,0
202503,15763000,2,16,21,-5,0.76
202503,15763000,2S3,0,2,-2,0
202503,15763000,3,0,5,-5,0
202503,15763000,3S2,0,30,-30,0
202503,15763000,3S3,0,45,-45,0
202503,15763000,CA,3,22,-19,0.14
202503,15764000,2,10,59,-49,0.17
202503,15764000,2S2,0,1,-1,0
202503,15764000,3,1,1,0,1
202503,15764000,3S2,1,4,-3,0.25
202503,15764000,3S3,1,21,-20,0.05
202503,15764000,CA,1,38,-37,0.03
202503,15774000,2,0,4,-4,0
202503,15774000,CA,0,2,-2,0
202503,15776000,2,2,29,-27,0.07
202503,15776000,2S2,0,1,-1,0
202503,15776000,3S2,0,1,-1,0
202503,15776000,3S3,0,7,-7,0
202503,15776000,CA,0,14,-14,0
202503,15778000,2,0,10,-10,0
202503,15778000,CA,0,7,-7,0
202503,15790000,2,0,9,-9,0
202503,15790000,3,0,1,-1,0
202503,15790000,3S2,1,0,1,NA
202503,15790000,3S3,107,2,105,53.5
202503,15790000,CA,0,13,-13,0
202503,15790000,V2,0,1,-1,0
202503,15790000,V3,13,13,0,1
202503,15790000,V4,2,2,0,1
202503,15798000,2,0,12,-12,0
202503,15798000,3,0,1,-1,0
202503,15798000,CA,0,1,-1,0
202503,15798000,V3,0,2,-2,0
202503,15804000,2,0,21,-21,0
202503,15804000,3S3,0,2,-2,0
202503,15804000,CA,0,17,-17,0
202503,15806000,2,13,321,-308,0.04
202503,15806000,2S2,22,339,-317,0.06
202503,15806000,2S3,11,44,-33,0.25
202503,15806000,3S2,1,9,-8,0.11
202503,15806000,3S3,1365,1034,331,1.32
202503,15806000,CA,8,59,-51,0.14
202503,15808000,2,0,5,-5,0
202503,15808000,CA,0,32,-32,0
202503,15810000,2,1,1,0,1
202503,15810000,3S3,0,2,-2,0
202503,15810000,CA,0,2,-2,0
202503,15814000,2,15,49,-34,0.31
202503,15814000,3S3,0,11,-11,0
202503,15814000,CA,13,12,1,1.08
202503,15816000,2,2,10,-8,0.2
202503,15816000,CA,0,3,-3,0
202503,15820000,2,0,21,-21,0
202503,15820000,3S2,1,0,1,NA
202503,15820000,3S3,409,0,409,NA
202503,15820000,CA,2,4,-2,0.5
202503,15822000,CA,0,2,-2,0
202503,15832000,3S2,1,1,0,1
202503,15832000,CA,0,3,-3,0
202503,15835000,2,0,11,-11,0
202503,15835000,3S3,0,4,-4,0
202503,15835000,CA,0,4,-4,0
202503,15837000,2,321,422,-101,0.76
202503,15837000,2S3,0,1,-1,0
202503,15837000,3,40,64,-24,0.62
202503,15837000,3S1,0,1,-1,0
202503,15837000,3S2,29,51,-22,0.57
202503,15837000,3S3,846,890,-44,0.95
202503,15837000,3S4,1,0,1,NA
202503,15837000,CA,1,23,-22,0.04
202503,15837000,V2,0,24,-24,0
202503,15837000,V3,286,0,286,NA
202503,15839000,2,0,1,-1,0
202503,15839000,3S3,0,1,-1,0
202503,15839000,CA,0,7,-7,0
202503,15842000,2,0,7,-7,0
202503,15842000,3,1,0,1,NA
202503,15842000,3S2,0,2,-2,0
202503,15842000,3S3,0,2,-2,0
202503,15842000,CA,0,10,-10,0
202503,15861000,2,8,49,-41,0.16
202503,15861000,3S2,0,1,-1,0
202503,15861000,3S3,0,12,-12,0
202503,15861000,CA,9,46,-37,0.2
202503,15861002,3S3,0,1,-1,0
202503,15861007,3S3,0,1,-1,0
202503,15861007,CA,0,1,-1,0
202503,15861008,2,1,1,0,1
202503,15861008,3S3,0,1,-1,0
202503,15879000,2,2,3,-1,0.67
202503,15879000,CA,0,2,-2,0
202503,15897000,2,2,9,-7,0.22
202503,15897000,3,0,2,-2,0
202503,15897000,CA,1,4,-3,0.25
202503,17001000,2,4559,6597,-2038,0.69
202503,17001000,2S2,702,919,-217,0.76
202503,17001000,2S3,131,156,-25,0.84
202503,17001000,3,141,146,-5,0.97
202503,17001000,3S1,1,5,-4,0.2
202503,17001000,3S2,393,433,-40,0.91
202503,17001000,3S3,2096,2154,-58,0.97
202503,17001000,3S4,1,3,-2,0.33
202503,17001000,4,8,7,1,1.14
202503,17001000,CA,681,2118,-1437,0.32
202503,17001000,V2,2,0,2,NA
202503,17001002,2,0,2,-2,0
202503,17001013,CA,0,2,-2,0
202503,17001027,2,2,1,1,2
202503,17001027,3S3,0,54,-54,0
202503,17001029,2,0,3,-3,0
202503,17001031,2,0,2,-2,0
202503,17013000,2,44,316,-272,0.14
202503,17013000,3,0,12,-12,0
202503,17013000,CA,2,74,-72,0.03
202503,17013000,V2,0,1,-1,0
202503,17013000,V3,0,1,-1,0
202503,17013001,2,0,1,-1,0
202503,17042000,2,55,193,-138,0.28
202503,17042000,2S2,1,1,0,1
202503,17042000,3,2,3,-1,0.67
202503,17042000,3S2,7,10,-3,0.7
202503,17042000,3S3,59,22,37,2.68
202503,17042000,CA,4,85,-81,0.05
202503,17050000,2,5,84,-79,0.06
202503,17050000,3S3,0,19,-19,0
202503,17050000,CA,0,27,-27,0
202503,17088000,2,6,60,-54,0.1
202503,17088000,2S2,0,1,-1,0
202503,17088000,3S3,0,1,-1,0
202503,17088000,CA,0,13,-13,0
202503,17174000,2,429,610,-181,0.7
202503,17174000,2R2,0,12,-12,0
202503,17174000,2S2,33,66,-33,0.5
202503,17174000,2S3,33,45,-12,0.73
202503,17174000,3,40,7,33,5.71
202503,17174000,3S2,51,25,26,2.04
202503,17174000,3S3,340,505,-165,0.67
202503,17174000,4,44,2,42,22
202503,17174000,CA,12,224,-212,0.05
202503,17272000,2,13,41,-28,0.32
202503,17272000,3S3,0,25,-25,0
202503,17272000,CA,1,23,-22,0.04
202503,17272005,2,0,1,-1,0
202503,17380000,2,749,1083,-334,0.69
202503,17380000,2R2,0,2,-2,0
202503,17380000,2S2,2,15,-13,0.13
202503,17380000,2S3,0,3,-3,0
202503,17380000,3,20,27,-7,0.74
202503,17380000,3S2,17,12,5,1.42
202503,17380000,3S3,100,176,-76,0.57
202503,17380000,3S4,2,1,1,2
202503,17380000,4,0,2,-2,0
202503,17380000,CA,231,226,5,1.02
202503,17380000,V3,0,6,-6,0
202503,17380001,2S2,0,1,-1,0
202503,17380002,2,2,1,1,2
202503,17380002,3S3,10,0,10,NA
202503,17380003,2,1,0,1,NA
202503,17388000,2,1,16,-15,0.06
202503,17388000,CA,0,17,-17,0
202503,17388002,2,1,0,1,NA
202503,17388002,3S2,1,1,0,1
202503,17388002,3S3,0,10,-10,0
202503,17388002,CA,0,3,-3,0
202503,17388008,2,0,3,-3,0
202503,17433000,2,26,88,-62,0.3
202503,17433000,3,4,0,4,NA
202503,17433000,3S3,26,2,24,13
202503,17433000,CA,3,53,-50,0.06
202503,17433000,V3,0,3,-3,0
202503,17442000,2,24,128,-104,0.19
202503,17442000,3,0,17,-17,0
202503,17442000,3S2,0,2,-2,0
202503,17442000,3S3,2,3,-1,0.67
202503,17442000,CA,3,20,-17,0.15
202503,17442002,2,0,1,-1,0
202503,17444000,2,23,83,-60,0.28
202503,17444000,3,0,10,-10,0
202503,17444000,3S3,0,4,-4,0
202503,17444000,CA,0,5,-5,0
202503,17446000,2,3,2,1,1.5
202503,17446000,2S2,0,1,-1,0
202503,17446000,CA,0,7,-7,0
202503,17486000,2,26,129,-103,0.2
202503,17486000,2S2,1,1,0,1
202503,17486000,3,0,11,-11,0
202503,17486000,3S3,0,20,-20,0
202503,17486000,CA,0,78,-78,0
202503,17486001,2,0,1,-1,0
202503,17486009,2,1,0,1,NA
202503,17486012,CA,0,2,-2,0
202503,17495000,2,3,34,-31,0.09
202503,17495000,3,0,1,-1,0
202503,17495000,CA,0,9,-9,0
202503,17495000,V3,0,1,-1,0
202503,17513000,2,65,65,0,1
202503,17513000,3,0,18,-18,0
202503,17513000,CA,1,9,-8,0.11
202503,17513000,V2,0,3,-3,0
202503,17513000,V3,0,4,-4,0
202503,17524000,2,2,88,-86,0.02
202503,17524000,2S2,0,1,-1,0
202503,17524000,3S2,0,1,-1,0
202503,17524000,3S3,0,16,-16,0
202503,17524000,CA,1,63,-62,0.02
202503,17524001,2,14,54,-40,0.26
202503,17524001,2S3,0,1,-1,0
202503,17524001,3,1,0,1,NA
202503,17524001,3S2,0,5,-5,0
202503,17524001,3S3,0,148,-148,0
202503,17524001,CA,0,26,-26,0
202503,17524003,2,0,10,-10,0
202503,17524003,CA,0,1,-1,0
202503,17524006,2,1,7,-6,0.14
202503,17524006,CA,0,1,-1,0
202503,17524008,2,0,2,-2,0
202503,17541000,2,11,120,-109,0.09
202503,17541000,3,1,6,-5,0.17
202503,17541000,3S3,8,17,-9,0.47
202503,17541000,CA,1,76,-75,0.01
202503,17541000,V3,0,1,-1,0
202503,17541002,2,0,8,-8,0
202503,17541002,3,0,1,-1,0
202503,17541002,CA,0,1,-1,0
202503,17541009,2,0,1,-1,0
202503,17614000,2,15,277,-262,0.05
202503,17614000,2R2,0,13,-13,0
202503,17614000,3,1,4,-3,0.25
202503,17614000,3S2,1,2,-1,0.5
202503,17614000,3S3,14,51,-37,0.27
202503,17614000,CA,6,154,-148,0.04
202503,17614004,2,0,18,-18,0
202503,17616000,2,34,53,-19,0.64
202503,17616000,3S3,0,3,-3,0
202503,17616000,4,0,1,-1,0
202503,17616000,CA,0,30,-30,0
202503,17653000,2,8,144,-136,0.06
202503,17653000,2S3,0,1,-1,0
202503,17653000,3,0,2,-2,0
202503,17653000,CA,0,34,-34,0
202503,17653007,2,0,1,-1,0
202503,17662000,2,13,50,-37,0.26
202503,17662000,3,0,13,-13,0
202503,17662000,CA,2,11,-9,0.18
202503,17662000,V3,0,7,-7,0
202503,17662003,2,4,7,-3,0.57
202503,17662003,3,0,6,-6,0
202503,17662003,CA,0,3,-3,0
202503,17662003,V3,0,4,-4,0
202503,17662007,2,0,4,-4,0
202503,17665000,2,1,2,-1,0.5
202503,17665000,CA,0,1,-1,0
202503,17777000,2,5,320,-315,0.02
202503,17777000,2R2,0,12,-12,0
202503,17777000,3S3,2,9,-7,0.22
202503,17777000,CA,1,321,-320,0
202503,17777000,V2,1,0,1,NA
202503,17867000,2,4,31,-27,0.13
202503,17867000,3,0,1,-1,0
202503,17867000,3S3,0,2,-2,0
202503,17867000,CA,1,15,-14,0.07
202503,17867000,V3,0,2,-2,0
202503,17873000,2,4,403,-399,0.01
202503,17873000,2S2,3,6,-3,0.5
202503,17873000,2S3,0,1,-1,0
202503,17873000,3,0,10,-10,0
202503,17873000,3S2,0,6,-6,0
202503,17873000,3S3,1,40,-39,0.03
202503,17873000,CA,5,138,-133,0.04
202503,17873004,2,1,0,1,NA
202503,17873004,2S3,0,1,-1,0
202503,17873004,3,3,0,3,NA
202503,17873004,3S3,3,1,2,3
202503,17873004,4,1,0,1,NA
202503,17873004,CA,0,2,-2,0
202503,17873016,2,0,1,-1,0
202503,17873016,3S3,0,1,-1,0
202503,17877000,2,61,158,-97,0.39
202503,17877000,3,2,12,-10,0.17
202503,17877000,3S2,0,1,-1,0
202503,17877000,3S3,1,19,-18,0.05
202503,17877000,CA,0,61,-61,0
202503,18001000,2,554,1843,-1289,0.3
202503,18001000,2R2,0,4,-4,0
202503,18001000,2S2,2,87,-85,0.02
202503,18001000,2S3,0,4,-4,0
202503,18001000,3,35,92,-57,0.38
202503,18001000,3S2,5,42,-37,0.12
202503,18001000,3S3,38,579,-541,0.07
202503,18001000,CA,67,253,-186,0.26
202503,18001008,2S2,0,1,-1,0
202503,18001013,2,0,1,-1,0
202503,18001013,3,0,2,-2,0
202503,18001013,3S3,1,1,0,1
202503,18029000,2,4,9,-5,0.44
202503,18029000,2S2,1,0,1,NA
202503,18029000,3S3,2,0,2,NA
202503,18029000,CA,0,3,-3,0
202503,18094000,2,2,27,-25,0.07
202503,18094000,2S2,1,1,0,1
202503,18094000,3S3,0,3,-3,0
202503,18094000,CA,0,1,-1,0
202503,18150000,2,28,133,-105,0.21
202503,18150000,2S2,0,1,-1,0
202503,18150000,3,3,21,-18,0.14
202503,18150000,3S2,0,2,-2,0
202503,18150000,3S3,2,34,-32,0.06
202503,18150000,CA,1,17,-16,0.06
202503,18205000,2,2,24,-22,0.08
202503,18205000,3,0,2,-2,0
202503,18205000,3S3,0,2,-2,0
202503,18205000,CA,0,14,-14,0
202503,18247000,2,1,73,-72,0.01
202503,18247000,3,0,1,-1,0
202503,18247000,3S2,1,0,1,NA
202503,18247000,3S3,0,10,-10,0
202503,18247000,CA,0,11,-11,0
202503,18247005,3,0,1,-1,0
202503,18256000,2,6,27,-21,0.22
202503,18256000,2S2,0,1,-1,0
202503,18256000,3,1,1,0,1
202503,18256000,3S3,0,3,-3,0
202503,18410000,2,1,33,-32,0.03
202503,18410000,V3,0,2,-2,0
202503,18460000,2,3,1,2,3
202503,18460001,2,0,1,-1,0
202503,18460001,3,0,1,-1,0
202503,18479000,2,2,1,1,2
202503,18479000,2S2,0,1,-1,0
202503,18479000,3S2,1,1,0,1
202503,18479000,3S3,0,8,-8,0
202503,18592000,2,23,72,-49,0.32
202503,18592000,3,0,5,-5,0
202503,18592000,3S2,0,3,-3,0
202503,18592000,3S3,0,14,-14,0
202503,18592000,CA,0,4,-4,0
202503,18610000,2,2,45,-43,0.04
202503,18610000,2S2,0,1,-1,0
202503,18610000,3S3,0,1,-1,0
202503,18610000,CA,1,2,-1,0.5
202503,18610001,2,0,4,-4,0
202503,18610002,CA,0,1,-1,0
202503,18753000,2,122,464,-342,0.26
202503,18753000,3,1,23,-22,0.04
202503,18753000,3S2,0,1,-1,0
202503,18753000,3S3,6,41,-35,0.15
202503,18753000,CA,1,34,-33,0.03
202503,18753000,V2,0,1,-1,0
202503,18753003,2,0,4,-4,0
202503,18753006,2,0,4,-4,0
202503,18756000,CA,0,2,-2,0
202503,18756008,2,1,7,-6,0.14
202503,18785000,2,10,11,-1,0.91
202503,18785000,3,0,34,-34,0
202503,18785000,3S3,0,3,-3,0
202503,18785000,CA,0,2,-2,0
202503,18860000,2,7,3,4,2.33
202503,18860000,2S2,0,1,-1,0
202503,18860000,3S2,0,2,-2,0
202503,18860000,3S3,0,2,-2,0
202503,18860000,CA,0,1,-1,0
202503,19001000,2,972,3645,-2673,0.27
202503,19001000,2R2,0,40,-40,0
202503,19001000,2S2,13,81,-68,0.16
202503,19001000,2S3,0,15,-15,0
202503,19001000,3,14,134,-120,0.1
202503,19001000,3S1,12,0,12,NA
202503,19001000,3S2,32,99,-67,0.32
202503,19001000,3S3,200,861,-661,0.23
202503,19001000,3S4,1,2,-1,0.5
202503,19001000,CA,416,936,-520,0.44
202503,19001000,V2,2,2,0,1
202503,19001000,V3,3,0,3,NA
202503,19001008,2,1,0,1,NA
202503,19022000,2,1,39,-38,0.03
202503,19050000,2,4,115,-111,0.03
202503,19050000,3,0,4,-4,0
202503,19050000,CA,0,13,-13,0
202503,19050000,V3,0,5,-5,0
202503,19050001,2,1,12,-11,0.08
202503,19050001,3,0,2,-2,0
202503,19050006,2,0,35,-35,0
202503,19050007,2,0,7,-7,0
202503,19050008,2,0,2,-2,0
202503,19050016,2,0,2,-2,0
202503,19075000,2,1,57,-56,0.02
202503,19075000,3S3,1,1,0,1
202503,19075000,CA,1,17,-16,0.06
202503,19075002,2,0,2,-2,0
202503,19100000,2,3,52,-49,0.06
202503,19100000,2S2,0,1,-1,0
202503,19100000,3,0,11,-11,0
202503,19100000,3S2,1,0,1,NA
202503,19100000,3S3,0,8,-8,0
202503,19100000,CA,0,4,-4,0
202503,19110000,2,1,21,-20,0.05
202503,19110000,2S2,0,2,-2,0
202503,19110000,3,0,2,-2,0
202503,19110000,3S3,0,1,-1,0
202503,19110000,CA,0,1,-1,0
202503,19110012,2,0,3,-3,0
202503,19110012,3S3,0,44,-44,0
202503,19110020,2,0,1,-1,0
202503,19130000,2,1,32,-31,0.03
202503,19130000,3,0,10,-10,0
202503,19130000,CA,0,33,-33,0
202503,19137000,2,0,17,-17,0
202503,19137000,3,0,4,-4,0
202503,19137000,CA,0,47,-47,0
202503,19137004,2,3,9,-6,0.33
202503,19137004,CA,1,2,-1,0.5
202503,19142000,2,1744,809,935,2.16
202503,19142000,2B1,0,1,-1,0
202503,19142000,2R2,1,0,1,NA
202503,19142000,2S1,0,3,-3,0
202503,19142000,2S2,176,129,47,1.36
202503,19142000,2S3,31,39,-8,0.79
202503,19142000,3,64,32,32,2
202503,19142000,3S2,237,171,66,1.39
202503,19142000,3S3,759,847,-88,0.9
202503,19142000,3S4,2,0,2,NA
202503,19142000,CA,182,209,-27,0.87
202503,19142004,2S2,0,2,-2,0
202503,19142004,3S2,1,1,0,1
202503,19142006,2,289,113,176,2.56
202503,19142006,2S2,20,6,14,3.33
202503,19142006,2S3,9,5,4,1.8
202503,19142006,3,3,0,3,NA
202503,19142006,3S2,113,51,62,2.22
202503,19142006,3S3,362,189,173,1.92
202503,19142006,CA,0,6,-6,0
202503,19142020,CA,0,2,-2,0
202503,19212000,2,0,135,-135,0
202503,19212000,3,0,5,-5,0
202503,19212000,3S3,1,2,-1,0.5
202503,19212000,CA,0,84,-84,0
202503,19256000,2,0,89,-89,0
202503,19256000,3,1,11,-10,0.09
202503,19256000,3S2,0,1,-1,0
202503,19256000,3S3,0,5,-5,0
202503,19256000,CA,1,16,-15,0.06
202503,19256018,2,0,5,-5,0
202503,19256018,2S2,0,1,-1,0
202503,19256018,3S3,0,2,-2,0
202503,19256018,CA,0,2,-2,0
202503,19290000,2,0,122,-122,0
202503,19290000,3,0,2,-2,0
202503,19290000,3S3,0,8,-8,0
202503,19290000,CA,0,3,-3,0
202503,19300000,2,335,97,238,3.45
202503,19300000,2S2,123,30,93,4.1
202503,19300000,2S3,26,19,7,1.37
202503,19300000,3S2,52,29,23,1.79
202503,19300000,3S3,208,172,36,1.21
202503,19300000,CA,51,11,40,4.64
202503,19300000,V2,0,5,-5,0
202503,19318000,2,0,7,-7,0
202503,19318000,CA,0,7,-7,0
202503,19318010,2,0,1,-1,0
202503,19355000,2,1,16,-15,0.06
202503,19355000,3,0,7,-7,0
202503,19355000,3S3,0,4,-4,0
202503,19355000,CA,0,1,-1,0
202503,19355012,2,4,17,-13,0.24
202503,19355012,3S2,0,1,-1,0
202503,19355012,CA,0,3,-3,0
202503,19364000,2,0,2,-2,0
202503,19364000,CA,0,1,-1,0
202503,19364002,2,0,1,-1,0
202503,19392000,2,1,22,-21,0.05
202503,19392000,CA,0,3,-3,0
202503,19397000,2,0,38,-38,0
202503,19397000,CA,0,7,-7,0
202503,19397002,2,0,1,-1,0
202503,19418000,CA,0,4,-4,0
202503,19418013,2,0,1,-1,0
202503,19418020,3S3,0,10,-10,0
202503,19418033,2,0,1,-1,0
202503,19450000,2,3,60,-57,0.05
202503,19450000,3S3,0,5,-5,0
202503,19450000,CA,0,3,-3,0
202503,19450019,2,1,6,-5,0.17
202503,19455000,2,44,171,-127,0.26
202503,19455000,2R2,0,4,-4,0
202503,19455000,2S2,16,10,6,1.6
202503,19455000,2S3,3,2,1,1.5
202503,19455000,3,4,4,0,1
202503,19455000,3S2,12,5,7,2.4
202503,19455000,3S3,480,113,367,4.25
202503,19455000,CA,1,84,-83,0.01
202503,19455005,2,88,4,84,22
202503,19455005,3S3,187,70,117,2.67
202503,19455005,CA,22,7,15,3.14
202503,19473000,2,1,55,-54,0.02
202503,19473000,3,0,4,-4,0
202503,19473000,3S2,1,2,-1,0.5
202503,19473000,3S3,0,8,-8,0
202503,19473000,CA,0,68,-68,0
202503,19513000,2,1,22,-21,0.05
202503,19513000,CA,0,2,-2,0
202503,19513003,2,0,1,-1,0
202503,19513003,CA,0,3,-3,0
202503,19517000,2,0,11,-11,0
202503,19517000,3,0,1,-1,0
202503,19517000,3S3,0,1,-1,0
202503,19517012,3S3,0,1,-1,0
202503,19517012,CA,0,1,-1,0
202503,19532000,2,7,234,-227,0.03
202503,19532000,2S2,0,1,-1,0
202503,19532000,3,0,2,-2,0
202503,19532000,3S2,3,2,1,1.5
202503,19532000,3S3,0,20,-20,0
202503,19532000,CA,25,53,-28,0.47
202503,19532005,2,2,7,-5,0.29
202503,19532008,2,0,40,-40,0
202503,19532008,3S3,0,2,-2,0
202503,19532008,CA,0,4,-4,0
202503,19532009,3,0,12,-12,0
202503,19532013,2,0,5,-5,0
202503,19532013,2S2,0,1,-1,0
202503,19532013,2S3,0,1,-1,0
202503,19532013,3S3,0,16,-16,0
202503,19532013,CA,0,1,-1,0
202503,19532020,2,1,0,1,NA
202503,19532021,CA,0,2,-2,0
202503,19533000,2,1,13,-12,0.08
202503,19533000,3,1,0,1,NA
202503,19533000,3S2,1,0,1,NA
202503,19533000,CA,1,1,0,1
202503,19548000,2,21,159,-138,0.13
202503,19548000,2R2,0,1,-1,0
202503,19548000,2S2,0,3,-3,0
202503,19548000,3,3,1,2,3
202503,19548000,3S3,0,24,-24,0
202503,19548000,CA,1,52,-51,0.02
202503,19548001,2,0,1,-1,0
202503,19548001,CA,0,1,-1,0
202503,19573000,2,1422,503,919,2.83
202503,19573000,2B1,12,1,11,12
202503,19573000,2R2,7,5,2,1.4
202503,19573000,2S2,230,110,120,2.09
202503,19573000,2S3,29,31,-2,0.94
202503,19573000,3,27,19,8,1.42
202503,19573000,3S2,83,137,-54,0.61
202503,19573000,3S3,1490,489,1001,3.05
202503,19573000,3S4,3,2,1,1.5
202503,19573000,4,0,1,-1,0
202503,19573000,CA,102,157,-55,0.65
202503,19573000,V2,1,0,1,NA
202503,19585000,2,0,11,-11,0
202503,19585000,CA,0,5,-5,0
202503,19585001,2,0,5,-5,0
202503,19585001,CA,0,3,-3,0
202503,19585004,2,0,7,-7,0
202503,19585004,CA,0,2,-2,0
202503,19622000,2,2,25,-23,0.08
202503,19622000,2S2,1,0,1,NA
202503,19622000,3S2,1,0,1,NA
202503,19622000,CA,0,25,-25,0
202503,19693000,2,0,6,-6,0
202503,19693001,2,0,1,-1,0
202503,19698000,2,661,1482,-821,0.45
202503,19698000,2B1,4,0,4,NA
202503,19698000,2R2,0,1,-1,0
202503,19698000,2S1,0,4,-4,0
202503,19698000,2S2,199,80,119,2.49
202503,19698000,2S3,39,20,19,1.95
202503,19698000,3,14,91,-77,0.15
202503,19698000,3S1,0,2,-2,0
202503,19698000,3S2,104,73,31,1.42
202503,19698000,3S3,225,554,-329,0.41
202503,19698000,3S4,2,3,-1,0.67
202503,19698000,4,0,1,-1,0
202503,19698000,CA,28,571,-543,0.05
202503,19698000,V2,3,0,3,NA
202503,19698000,V3,2,0,2,NA
202503,19698007,2,13,42,-29,0.31
202503,19698007,2S2,0,1,-1,0
202503,19698007,3,0,1,-1,0
202503,19698007,3S3,0,1,-1,0
202503,19698007,CA,1,21,-20,0.05
202503,19698020,2,0,1,-1,0
202503,19698036,2,1,0,1,NA
202503,19698036,CA,1,0,1,NA
202503,19701000,2,3,6,-3,0.5
202503,19701000,3,0,1,-1,0
202503,19701000,3S2,2,0,2,NA
202503,19701000,3S3,0,4,-4,0
202503,19701000,3S4,1,1,0,1
202503,19701006,2,0,2,-2,0
202503,19701006,V2,2,0,2,NA
202503,19743000,2,0,43,-43,0
202503,19743000,3,0,1,-1,0
202503,19743000,CA,0,22,-22,0
202503,19760000,2,0,2,-2,0
202503,19780000,2,2,84,-82,0.02
202503,19780000,2S2,1,1,0,1
202503,19780000,3,1,13,-12,0.08
202503,19780000,3S3,0,5,-5,0
202503,19780000,3S4,0,4,-4,0
202503,19780000,CA,1,23,-22,0.04
202503,19780001,2,0,4,-4,0
202503,19780009,2,0,1,-1,0
202503,19785000,2,1,12,-11,0.08
202503,19785001,CA,0,2,-2,0
202503,19785011,3S3,1,0,1,NA
202503,19807000,2,12,192,-180,0.06
202503,19807000,2S2,0,2,-2,0
202503,19807000,2S3,0,1,-1,0
202503,19807000,3S3,3,7,-4,0.43
202503,19807000,CA,1,73,-72,0.01
202503,19807009,2,1,2,-1,0.5
202503,19807012,2,0,2,-2,0
202503,19809000,2,0,1,-1,0
202503,19809000,CA,0,4,-4,0
202503,19821000,2,0,31,-31,0
202503,19821000,CA,0,2,-2,0
202503,19821007,2,0,3,-3,0
202503,19824000,2,1,12,-11,0.08
202503,19824000,CA,0,1,-1,0
202503,19845000,2,1867,493,1374,3.79
202503,19845000,2S2,523,123,400,4.25
202503,19845000,2S3,49,37,12,1.32
202503,19845000,3,24,5,19,4.8
202503,19845000,3S1,4,0,4,NA
202503,19845000,3S2,133,246,-113,0.54
202503,19845000,3S3,167,763,-596,0.22
202503,19845000,4,2,0,2,NA
202503,19845000,CA,139,166,-27,0.84
202503,20001000,2,3103,5586,-2483,0.56
202503,20001000,2B1,0,3,-3,0
202503,20001000,2R2,97,8,89,12.12
202503,20001000,2S1,0,1,-1,0
202503,20001000,2S2,28,218,-190,0.13
202503,20001000,2S3,15,125,-110,0.12
202503,20001000,3,51,181,-130,0.28
202503,20001000,3S1,0,1,-1,0
202503,20001000,3S2,145,421,-276,0.34
202503,20001000,3S3,426,1814,-1388,0.23
202503,20001000,3S4,3,0,3,NA
202503,20001000,4,0,14,-14,0
202503,20001000,CA,376,650,-274,0.58
202503,20001001,2,2,3,-1,0.67
202503,20001001,3S3,2,2,0,1
202503,20001002,2,0,4,-4,0
202503,20001003,2,1,3,-2,0.33
202503,20001003,3S3,0,2,-2,0
202503,20001005,2,0,5,-5,0
202503,20001005,3S3,1,2,-1,0.5
202503,20001009,2,0,2,-2,0
202503,20001012,2,5,0,5,NA
202503,20001012,3S3,0,1,-1,0
202503,20001013,2,16,15,1,1.07
202503,20001013,2S2,4,0,4,NA
202503,20001013,3S2,1,0,1,NA
202503,20001013,3S3,3,0,3,NA
202503,20001013,V2,0,1,-1,0
202503,20001013,V3R3,7,0,7,NA
202503,20001014,3S2,0,1,-1,0
202503,20001018,2,6,7,-1,0.86
202503,20001018,2S2,0,1,-1,0
202503,20001018,2S3,0,1,-1,0
202503,20001018,3S2,0,1,-1,0
202503,20001018,3S3,2,4,-2,0.5
202503,20001018,CA,0,1,-1,0
202503,20001025,2,3,0,3,NA
202503,20001025,3S2,2,0,2,NA
202503,20001027,3,0,1,-1,0
202503,20001031,2,6,6,0,1
202503,20001031,CA,0,1,-1,0
202503,20001032,2,0,6,-6,0
202503,20001039,2,0,1,-1,0
202503,20011000,2,362,1640,-1278,0.22
202503,20011000,2S2,2,11,-9,0.18
202503,20011000,2S3,0,19,-19,0
202503,20011000,3,23,136,-113,0.17
202503,20011000,3S2,299,244,55,1.23
202503,20011000,3S2S3,0,1,-1,0
202503,20011000,3S3,349,4219,-3870,0.08
202503,20011000,3S4,7,3,4,2.33
202503,20011000,CA,69,199,-130,0.35
202503,20011000,V3,32,11,21,2.91
202503,20011000,V4,0,88,-88,0
202503,20011010,3S3,0,15,-15,0
202503,20011014,2,0,1,-1,0
202503,20011014,3S3,0,1,-1,0
202503,20011021,2,0,13,-13,0
202503,20013000,2,74,360,-286,0.21
202503,20013000,2S2,3,0,3,NA
202503,20013000,2S3,0,1,-1,0
202503,20013000,3,1,1,0,1
202503,20013000,3S2,28,3,25,9.33
202503,20013000,3S3,409,656,-247,0.62
202503,20013000,3S4,0,2,-2,0
202503,20013000,CA,24,66,-42,0.36
202503,20013002,2,1,13,-12,0.08
202503,20032000,2,9,62,-53,0.15
202503,20032000,2S2,2,0,2,NA
202503,20032000,2S3,0,1,-1,0
202503,20032000,3S2,0,2,-2,0
202503,20032000,3S3,2,13,-11,0.15
202503,20032000,CA,0,7,-7,0
202503,20032001,2,0,2,-2,0
202503,20032001,3S3,5,2,3,2.5
202503,20032001,3S4,1,0,1,NA
202503,20045000,2,39,149,-110,0.26
202503,20045000,2S2,1,0,1,NA
202503,20045000,2S3,2,0,2,NA
202503,20045000,3S2,0,1,-1,0
202503,20045000,3S3,1,78,-77,0.01
202503,20045000,3S4,0,1,-1,0
202503,20045000,CA,0,19,-19,0
202503,20045001,2,1,2,-1,0.5
202503,20060000,2,311,404,-93,0.77
202503,20060000,2R2,0,1,-1,0
202503,20060000,2S1,0,1,-1,0
202503,20060000,2S2,5,16,-11,0.31
202503,20060000,2S3,4,10,-6,0.4
202503,20060000,3,53,14,39,3.79
202503,20060000,3S1,0,12,-12,0
202503,20060000,3S2,34,197,-163,0.17
202503,20060000,3S2S3,1,0,1,NA
202503,20060000,3S3,179,256,-77,0.7
202503,20060000,3S4,2,1,1,2
202503,20060000,CA,35,38,-3,0.92
202503,20060000,V2,0,7,-7,0
202503,20060000,V3,4,5,-1,0.8
202503,20060004,2,0,1,-1,0
202503,20060004,3S3,1,0,1,NA
202503,20175000,2,14,59,-45,0.24
202503,20175000,3,0,1,-1,0
202503,20175000,3S3,1,7,-6,0.14
202503,20175000,CA,0,8,-8,0
202503,20175009,2,0,1,-1,0
202503,20175010,2,0,1,-1,0
202503,20175010,3S3,2,3,-1,0.67
202503,20175011,CA,1,9,-8,0.11
202503,20175016,2,1,1,0,1
202503,20175016,3S3,1,1,0,1
202503,20178000,2,29,95,-66,0.31
202503,20178000,3,0,4,-4,0
202503,20178000,3S2,0,11,-11,0
202503,20178000,3S3,4,30,-26,0.13
202503,20178000,3S4,1,0,1,NA
202503,20178000,CA,1,6,-5,0.17
202503,20178006,3S3,1,3,-2,0.33
202503,20178008,2,1,2,-1,0.5
202503,20178008,3S3,0,2,-2,0
202503,20178014,2,3,0,3,NA
202503,20178014,3S3,0,1,-1,0
202503,20178018,2,0,1,-1,0
202503,20228000,2,69,332,-263,0.21
202503,20228000,2S2,1,0,1,NA
202503,20228000,2S3,1,0,1,NA
202503,20228000,3,2,6,-4,0.33
202503,20228000,3S2,2,2,0,1
202503,20228000,3S3,32,67,-35,0.48
202503,20228000,3S4,0,3,-3,0
202503,20228000,CA,1,21,-20,0.05
202503,20228001,2,0,1,-1,0
202503,20228002,2,2,0,2,NA
202503,20228002,3S2,0,1,-1,0
202503,20228002,3S3,34,48,-14,0.71
202503,20228003,2,0,1,-1,0
202503,20228006,2,0,1,-1,0
202503,20228006,2S2,0,1,-1,0
202503,20228010,2,1,3,-2,0.33
202503,20228011,3S3,0,1,-1,0
202503,20238000,2,22,154,-132,0.14
202503,20238000,2S2,1,1,0,1
202503,20238000,2S3,0,1,-1,0
202503,20238000,3S2,3,2,1,1.5
202503,20238000,3S3,112,47,65,2.38
202503,20238000,CA,0,10,-10,0
202503,20238002,3S3,0,2,-2,0
202503,20238003,2,0,3,-3,0
202503,20238003,3,0,1,-1,0
202503,20238003,CA,0,1,-1,0
202503,20250000,2,20,122,-102,0.16
202503,20250000,2S2,5,2,3,2.5
202503,20250000,2S3,2,0,2,NA
202503,20250000,3S2,0,3,-3,0
202503,20250000,3S3,59,200,-141,0.3
202503,20250000,3S4,1,6,-5,0.17
202503,20250000,CA,0,14,-14,0
202503,20250001,2,0,2,-2,0
202503,20250001,3S3,0,1,-1,0
202503,20250002,2,74,144,-70,0.51
202503,20250002,2R2,0,1,-1,0
202503,20250002,2S2,2,6,-4,0.33
202503,20250002,2S3,0,3,-3,0
202503,20250002,3,0,2,-2,0
202503,20250002,3S2,1,5,-4,0.2
202503,20250002,3S3,104,472,-368,0.22
202503,20250002,3S4,0,4,-4,0
202503,20250002,CA,4,16,-12,0.25
202503,20250002,V3,0,1,-1,0
202503,20250002,V3R3,3,0,3,NA
202503,20250003,2,0,1,-1,0
202503,20250003,3S3,2,3,-1,0.67
202503,20250004,2,3,8,-5,0.38
202503,20250004,3S2,15,0,15,NA
202503,20250004,3S3,0,90,-90,0
202503,20295000,2,13,96,-83,0.14
202503,20295000,2S2,0,3,-3,0
202503,20295000,2S3,0,2,-2,0
202503,20295000,3,1,0,1,NA
202503,20295000,3S2,0,2,-2,0
202503,20295000,3S3,24,92,-68,0.26
202503,20295000,CA,0,10,-10,0
202503,20295000,V2,0,10,-10,0
202503,20295000,V3,0,38,-38,0
202503,20295000,V4,0,60,-60,0
202503,20295005,3S2,0,1,-1,0
202503,20295005,3S3,1,1,0,1
202503,20310000,2,0,2,-2,0
202503,20383000,2,2,56,-54,0.04
202503,20383000,2S2,0,1,-1,0
202503,20383000,2S3,4,0,4,NA
202503,20383000,3,18,1,17,18
202503,20383000,3S1,0,1,-1,0
202503,20383000,3S2,9,38,-29,0.24
202503,20383000,3S3,318,1936,-1618,0.16
202503,20383000,CA,1,4,-3,0.25
202503,20383000,V3,0,32,-32,0
202503,20383001,2,0,3,-3,0
202503,20383001,3S2,2,25,-23,0.08
202503,20383001,3S3,79,714,-635,0.11
202503,20383005,2,0,1,-1,0
202503,20383006,2,13,0,13,NA
202503,20383006,3,0,2,-2,0
202503,20383006,3S3,0,7,-7,0
202503,20383010,2,3,6,-3,0.5
202503,20383010,2S2,0,4,-4,0
202503,20383010,2S3,0,1,-1,0
202503,20383010,3S3,19,108,-89,0.18
202503,20383010,CA,0,1,-1,0
202503,20400000,2,60,292,-232,0.21
202503,20400000,2S2,32,33,-1,0.97
202503,20400000,2S3,6,7,-1,0.86
202503,20400000,3,0,5,-5,0
202503,20400000,3S2,23,178,-155,0.13
202503,20400000,3S3,556,428,128,1.3
202503,20400000,CA,6,55,-49,0.11
202503,20400000,V3,0,4,-4,0
202503,20400001,2,0,2,-2,0
202503,20400002,2,0,15,-15,0
202503,20400002,3S3,0,1,-1,0
202503,20443000,2,5,45,-40,0.11
202503,20443000,3,0,4,-4,0
202503,20443000,3S3,3,4,-1,0.75
202503,20517000,2,47,110,-63,0.43
202503,20517000,2S3,1,3,-2,0.33
202503,20517000,3,1,2,-1,0.5
202503,20517000,3S2,0,1,-1,0
202503,20517000,3S3,5,17,-12,0.29
202503,20517000,CA,2,4,-2,0.5
202503,20517000,V2,1,0,1,NA
202503,20517001,2,0,4,-4,0
202503,20517002,2,0,1,-1,0
202503,20517004,2,0,1,-1,0
202503,20517006,3,0,1,-1,0
202503,20517006,3S4,0,1,-1,0
202503,20550000,2,59,139,-80,0.42
202503,20550000,2R2,0,5,-5,0
202503,20550000,2S2,2,0,2,NA
202503,20550000,2S3,4,1,3,4
202503,20550000,3,1,12,-11,0.08
202503,20550000,3S2,2,9,-7,0.22
202503,20550000,3S3,5,101,-96,0.05
202503,20550000,3S4,0,1,-1,0
202503,20550000,CA,4,7,-3,0.57
202503,20550007,2,0,1,-1,0
202503,20570000,2,4,114,-110,0.04
202503,20570000,2S3,0,1,-1,0
202503,20570000,3S3,8,4,4,2
202503,20570000,CA,0,2,-2,0
202503,20570002,2,0,1,-1,0
202503,20614000,2,23,33,-10,0.7
202503,20614000,2S3,0,1,-1,0
202503,20614000,3,0,15,-15,0
202503,20614000,3S1,2,0,2,NA
202503,20614000,3S2,2,0,2,NA
202503,20614000,3S3,43,19,24,2.26
202503,20614000,3S4,2,4,-2,0.5
202503,20614000,CA,3,1,2,3
202503,20614004,2,1,0,1,NA
202503,20614004,CA,1,0,1,NA
202503,20614006,3S3,18,0,18,NA
202503,20614012,2,0,2,-2,0
202503,20614012,3S2,6,12,-6,0.5
202503,20614012,3S3,18,47,-29,0.38
202503,20614012,3S4,0,11,-11,0
202503,20614012,CA,0,1,-1,0
202503,20621000,2,151,178,-27,0.85
202503,20621000,2S2,0,1,-1,0
202503,20621000,2S3,11,3,8,3.67
202503,20621000,3,9,3,6,3
202503,20621000,3S2,13,10,3,1.3
202503,20621000,3S3,176,347,-171,0.51
202503,20621000,CA,0,31,-31,0
202503,20621006,2,0,1,-1,0
202503,20621006,3S3,0,1,-1,0
202503,20621011,2,0,1,-1,0
202503,20621011,3S3,0,1,-1,0
202503,20621012,2,0,1,-1,0
202503,20710000,2,165,174,-9,0.95
202503,20710000,2S2,57,0,57,NA
202503,20710000,3,3,48,-45,0.06
202503,20710000,3S2,31,4,27,7.75
202503,20710000,3S3,292,104,188,2.81
202503,20710000,3S4,1,0,1,NA
202503,20710000,4,0,2,-2,0
202503,20710000,CA,2,53,-51,0.04
202503,20710000,V3R3,8,0,8,NA
202503,20710001,2S3,18,0,18,NA
202503,20710001,3S3,3,0,3,NA
202503,20750000,2,15,72,-57,0.21
202503,20750000,2S3,2,0,2,NA
202503,20750000,3,1,1,0,1
202503,20750000,3S2,1,1,0,1
202503,20750000,3S3,3,4,-1,0.75
202503,20750000,CA,0,15,-15,0
202503,20750002,2,0,12,-12,0
202503,20770000,2,28,132,-104,0.21
202503,20770000,2R2,0,25,-25,0
202503,20770000,2S2,0,5,-5,0
202503,20770000,2S3,0,3,-3,0
202503,20770000,3,4,9,-5,0.44
202503,20770000,3S1,0,1,-1,0
202503,20770000,3S2,71,4,67,17.75
202503,20770000,3S3,1833,68,1765,26.96
202503,20770000,3S4,10,0,10,NA
202503,20770000,CA,6,38,-32,0.16
202503,20770000,V3,1,2,-1,0.5
202503,20770003,3S3,2,1,1,2
202503,20770010,2S3,1,0,1,NA
202503,20770010,3,0,2,-2,0
202503,20770014,2,30,4,26,7.5
202503,20770014,2S2,1,1,0,1
202503,20770014,3,2,2,0,1
202503,20770014,3S2,10,3,7,3.33
202503,20770014,3S3,918,7,911,131.14
202503,20770014,CA,4,10,-6,0.4
202503,20787000,2,6,21,-15,0.29
202503,20787000,3S2,1,1,0,1
202503,20787000,3S3,0,9,-9,0
202503,20787000,3S4,0,1,-1,0
202503,20787000,CA,0,1,-1,0
202503,20787005,2,0,1,-1,0
202503,20787005,CA,2,0,2,NA
202503,23001000,2,2749,4945,-2196,0.56
202503,23001000,2B1,0,1,-1,0
202503,23001000,2R2,1,108,-107,0.01
202503,23001000,2S2,35,265,-230,0.13
202503,23001000,2S3,10,70,-60,0.14
202503,23001000,3,23,219,-196,0.11
202503,23001000,3S2,188,638,-450,0.29
202503,23001000,3S3,540,1777,-1237,0.3
202503,23001000,3S4,0,2,-2,0
202503,23001000,4,1,5,-4,0.2
202503,23001000,CA,903,640,263,1.41
202503,23001001,2,0,7,-7,0
202503,23001004,2,0,4,-4,0
202503,23001004,3,0,3,-3,0
202503,23001008,2,0,1,-1,0
202503,23001010,2,2,0,2,NA
202503,23001010,3,0,3,-3,0
202503,23001014,2,0,2,-2,0
202503,23001017,2,0,10,-10,0
202503,23001019,3,3,0,3,NA
202503,23001020,2,0,3,-3,0
202503,23001020,3S2,0,3,-3,0
202503,23001031,2,1,0,1,NA
202503,23001031,3S2,1,0,1,NA
202503,23001032,3,0,1,-1,0
202503,23001032,3S2,0,1,-1,0
202503,23001068,3S2,0,1,-1,0
202503,23068000,2,38,88,-50,0.43
202503,23068000,2R2,0,3,-3,0
202503,23068000,2S2,1,0,1,NA
202503,23068000,2S3,3,0,3,NA
202503,23068000,3,1,10,-9,0.1
202503,23068000,3S2,2,9,-7,0.22
202503,23068000,3S3,0,33,-33,0
202503,23068000,4,0,1,-1,0
202503,23068000,CA,0,15,-15,0
202503,23068012,3,0,1,-1,0
202503,23068014,2,1,4,-3,0.25
202503,23068014,2R2,0,1,-1,0
202503,23068014,3,0,5,-5,0
202503,23068014,CA,0,1,-1,0
202503,23068014,V3,0,35,-35,0
202503,23079000,2,65,39,26,1.67
202503,23079000,2R2,0,2,-2,0
202503,23079000,2S3,1,0,1,NA
202503,23079000,3,0,2,-2,0
202503,23079000,3S2,1,0,1,NA
202503,23079000,3S3,11,58,-47,0.19
202503,23079000,CA,0,2,-2,0
202503,23079007,2,0,1,-1,0
202503,23090000,2,95,24,71,3.96
202503,23090000,2S2,1,0,1,NA
202503,23090000,3,1,2,-1,0.5
202503,23090000,3S2,3,0,3,NA
202503,23090000,CA,0,2,-2,0
202503,23090002,2,0,1,-1,0
202503,23090002,2S3,0,1,-1,0
202503,23090020,3S3,56,0,56,NA
202503,23090022,3R3,1,0,1,NA
202503,23090022,3S2,8,0,8,NA
202503,23090022,3S3,1127,0,1127,NA
202503,23162000,2,1191,1156,35,1.03
202503,23162000,2R2,293,1,292,293
202503,23162000,2S2,4,53,-49,0.08
202503,23162000,2S3,13,12,1,1.08
202503,23162000,3,53,80,-27,0.66
202503,23162000,3S2,5,104,-99,0.05
202503,23162000,3S3,343,1012,-669,0.34
202503,23162000,3S4,1,0,1,NA
202503,23162000,4,1,5,-4,0.2
202503,23162000,CA,57,188,-131,0.3
202503,23162002,2,0,1,-1,0
202503,23162002,3,0,9,-9,0
202503,23162003,2,0,4,-4,0
202503,23162006,2,1,0,1,NA
202503,23162012,2,0,1,-1,0
202503,23162015,2,0,1,-1,0
202503,23168000,2,1,3,-2,0.33
202503,23168000,CA,0,1,-1,0
202503,23168004,2,0,1,-1,0
202503,23168004,3S2,2,0,2,NA
202503,23168004,3S3,83,0,83,NA
202503,23168016,2,1,0,1,NA
202503,23182000,2,28,148,-120,0.19
202503,23182000,2R2,0,2,-2,0
202503,23182000,2S2,1,2,-1,0.5
202503,23182000,3,0,12,-12,0
202503,23182000,3S2,4,1,3,4
202503,23182000,3S3,9,7,2,1.29
202503,23182000,CA,6,12,-6,0.5
202503,23182000,V3,1,0,1,NA
202503,23182020,2,0,1,-1,0
202503,23182020,2S2,0,1,-1,0
202503,23189000,2,1229,666,563,1.85
202503,23189000,2R2,0,1,-1,0
202503,23189000,2S2,5,4,1,1.25
202503,23189000,2S3,0,5,-5,0
202503,23189000,3,54,30,24,1.8
202503,23189000,3S2,120,124,-4,0.97
202503,23189000,3S3,236,1013,-777,0.23
202503,23189000,3S4,6,0,6,NA
202503,23189000,CA,6,45,-39,0.13
202503,23189000,V3,35,1,34,35
202503,23189001,2,0,2,-2,0
202503,23189001,3,0,2,-2,0
202503,23189001,3S2,0,1,-1,0
202503,23300000,2,1,37,-36,0.03
202503,23300000,3,0,2,-2,0
202503,23300000,3S3,0,1,-1,0
202503,23300000,4,0,1,-1,0
202503,23300000,CA,0,5,-5,0
202503,23300001,2,0,1,-1,0
202503,23350000,2,33,21,12,1.57
202503,23350000,2S3,1,2,-1,0.5
202503,23350000,3,1,0,1,NA
202503,23350000,3S2,1,5,-4,0.2
202503,23350000,3S3,2,24,-22,0.08
202503,23350000,4,1,0,1,NA
202503,23350000,CA,0,5,-5,0
202503,23417000,2,54,541,-487,0.1
202503,23417000,2R2,0,7,-7,0
202503,23417000,2S2,2,7,-5,0.29
202503,23417000,2S3,0,1,-1,0
202503,23417000,3,2,15,-13,0.13
202503,23417000,3S2,35,23,12,1.52
202503,23417000,3S3,23,113,-90,0.2
202503,23417000,3S4,0,1,-1,0
202503,23417000,4,0,1,-1,0
202503,23417000,CA,6,80,-74,0.07
202503,23417003,2,0,2,-2,0
202503,23417004,2,0,2,-2,0
202503,23417006,2,0,3,-3,0
202503,23417006,3,0,3,-3,0
202503,23417007,2,0,1,-1,0
202503,23417010,2,1,6,-5,0.17
202503,23417014,3S3,0,1,-1,0
202503,23417015,2,0,1,-1,0
202503,23417016,2,11,1,10,11
202503,23417016,3,0,34,-34,0
202503,23417016,3S3,11,1,10,11
202503,23417016,CA,1,0,1,NA
202503,23417023,2,0,1,-1,0
202503,23417024,2,0,1,-1,0
202503,23417034,3,0,1,-1,0
202503,23417036,3,0,1,-1,0
202503,23417036,3S3,0,2,-2,0
202503,23419000,2,24,24,0,1
202503,23419000,3,1,0,1,NA
202503,23419000,3S2,0,3,-3,0
202503,23419000,4,0,1,-1,0
202503,23419000,CA,0,4,-4,0
202503,23464000,2,15,22,-7,0.68
202503,23464000,2S3,1,0,1,NA
202503,23464000,3S3,0,24,-24,0
202503,23464000,CA,0,7,-7,0
202503,23464001,2,0,20,-20,0
202503,23464001,2S3,0,12,-12,0
202503,23466000,2,67,385,-318,0.17
202503,23466000,2R2,0,5,-5,0
202503,23466000,2S2,0,4,-4,0
202503,23466000,2S3,1,1,0,1
202503,23466000,3,1,40,-39,0.03
202503,23466000,3S2,4,23,-19,0.17
202503,23466000,3S3,521,2951,-2430,0.18
202503,23466000,3S4,3,2,1,1.5
202503,23466000,4,0,1,-1,0
202503,23466000,CA,1,114,-113,0.01
202503,23466000,V3,0,6,-6,0
202503,23466000,V4,92,0,92,NA
202503,23466001,3,0,2,-2,0
202503,23466005,3,1,0,1,NA
202503,23466006,2,0,1,-1,0
202503,23466006,3S2,5,0,5,NA
202503,23466006,3S3,264,0,264,NA
202503,23466007,2,1,1,0,1
202503,23466007,2S3,2,0,2,NA
202503,23466007,3,0,1,-1,0
202503,23466013,2,0,1,-1,0
202503,23500000,2,3,44,-41,0.07
202503,23500000,2R2,0,1,-1,0
202503,23500000,3,0,16,-16,0
202503,23500000,3S2,1,4,-3,0.25
202503,23500000,3S3,5,5,0,1
202503,23500000,CA,0,13,-13,0
202503,23500006,2,0,4,-4,0
202503,23500011,2,0,1,-1,0
202503,23555000,2,203,385,-182,0.53
202503,23555000,2R2,0,2,-2,0
202503,23555000,2S2,10,7,3,1.43
202503,23555000,2S3,4,1,3,4
202503,23555000,3,35,19,16,1.84
202503,23555000,3S2,14,38,-24,0.37
202503,23555000,3S3,2304,311,1993,7.41
202503,23555000,CA,7,47,-40,0.15
202503,23555004,2,1,0,1,NA
202503,23555011,2,0,2,-2,0
202503,23555022,2,0,6,-6,0
202503,23570000,2,47,87,-40,0.54
202503,23570000,2R2,0,1,-1,0
202503,23570000,2S1,1,1,0,1
202503,23570000,2S2,0,4,-4,0
202503,23570000,2S3,0,2,-2,0
202503,23570000,3,2,32,-30,0.06
202503,23570000,3S1,1,4,-3,0.25
202503,23570000,3S2,5,7,-2,0.71
202503,23570000,3S3,7,28,-21,0.25
202503,23570000,3S4,0,5,-5,0
202503,23570000,4,2,2,0,1
202503,23570000,CA,0,4,-4,0
202503,23570004,2,1,0,1,NA
202503,23570011,2,0,52,-52,0
202503,23570011,2S2,0,53,-53,0
202503,23570011,2S3,0,27,-27,0
202503,23570011,3,0,2,-2,0
202503,23570011,3S3,0,2,-2,0
202503,23570011,CA,0,2,-2,0
202503,23570013,2,102,8,94,12.75
202503,23570013,3,47,2,45,23.5
202503,23570013,3S2,0,4,-4,0
202503,23570013,3S3,0,9,-9,0
202503,23570013,CA,1,0,1,NA
202503,23574000,2,15,17,-2,0.88
202503,23574000,3,1,2,-1,0.5
202503,23574000,3S3,0,6,-6,0
202503,23574000,CA,1,8,-7,0.12
202503,23580000,2,48,125,-77,0.38
202503,23580000,2R2,0,8,-8,0
202503,23580000,2S3,1,1,0,1
202503,23580000,3,1,31,-30,0.03
202503,23580000,3R3,7,1,6,7
202503,23580000,3S2,137,20,117,6.85
202503,23580000,3S3,3361,1670,1691,2.01
202503,23580000,3S4,2,3,-1,0.67
202503,23580000,4,0,1,-1,0
202503,23580000,CA,1,28,-27,0.04
202503,23580000,V3,9,0,9,NA
202503,23580002,3S2,4,0,4,NA
202503,23580002,3S3,332,0,332,NA
202503,23580003,3,0,1,-1,0
202503,23580003,3S3,1,0,1,NA
202503,23580004,3,0,1,-1,0
202503,23580006,3,1,0,1,NA
202503,23580006,3S2,1,0,1,NA
202503,23580006,3S3,81,0,81,NA
202503,23580013,3S3,1,0,1,NA
202503,23586000,2,2,7,-5,0.29
202503,23586000,3,0,2,-2,0
202503,23586000,CA,0,1,-1,0
202503,23660000,2,203,356,-153,0.57
202503,23660000,2R2,0,3,-3,0
202503,23660000,2S2,5,0,5,NA
202503,23660000,2S3,13,1,12,13
202503,23660000,3,29,29,0,1
202503,23660000,3S1,0,2,-2,0
202503,23660000,3S2,5,5,0,1
202503,23660000,3S3,596,92,504,6.48
202503,23660000,3S4,42,6,36,7
202503,23660000,4,2,2,0,1
202503,23660000,CA,4,63,-59,0.06
202503,23660000,V3,0,1,-1,0
202503,23660004,2,0,5,-5,0
202503,23660005,2,4,4,0,1
202503,23660005,2S2,3,1,2,3
202503,23660005,3,0,7,-7,0
202503,23660005,3S1,0,2,-2,0
202503,23660005,3S3,0,2,-2,0
202503,23660005,3S4,4,0,4,NA
202503,23660005,4,1,0,1,NA
202503,23660005,CA,0,1,-1,0
202503,23660006,2,1,1,0,1
202503,23660006,3,0,3,-3,0
202503,23660006,3S3,0,2,-2,0
202503,23660006,3S4,0,1,-1,0
202503,23660008,2,1,6,-5,0.17
202503,23660008,3S2,1,0,1,NA
202503,23660008,3S3,2,13,-11,0.15
202503,23660009,2,1,0,1,NA
202503,23660009,3,0,1,-1,0
202503,23660015,2,4,0,4,NA
202503,23660015,2S1,1,1,0,1
202503,23660015,2S2,3,0,3,NA
202503,23660015,2S3,2,0,2,NA
202503,23660015,3S1,6,1,5,6
202503,23660015,3S2,2,0,2,NA
202503,23660015,3S3,2,0,2,NA
202503,23670000,2,2,86,-84,0.02
202503,23670000,2R2,0,1,-1,0
202503,23670000,3,0,2,-2,0
202503,23670000,3S3,2,1,1,2
202503,23670000,CA,0,3,-3,0
202503,23670011,2,0,4,-4,0
202503,23670011,3S3,0,1,-1,0
202503,23670018,2,0,1,-1,0
202503,23672000,2,6,60,-54,0.1
202503,23672000,2R2,0,2,-2,0
202503,23672000,3,0,6,-6,0
202503,23672000,3S2,1,0,1,NA
202503,23672000,3S3,0,2,-2,0
202503,23672000,CA,1,17,-16,0.06
202503,23675000,2,14,86,-72,0.16
202503,23675000,2S2,1,1,0,1
202503,23675000,2S3,1,0,1,NA
202503,23675000,3,0,18,-18,0
202503,23675000,3S2,0,2,-2,0
202503,23675000,3S3,0,10,-10,0
202503,23675000,CA,0,1,-1,0
202503,23675001,2,0,1,-1,0
202503,23675001,3,0,4,-4,0
202503,23675003,CA,0,1,-1,0
202503,23675018,2,0,2,-2,0
202503,23675019,2,0,2,-2,0
202503,23678000,2,13,29,-16,0.45
202503,23678000,3,0,2,-2,0
202503,23678000,3S2,1,1,0,1
202503,23678000,V3,0,1,-1,0
202503,23678002,2,0,1,-1,0
202503,23678002,3,3,1,2,3
202503,23678015,2,0,1,-1,0
202503,23682000,2,16,10,6,1.6
202503,23682000,3,0,3,-3,0
202503,23682000,3S2,0,1,-1,0
202503,23682000,3S3,0,4,-4,0
202503,23686000,2,20,27,-7,0.74
202503,23686000,2R2,0,1,-1,0
202503,23686000,2S3,0,1,-1,0
202503,23686000,3,1,2,-1,0.5
202503,23686000,3S3,2,2,0,1
202503,23686000,CA,1,4,-3,0.25
202503,23686002,2,0,1,-1,0
202503,23686003,2,0,1,-1,0
202503,23686003,2R2,0,2,-2,0
202503,23686003,3S2,1,0,1,NA
202503,23686004,2,0,1,-1,0
202503,23686004,3,0,1,-1,0
202503,23686009,2,5,0,5,NA
202503,23686022,2,0,6,-6,0
202503,23686022,3,0,8,-8,0
202503,23686024,3S3,0,1,-1,0
202503,23807000,2,182,314,-132,0.58
202503,23807000,2R2,0,3,-3,0
202503,23807000,2S2,13,0,13,NA
202503,23807000,2S3,0,3,-3,0
202503,23807000,3,1,31,-30,0.03
202503,23807000,3S2,10,4,6,2.5
202503,23807000,3S3,46,42,4,1.1
202503,23807000,CA,1,81,-80,0.01
202503,23807012,2,0,1,-1,0
202503,23807012,3S3,1,0,1,NA
202503,23807027,2,0,29,-29,0
202503,23807027,3S2,0,3,-3,0
202503,23807027,3S3,20,49,-29,0.41
202503,23807027,CA,0,3,-3,0
202503,23807033,2,0,15,-15,0
202503,23807033,CA,0,2,-2,0
202503,23815000,2,0,10,-10,0
202503,23815000,2S3,1,0,1,NA
202503,23815000,3,1,0,1,NA
202503,23815000,3S3,0,2,-2,0
202503,23815000,CA,0,1,-1,0
202503,23855000,2,69,76,-7,0.91
202503,23855000,2R2,0,1,-1,0
202503,23855000,2S2,1,1,0,1
202503,23855000,2S3,1,0,1,NA
202503,23855000,3,18,5,13,3.6
202503,23855000,3S2,1,0,1,NA
202503,23855000,3S3,1,22,-21,0.05
202503,23855000,CA,0,8,-8,0
202503,23855001,3,0,2,-2,0
202503,23855008,2,0,2,-2,0
202503,23855013,3,0,6,-6,0
202503,25001000,2,7,88,-81,0.08
202503,25001000,2S2,0,1,-1,0
202503,25001000,2S3,0,1,-1,0
202503,25001000,3S3,1,13,-12,0.08
202503,25001000,CA,3,69,-66,0.04
202503,25019000,2,26,109,-83,0.24
202503,25019000,2S2,5,1,4,5
202503,25019000,2S3,5,0,5,NA
202503,25019000,3,2,4,-2,0.5
202503,25019000,3S2,7,8,-1,0.88
202503,25019000,3S3,1,1,0,1
202503,25019000,CA,1,9,-8,0.11
202503,25019003,2,1,0,1,NA
202503,25035000,2,12,228,-216,0.05
202503,25035000,3,0,2,-2,0
202503,25035000,3S2,0,2,-2,0
202503,25035000,3S3,0,60,-60,0
202503,25035000,CA,3,94,-91,0.03
202503,25040000,2,24,108,-84,0.22
202503,25040000,3,0,1,-1,0
202503,25040000,3S3,0,4,-4,0
202503,25040000,CA,0,59,-59,0
202503,25040002,2,0,2,-2,0
202503,25040002,3S3,0,1,-1,0
202503,25053000,2,3,385,-382,0.01
202503,25053000,3,0,3,-3,0
202503,25053000,CA,0,51,-51,0
202503,25053000,V2,0,1,-1,0
202503,25086000,2,1,8,-7,0.12
202503,25086000,CA,0,3,-3,0
202503,25095000,2,0,16,-16,0
202503,25099000,2,76,131,-55,0.58
202503,25099000,2S2,1,0,1,NA
202503,25099000,2S3,1,0,1,NA
202503,25099000,3,0,6,-6,0
202503,25099000,3S3,4,26,-22,0.15
202503,25099000,CA,109,79,30,1.38
202503,25099000,V2,0,1,-1,0
202503,25120000,2,0,20,-20,0
202503,25120000,3,0,3,-3,0
202503,25120000,CA,0,16,-16,0
202503,25120003,2,0,1,-1,0
202503,25123000,2,13,79,-66,0.16
202503,25123000,3,2,8,-6,0.25
202503,25123000,3S2,1,0,1,NA
202503,25123000,3S3,0,1,-1,0
202503,25123000,CA,0,58,-58,0
202503,25123000,V3,0,1,-1,0
202503,25126000,2,3327,1925,1402,1.73
202503,25126000,2B1,2,0,2,NA
202503,25126000,2R2,3,0,3,NA
202503,25126000,2S2,503,199,304,2.53
202503,25126000,2S3,120,58,62,2.07
202503,25126000,3,64,152,-88,0.42
202503,25126000,3S2,1006,708,298,1.42
202503,25126000,3S3,1260,737,523,1.71
202503,25126000,3S4,4,3,1,1.33
202503,25126000,4,5,7,-2,0.71
202503,25126000,CA,1318,1157,161,1.14
202503,25126000,V2,1,0,1,NA
202503,25126000,V3,183,64,119,2.86
202503,25126000,V4,0,13,-13,0
202503,25126007,3S3,0,1,-1,0
202503,25126009,2,0,8,-8,0
202503,25148000,2,2,45,-43,0.04
202503,25148000,3,0,1,-1,0
202503,25148000,3S4,2,0,2,NA
202503,25148000,CA,0,22,-22,0
202503,25148005,2,0,2,-2,0
202503,25151000,2,16,95,-79,0.17
202503,25151000,2S2,0,2,-2,0
202503,25151000,2S3,1,14,-13,0.07
202503,25151000,3,0,13,-13,0
202503,25151000,3S2,2,2,0,1
202503,25151000,3S3,7,320,-313,0.02
202503,25151000,CA,10,102,-92,0.1
202503,25154000,2,1,48,-47,0.02
202503,25154000,CA,0,35,-35,0
202503,25168000,2,0,13,-13,0
202503,25168000,CA,0,10,-10,0
202503,25175000,2,910,2655,-1745,0.34
202503,25175000,2S1,0,3,-3,0
202503,25175000,2S2,95,264,-169,0.36
202503,25175000,2S3,38,74,-36,0.51
202503,25175000,3,19,95,-76,0.2
202503,25175000,3S2,147,184,-37,0.8
202503,25175000,3S2S3,0,2,-2,0
202503,25175000,3S3,114,372,-258,0.31
202503,25175000,3S4,2,4,-2,0.5
202503,25175000,4,1,2,-1,0.5
202503,25175000,CA,433,2154,-1721,0.2
202503,25175000,V2,4,2,2,2
202503,25175000,V4,0,1,-1,0
202503,25175004,2,1,0,1,NA
202503,25175004,2S3,0,3,-3,0
202503,25175004,3S3,0,2,-2,0
202503,25175007,CA,0,2,-2,0
202503,25178000,2,24,68,-44,0.35
202503,25178000,2S2,0,4,-4,0
202503,25178000,3,1,9,-8,0.11
202503,25178000,3S3,1,9,-8,0.11
202503,25178000,CA,0,11,-11,0
202503,25181000,2,1,149,-148,0.01
202503,25181000,2S2,0,1,-1,0
202503,25181000,3,1,24,-23,0.04
202503,25181000,3S3,0,4,-4,0
202503,25181000,CA,0,45,-45,0
202503,25181000,V2,0,5,-5,0
202503,25181000,V3,0,5,-5,0
202503,25183000,2,17,146,-129,0.12
202503,25183000,2S3,1,1,0,1
202503,25183000,3,7,20,-13,0.35
202503,25183000,3S2,1,2,-1,0.5
202503,25183000,3S3,19,13,6,1.46
202503,25183000,CA,3,75,-72,0.04
202503,25183000,V2,0,4,-4,0
202503,25183000,V3,0,7,-7,0
202503,25183001,2,0,33,-33,0
202503,25183001,3S3,0,2,-2,0
202503,25200000,2,320,376,-56,0.85
202503,25200000,2S1,23,2,21,11.5
202503,25200000,2S2,377,69,308,5.46
202503,25200000,2S3,620,38,582,16.32
202503,25200000,3,29,17,12,1.71
202503,25200000,3S1,1,0,1,NA
202503,25200000,3S2,264,30,234,8.8
202503,25200000,3S3,783,579,204,1.35
202503,25200000,4,0,2,-2,0
202503,25200000,CA,54,122,-68,0.44
202503,25200000,V2,0,14,-14,0
202503,25200000,V3,0,31,-31,0
202503,25200000,V4,0,15,-15,0
202503,25200010,3S3,4,0,4,NA
202503,25200010,V2,2,0,2,NA
202503,25200010,V3,7,0,7,NA
202503,25214000,2,21361,7030,14331,3.04
202503,25214000,2B1,4,1,3,4
202503,25214000,2R2,61,10,51,6.1
202503,25214000,2S1,6,2,4,3
202503,25214000,2S2,997,1787,-790,0.56
202503,25214000,2S3,393,511,-118,0.77
202503,25214000,3,352,173,179,2.03
202503,25214000,3S1,37,0,37,NA
202503,25214000,3S2,1210,1136,74,1.07
202503,25214000,3S3,1555,2936,-1381,0.53
202503,25214000,3S4,10,5,5,2
202503,25214000,4,4,2,2,2
202503,25214000,CA,11779,2321,9458,5.07
202503,25214000,V2,0,3,-3,0
202503,25214000,V3,0,4,-4,0
202503,25214008,2,527,622,-95,0.85
202503,25214008,2S2,82,52,30,1.58
202503,25214008,2S3,38,27,11,1.41
202503,25214008,3,2,8,-6,0.25
202503,25214008,3S1,0,1,-1,0
202503,25214008,3S2,41,34,7,1.21
202503,25214008,3S3,76,134,-58,0.57
202503,25214008,3S4,1,0,1,NA
202503,25214008,4,2,4,-2,0.5
202503,25214008,CA,327,457,-130,0.72
202503,25224000,2,1,17,-16,0.06
202503,25224000,3,15,4,11,3.75
202503,25224000,3S2,6,0,6,NA
202503,25224000,3S3,1946,110,1836,17.69
202503,25224000,4,9,1,8,9
202503,25224000,CA,0,14,-14,0
202503,25224000,V2,7,7,0,1
202503,25224000,V3,86,105,-19,0.82
202503,25224000,V3R2,3,0,3,NA
202503,25224000,V4,78,50,28,1.56
202503,25224000,V4R2,1,6,-5,0.17
202503,25245000,2,6,127,-121,0.05
202503,25245000,2S2,0,1,-1,0
202503,25245000,3,2,17,-15,0.12
202503,25245000,3S2,1,1,0,1
202503,25245000,3S3,0,16,-16,0
202503,25245000,CA,3,101,-98,0.03
202503,25245002,CA,0,1,-1,0
202503,25258000,2,0,1,-1,0
202503,25258000,3S2,1,0,1,NA
202503,25258001,2,0,1,-1,0
202503,25260000,2,458,1437,-979,0.32
202503,25260000,2S2,44,27,17,1.63
202503,25260000,2S3,15,16,-1,0.94
202503,25260000,3,2,8,-6,0.25
202503,25260000,3S2,4,35,-31,0.11
202503,25260000,3S3,8,253,-245,0.03
202503,25260000,4,1,1,0,1
202503,25260000,CA,86,293,-207,0.29
202503,25260000,V2,0,11,-11,0
202503,25260000,V3,0,13,-13,0
202503,25269000,2,1094,2365,-1271,0.46
202503,25269000,2S2,228,29,199,7.86
202503,25269000,2S3,245,20,225,12.25
202503,25269000,3,896,50,846,17.92
202503,25269000,3S2,1584,414,1170,3.83
202503,25269000,3S3,3771,2450,1321,1.54
202503,25269000,3S4,0,3,-3,0
202503,25269000,4,46,0,46,NA
202503,25269000,CA,134,1920,-1786,0.07
202503,25269000,V2,0,2,-2,0
202503,25269000,V3,0,9,-9,0
202503,25269007,3S3,5,0,5,NA
202503,25269009,3S3,0,16,-16,0
202503,25279000,2,3,50,-47,0.06
202503,25279000,3,0,9,-9,0
202503,25279000,3S2,1,2,-1,0.5
202503,25279000,3S3,0,71,-71,0
202503,25279000,CA,0,51,-51,0
202503,25279000,V3,0,2,-2,0
202503,25281000,2,2,10,-8,0.2
202503,25281000,2S2,1,0,1,NA
202503,25281000,3S2,1,0,1,NA
202503,25281000,3S3,1,2,-1,0.5
202503,25281000,CA,0,10,-10,0
202503,25281002,CA,0,1,-1,0
202503,25286000,2,35830,13326,22504,2.69
202503,25286000,2B1,2,4,-2,0.5
202503,25286000,2R2,74,11,63,6.73
202503,25286000,2R3,2,0,2,NA
202503,25286000,2S1,14,33,-19,0.42
202503,25286000,2S2,4525,4194,331,1.08
202503,25286000,2S3,807,857,-50,0.94
202503,25286000,3,332,240,92,1.38
202503,25286000,3S1,7,3,4,2.33
202503,25286000,3S2,1345,2172,-827,0.62
202503,25286000,3S3,2760,6777,-4017,0.41
202503,25286000,3S4,8,0,8,NA
202503,25286000,4,11,7,4,1.57
202503,25286000,CA,26352,3544,22808,7.44
202503,25286000,V2,32,2,30,16
202503,25286000,V3,12,3,9,4
202503,25288000,2,2,40,-38,0.05
202503,25288000,2S2,21,79,-58,0.27
202503,25288000,2S3,4,0,4,NA
202503,25288000,3,12,0,12,NA
202503,25288000,3S2,95,13,82,7.31
202503,25288000,3S3,64,3,61,21.33
202503,25288000,CA,17,23,-6,0.74
202503,25288001,2,1,4,-3,0.25
202503,25288001,CA,0,1,-1,0
202503,25290000,2,147,1554,-1407,0.09
202503,25290000,2R2,0,1,-1,0
202503,25290000,2S2,3,8,-5,0.38
202503,25290000,2S3,1,7,-6,0.14
202503,25290000,3,3,99,-96,0.03
202503,25290000,3S2,7,48,-41,0.15
202503,25290000,3S2S3,2,0,2,NA
202503,25290000,3S3,7,547,-540,0.01
202503,25290000,4,0,2,-2,0
202503,25290000,CA,116,524,-408,0.22
202503,25290000,V2,0,15,-15,0
202503,25290011,2,6,7,-1,0.86
202503,25290011,2S2,1,0,1,NA
202503,25290011,3,1,1,0,1
202503,25290011,3S3,1,0,1,NA
202503,25290011,3S4,1,0,1,NA
202503,25290011,CA,0,3,-3,0
202503,25290012,3S3,0,43,-43,0
202503,25293000,2,0,5,-5,0
202503,25293000,3,0,2,-2,0
202503,25293000,CA,0,57,-57,0
202503,25295000,2,2922,994,1928,2.94
202503,25295000,2B1,3,1,2,3
202503,25295000,2S1,0,3,-3,0
202503,25295000,2S2,142,395,-253,0.36
202503,25295000,2S3,67,192,-125,0.35
202503,25295000,3,51,105,-54,0.49
202503,25295000,3S2,57,269,-212,0.21
202503,25295000,3S3,215,506,-291,0.42
202503,25295000,3S4,2,1,1,2
202503,25295000,4,1,0,1,NA
202503,25295000,CA,60,314,-254,0.19
202503,25295000,V2,1,13,-12,0.08
202503,25295000,V3,20,8,12,2.5
202503,25295001,2,0,1,-1,0
202503,25295005,2,434,0,434,NA
202503,25297000,2,11,40,-29,0.28
202503,25297000,3,0,12,-12,0
202503,25297000,3S3,1,1,0,1
202503,25297000,CA,3,60,-57,0.05
202503,25297000,V2,1,0,1,NA
202503,25297000,V3,0,1,-1,0
202503,25299000,2,0,9,-9,0
202503,25299000,CA,0,6,-6,0
202503,25307000,2,347,1839,-1492,0.19
202503,25307000,2R2,0,14,-14,0
202503,25307000,2S2,3,20,-17,0.15
202503,25307000,2S3,0,5,-5,0
202503,25307000,3,26,62,-36,0.42
202503,25307000,3S2,6,14,-8,0.43
202503,25307000,3S3,303,513,-210,0.59
202503,25307000,4,0,4,-4,0
202503,25307000,CA,363,603,-240,0.6
202503,25307000,V3,0,1,-1,0
202503,25312000,2,3,90,-87,0.03
202503,25312000,2S2,0,4,-4,0
202503,25312000,2S3,0,2,-2,0
202503,25312000,3,0,2,-2,0
202503,25312000,3S2,14,0,14,NA
202503,25312000,3S3,2,6,-4,0.33
202503,25312000,3S4,2,1,1,2
202503,25312000,CA,0,10,-10,0
202503,25317000,2,1,37,-36,0.03
202503,25317000,2S2,5,2,3,2.5
202503,25317000,2S3,2,0,2,NA
202503,25317000,3,0,8,-8,0
202503,25317000,3S2,1,0,1,NA
202503,25317000,3S3,1873,33,1840,56.76
202503,25317000,4,8,0,8,NA
202503,25317000,CA,0,35,-35,0
202503,25317000,V2,38,33,5,1.15
202503,25317000,V3,168,154,14,1.09
202503,25317000,V4,146,214,-68,0.68
202503,25317000,V4R2,1,0,1,NA
202503,25320000,2,251,394,-143,0.64
202503,25320000,2S3,0,8,-8,0
202503,25320000,3,2,22,-20,0.09
202503,25320000,3S2,4,591,-587,0.01
202503,25320000,3S3,3,978,-975,0
202503,25320000,CA,2,125,-123,0.02
202503,25320000,V3,0,1,-1,0
202503,25320003,2,0,1,-1,0
202503,25320003,3S3,0,2,-2,0
202503,25322000,2,14,201,-187,0.07
202503,25322000,2S3,0,1,-1,0
202503,25322000,3,59,16,43,3.69
202503,25322000,3S2,39,1,38,39
202503,25322000,3S3,11,4,7,2.75
202503,25322000,CA,5,212,-207,0.02
202503,25322000,V2,0,4,-4,0
202503,25322000,V3,175,3,172,58.33
202503,25324000,2,2,9,-7,0.22
202503,25324000,3S2,1,1,0,1
202503,25324000,3S3,1,2,-1,0.5
202503,25324000,CA,0,11,-11,0
202503,25326000,2,4,31,-27,0.13
202503,25326000,2S2,0,1,-1,0
202503,25326000,3,2,1,1,2
202503,25326000,3S3,3,2,1,1.5
202503,25326000,3S4,3,0,3,NA
202503,25326000,CA,1,23,-22,0.04
202503,25326000,V3,1,0,1,NA
202503,25328000,2,2,32,-30,0.06
202503,25328000,3,0,7,-7,0
202503,25328000,3S3,3,11,-8,0.27
202503,25328000,CA,1,4,-3,0.25
202503,25328000,V2,0,2,-2,0
202503,25328001,3S3,0,4,-4,0
202503,25335000,2,9,17,-8,0.53
202503,25335000,2S2,2,0,2,NA
202503,25335000,2S3,1,1,0,1
202503,25335000,3,0,4,-4,0
202503,25335000,3S2,0,1,-1,0
202503,25335000,3S3,5,70,-65,0.07
202503,25335000,CA,2,26,-24,0.08
202503,25339000,2,1,2,-1,0.5
202503,25339000,CA,1,4,-3,0.25
202503,25368000,2,0,16,-16,0
202503,25368000,CA,0,5,-5,0
202503,25372000,2,0,5,-5,0
202503,25372000,3,0,1,-1,0
202503,25372000,CA,0,2,-2,0
202503,25377000,2,397,605,-208,0.66
202503,25377000,2S2,17,28,-11,0.61
202503,25377000,2S3,8,8,0,1
202503,25377000,3,219,61,158,3.59
202503,25377000,3S2,11,7,4,1.57
202503,25377000,3S3,622,157,465,3.96
202503,25377000,3S4,0,1,-1,0
202503,25377000,CA,9,488,-479,0.02
202503,25377000,V2,2,0,2,NA
202503,25377000,V3,120,1,119,120
202503,25377000,V4,1,0,1,NA
202503,25377003,3S3,0,4,-4,0
202503,25377003,CA,1,0,1,NA
202503,25386000,2,25,529,-504,0.05
202503,25386000,2R2,0,2,-2,0
202503,25386000,2S2,1,0,1,NA
202503,25386000,2S3,1,2,-1,0.5
202503,25386000,3,2,5,-3,0.4
202503,25386000,3S2,3,2,1,1.5
202503,25386000,3S3,3,106,-103,0.03
202503,25386000,4,0,1,-1,0
202503,25386000,CA,2,174,-172,0.01
202503,25386001,2,0,9,-9,0
202503,25386003,2,0,1,-1,0
202503,25394000,2,1,20,-19,0.05
202503,25394000,3S2,0,1,-1,0
202503,25394000,CA,0,4,-4,0
202503,25394002,2,0,1,-1,0
202503,25398000,2,0,21,-21,0
202503,25398000,CA,0,13,-13,0
202503,25402000,2,15,270,-255,0.06
202503,25402000,2S2,0,2,-2,0
202503,25402000,2S3,0,6,-6,0
202503,25402000,3,2,35,-33,0.06
202503,25402000,3S2,0,6,-6,0
202503,25402000,3S3,1,9,-8,0.11
202503,25402000,4,0,1,-1,0
202503,25402000,CA,0,68,-68,0
202503,25402000,V2,0,2,-2,0
202503,25402002,2,0,1,-1,0
202503,25407000,2,11,73,-62,0.15
202503,25407000,3,2,2,0,1
202503,25407000,3S2,3,7,-4,0.43
202503,25407000,3S3,874,271,603,3.23
202503,25407000,4,15,15,0,1
202503,25407000,CA,0,37,-37,0
202503,25407000,V2,29,36,-7,0.81
202503,25407000,V3,114,135,-21,0.84
202503,25407000,V4,117,73,44,1.6
202503,25407000,V4R2,1,1,0,1
202503,25426000,2,3,38,-35,0.08
202503,25426000,3,0,1,-1,0
202503,25426000,CA,0,10,-10,0
202503,25430000,2,4964,3234,1730,1.53
202503,25430000,2B1,2,5,-3,0.4
202503,25430000,2B2,0,4,-4,0
202503,25430000,2R2,2,11,-9,0.18
202503,25430000,2S1,0,2,-2,0
202503,25430000,2S2,1496,686,810,2.18
202503,25430000,2S3,292,173,119,1.69
202503,25430000,3,242,167,75,1.45
202503,25430000,3S2,286,521,-235,0.55
202503,25430000,3S3,1651,2238,-587,0.74
202503,25430000,3S4,5,1,4,5
202503,25430000,4,10,15,-5,0.67
202503,25430000,CA,1431,1278,153,1.12
202503,25430000,V2,4,6,-2,0.67
202503,25430000,V3,0,527,-527,0
202503,25430000,V4,1,177,-176,0.01
202503,25430003,2,0,1,-1,0
202503,25430003,3S3,0,1,-1,0
202503,25430003,CA,0,1,-1,0
202503,25430004,2,5,9,-4,0.56
202503,25430004,2S2,69,0,69,NA
202503,25430004,2S3,1,0,1,NA
202503,25430004,3S2,2,0,2,NA
202503,25430004,3S3,4,2,2,2
202503,25430004,CA,2,6,-4,0.33
202503,25430005,2S2,1,0,1,NA
202503,25430005,3S3,0,2,-2,0
202503,25430006,2,1,0,1,NA
202503,25436000,2,1,14,-13,0.07
202503,25436000,3,0,10,-10,0
202503,25436000,CA,0,12,-12,0
202503,25436000,V3,0,1,-1,0
202503,25438000,2,15,41,-26,0.37
202503,25438000,3,0,4,-4,0
202503,25438000,3S3,0,4,-4,0
202503,25438000,CA,1,11,-10,0.09
202503,25473000,2,14390,5334,9056,2.7
202503,25473000,2R2,3,1,2,3
202503,25473000,2S1,1,1,0,1
202503,25473000,2S2,1177,1119,58,1.05
202503,25473000,2S3,228,207,21,1.1
202503,25473000,3,121,363,-242,0.33
202503,25473000,3S1,1,0,1,NA
202503,25473000,3S2,852,445,407,1.91
202503,25473000,3S3,1053,3985,-2932,0.26
202503,25473000,3S4,3,9,-6,0.33
202503,25473000,4,12,52,-40,0.23
202503,25473000,CA,5681,1829,3852,3.11
202503,25473000,V2,22,56,-34,0.39
202503,25473000,V3,92,104,-12,0.88
202503,25473000,V4,3,916,-913,0
202503,25473004,2,0,1,-1,0
202503,25473004,3,1,0,1,NA
202503,25473004,3S3,0,2,-2,0
202503,25483000,2,3,6,-3,0.5
202503,25483000,3S3,1,1,0,1
202503,25483000,CA,0,14,-14,0
202503,25486000,2,93,270,-177,0.34
202503,25486000,2S2,3,1,2,3
202503,25486000,2S3,0,1,-1,0
202503,25486000,3,88,2,86,44
202503,25486000,3S2,4,17,-13,0.24
202503,25486000,3S3,148,7,141,21.14
202503,25486000,CA,1,144,-143,0.01
202503,25486000,V2,0,2,-2,0
202503,25486000,V3,1434,49,1385,29.27
202503,25486000,V4,301,0,301,NA
202503,25488000,2,8,95,-87,0.08
202503,25488000,2S1,1,0,1,NA
202503,25488000,2S2,0,1,-1,0
202503,25488000,2S3,0,1,-1,0
202503,25488000,3,3,10,-7,0.3
202503,25488000,3S2,2,0,2,NA
202503,25488000,3S3,2,9,-7,0.22
202503,25488000,CA,1,23,-22,0.04
202503,25488001,2,0,2,-2,0
202503,25489000,2,1,58,-57,0.02
202503,25489000,CA,0,3,-3,0
202503,25489000,V2,0,1,-1,0
202503,25491000,2,0,17,-17,0
202503,25491000,3S2,1,0,1,NA
202503,25491000,CA,0,15,-15,0
202503,25506000,2,1,10,-9,0.1
202503,25506000,CA,1,4,-3,0.25
202503,25513000,2,10,161,-151,0.06
202503,25513000,3,1,11,-10,0.09
202503,25513000,3S3,1,6,-5,0.17
202503,25513000,CA,0,77,-77,0
202503,25513000,V2,0,1,-1,0
202503,25513000,V3,0,8,-8,0
202503,25518000,2,0,5,-5,0
202503,25518004,2,0,5,-5,0
202503,25518004,CA,0,1,-1,0
202503,25524000,2,1,13,-12,0.08
202503,25524000,3,0,1,-1,0
202503,25524000,CA,0,17,-17,0
202503,25530000,2,9,60,-51,0.15
202503,25530000,2S2,0,3,-3,0
202503,25530000,3,4,32,-28,0.12
202503,25530000,3S2,5,8,-3,0.62
202503,25530000,3S3,6,48,-42,0.12
202503,25530000,CA,4,12,-8,0.33
202503,25530001,2,1,2,-1,0.5
202503,25530001,3,1,0,1,NA
202503,25530002,3,1,0,1,NA
202503,25530006,3S3,0,1,-1,0
202503,25535000,2,1,45,-44,0.02
202503,25535000,3,1,0,1,NA
202503,25535000,3S3,0,14,-14,0
202503,25535000,CA,0,11,-11,0
202503,25535000,V2,0,2,-2,0
202503,25572000,2,59,145,-86,0.41
202503,25572000,2R2,0,3,-3,0
202503,25572000,2S2,4,5,-1,0.8
202503,25572000,2S3,5,1,4,5
202503,25572000,3,2,7,-5,0.29
202503,25572000,3S2,31,2,29,15.5
202503,25572000,3S3,201,158,43,1.27
202503,25572000,3S4,0,1,-1,0
202503,25572000,CA,0,46,-46,0
202503,25572000,V3,0,1,-1,0
202503,25572003,CA,0,1,-1,0
202503,25580000,2,1,4,-3,0.25
202503,25580000,CA,0,2,-2,0
202503,25592000,2,0,18,-18,0
202503,25592000,3,0,3,-3,0
202503,25592000,CA,0,8,-8,0
202503,25592000,V2,0,3,-3,0
202503,25594000,2,0,15,-15,0
202503,25594000,3S2,0,1,-1,0
202503,25594000,3S3,0,25,-25,0
202503,25594000,CA,0,17,-17,0
202503,25594002,2,1,10,-9,0.1
202503,25594002,2S2,0,1,-1,0
202503,25594002,3S3,0,16,-16,0
202503,25594002,CA,0,15,-15,0
202503,25596000,2,0,18,-18,0
202503,25596000,CA,0,6,-6,0
202503,25596003,2,0,2,-2,0
202503,25599000,2,0,88,-88,0
202503,25599000,3S2,0,4,-4,0
202503,25599000,3S3,0,5,-5,0
202503,25599000,CA,0,65,-65,0
202503,25599002,2,0,4,-4,0
202503,25599002,CA,0,2,-2,0
202503,25612000,2,24,279,-255,0.09
202503,25612000,2R2,0,1,-1,0
202503,25612000,2S1,0,1,-1,0
202503,25612000,2S2,2,1,1,2
202503,25612000,3,49,1,48,49
202503,25612000,3S2,3,1,2,3
202503,25612000,3S3,7,111,-104,0.06
202503,25612000,4,0,1,-1,0
202503,25612000,CA,12,166,-154,0.07
202503,25612000,V2,3,0,3,NA
202503,25612000,V3,17,1,16,17
202503,25645000,2,0,51,-51,0
202503,25645000,3,1,0,1,NA
202503,25645000,3S3,0,1,-1,0
202503,25645000,CA,0,9,-9,0
202503,25645001,2,0,1,-1,0
202503,25645002,3S3,1,0,1,NA
202503,25649000,2,0,56,-56,0
202503,25649000,CA,4,24,-20,0.17
202503,25653000,2,0,1,-1,0
202503,25653000,CA,0,5,-5,0
202503,25658000,2,3,79,-76,0.04
202503,25658000,3,0,6,-6,0
202503,25658000,3S2,1,8,-7,0.12
202503,25658000,3S3,0,5,-5,0
202503,25658000,CA,0,28,-28,0
202503,25658000,V3,0,11,-11,0
202503,25662000,2,6,41,-35,0.15
202503,25662000,3,0,5,-5,0
202503,25662000,3S3,2,4,-2,0.5
202503,25662000,CA,0,16,-16,0
202503,25662001,2,0,4,-4,0
202503,25662001,2S2,1,5,-4,0.2
202503,25662001,2S3,0,2,-2,0
202503,25662001,3,0,1,-1,0
202503,25662001,3S2,1,2,-1,0.5
202503,25662001,3S3,1,8,-7,0.12
202503,25662001,CA,2,16,-14,0.12
202503,25718000,2,7,210,-203,0.03
202503,25718000,3,29,0,29,NA
202503,25718000,3S3,0,3,-3,0
202503,25718000,CA,33,26,7,1.27
202503,25718000,V2,0,2,-2,0
202503,25736000,2,728,245,483,2.97
202503,25736000,2S2,7,33,-26,0.21
202503,25736000,2S3,3,50,-47,0.06
202503,25736000,3,7,5,2,1.4
202503,25736000,3S2,80,129,-49,0.62
202503,25736000,3S3,967,713,254,1.36
202503,25736000,3S4,0,9,-9,0
202503,25736000,CA,141,115,26,1.23
202503,25736000,V2,81,0,81,NA
202503,25736000,V3,78,0,78,NA
202503,25740000,2,1209,1449,-240,0.83
202503,25740000,2S2,214,114,100,1.88
202503,25740000,2S3,11,40,-29,0.28
202503,25740000,3,34,84,-50,0.4
202503,25740000,3S1,0,3,-3,0
202503,25740000,3S2,129,206,-77,0.63
202503,25740000,3S3,1226,1858,-632,0.66
202503,25740000,3S4,0,1,-1,0
202503,25740000,4,1,1,0,1
202503,25740000,CA,686,528,158,1.3
202503,25740000,V2,0,29,-29,0
202503,25740000,V3,6,0,6,NA
202503,25740000,V4,0,1,-1,0
202503,25740004,2,1,0,1,NA
202503,25740005,2,1,0,1,NA
202503,25743000,2,17,261,-244,0.07
202503,25743000,2S2,14,1,13,14
202503,25743000,2S3,2,4,-2,0.5
202503,25743000,3,2,26,-24,0.08
202503,25743000,3S2,4,12,-8,0.33
202503,25743000,3S3,22,27,-5,0.81
202503,25743000,3S4,3,0,3,NA
202503,25743000,CA,2,62,-60,0.03
202503,25743000,V2,0,17,-17,0
202503,25743005,2,1,6,-5,0.17
202503,25743005,2S2,4,0,4,NA
202503,25743005,3S2,8,3,5,2.67
202503,25745000,2,11,141,-130,0.08
202503,25745000,2S2,2,7,-5,0.29
202503,25745000,2S3,3,5,-2,0.6
202503,25745000,3,1,2,-1,0.5
202503,25745000,3S2,111,1,110,111
202503,25745000,3S3,64,16,48,4
202503,25745000,CA,2,128,-126,0.02
202503,25754000,2,7797,4190,3607,1.86
202503,25754000,2B1,0,3,-3,0
202503,25754000,2R2,1,5,-4,0.2
202503,25754000,2S1,0,1,-1,0
202503,25754000,2S2,136,187,-51,0.73
202503,25754000,2S3,87,81,6,1.07
202503,25754000,3,899,149,750,6.03
202503,25754000,3S2,30,289,-259,0.1
202503,25754000,3S3,3117,1550,1567,2.01
202503,25754000,4,52,4,48,13
202503,25754000,CA,4735,2187,2548,2.17
202503,25754000,V2,78,4,74,19.5
202503,25754000,V3,128,16,112,8
202503,25754001,2,447,1,446,447
202503,25754001,2S2,69,0,69,NA
202503,25754001,2S3,1,0,1,NA
202503,25754001,3S2,2,0,2,NA
202503,25754001,3S3,2,5,-3,0.4
202503,25754001,CA,14,0,14,NA
202503,25758000,2,1019,1349,-330,0.76
202503,25758000,2S2,24,91,-67,0.26
202503,25758000,2S3,11,5,6,2.2
202503,25758000,3,505,198,307,2.55
202503,25758000,3S2,428,42,386,10.19
202503,25758000,3S3,1361,205,1156,6.64
202503,25758000,4,17,9,8,1.89
202503,25758000,CA,97,387,-290,0.25
202503,25758000,V2,0,16,-16,0
202503,25758000,V3,4,2827,-2823,0
202503,25758000,V4,0,249,-249,0
202503,25758006,2,26,26,0,1
202503,25758006,2S2,14,7,7,2
202503,25758006,2S3,4,2,2,2
202503,25758006,3,0,3,-3,0
202503,25758006,3S2,13,3,10,4.33
202503,25758006,3S3,1288,14,1274,92
202503,25758006,3S4,0,1,-1,0
202503,25758006,CA,0,15,-15,0
202503,25758006,V3,18,0,18,NA
202503,25769000,2,72,482,-410,0.15
202503,25769000,2S2,0,2,-2,0
202503,25769000,2S3,0,2,-2,0
202503,25769000,3,1,0,1,NA
202503,25769000,3S2,0,3,-3,0
202503,25769000,3S3,0,12,-12,0
202503,25769000,CA,4,200,-196,0.02
202503,25769000,V2,0,2,-2,0
202503,25769002,3S3,0,1,-1,0
202503,25769002,CA,0,3,-3,0
202503,25772000,2,110,279,-169,0.39
202503,25772000,2S2,0,1,-1,0
202503,25772000,2S3,0,4,-4,0
202503,25772000,3,37,17,20,2.18
202503,25772000,3S2,12,4,8,3
202503,25772000,3S3,419,706,-287,0.59
202503,25772000,CA,3,134,-131,0.02
202503,25772000,V2,0,3,-3,0
202503,25772000,V3,0,2,-2,0
202503,25777000,2,0,30,-30,0
202503,25777000,3,0,3,-3,0
202503,25777000,CA,0,29,-29,0
202503,25777001,V2,0,1,-1,0
202503,25779000,2,1,23,-22,0.04
202503,25779000,3S3,0,1,-1,0
202503,25779000,CA,0,35,-35,0
202503,25781000,2,1,9,-8,0.11
202503,25781000,3,4,16,-12,0.25
202503,25781000,3S3,680,30,650,22.67
202503,25781000,CA,0,15,-15,0
202503,25781000,V3,18,22,-4,0.82
202503,25781000,V4,7,6,1,1.17
202503,25785000,2,63,205,-142,0.31
202503,25785000,2S2,0,9,-9,0
202503,25785000,3,11,0,11,NA
202503,25785000,3S2,0,6,-6,0
202503,25785000,3S3,1,12,-11,0.08
202503,25785000,4,1,0,1,NA
202503,25785000,CA,2,262,-260,0.01
202503,25785000,V2,0,4,-4,0
202503,25785000,V3,0,10,-10,0
202503,25793000,2,2,22,-20,0.09
202503,25793000,2S3,1,0,1,NA
202503,25793000,3,1,2,-1,0.5
202503,25793000,3S2,1,6,-5,0.17
202503,25793000,3S3,945,66,879,14.32
202503,25793000,CA,0,21,-21,0
202503,25793000,V2,3,6,-3,0.5
202503,25793000,V3,35,39,-4,0.9
202503,25793000,V4,3,15,-12,0.2
202503,25793003,3S3,0,13,-13,0
202503,25797000,2,1,62,-61,0.02
202503,25797000,3,0,12,-12,0
202503,25797000,3S2,0,1,-1,0
202503,25797000,CA,0,15,-15,0
202503,25797001,2,0,2,-2,0
202503,25797001,2S2,0,2,-2,0
202503,25797001,3S3,0,1,-1,0
202503,25797001,CA,0,9,-9,0
202503,25799000,2,13952,3744,10208,3.73
202503,25799000,2R2,29,5,24,5.8
202503,25799000,2R3,5,4,1,1.25
202503,25799000,2S1,0,2,-2,0
202503,25799000,2S2,2001,2175,-174,0.92
202503,25799000,2S3,276,266,10,1.04
202503,25799000,3,46,61,-15,0.75
202503,25799000,3S1,3,1,2,3
202503,25799000,3S2,559,850,-291,0.66
202503,25799000,3S3,589,649,-60,0.91
202503,25799000,3S4,10,1,9,10
202503,25799000,CA,10246,1031,9215,9.94
202503,25799000,V2,0,5,-5,0
202503,25799000,V3,4,5,-1,0.8
202503,25799001,2,4,15,-11,0.27
202503,25799001,2S2,1,3,-2,0.33
202503,25799001,3,0,8,-8,0
202503,25799001,3S3,0,1,-1,0
202503,25799001,CA,2,2,0,1
202503,25805000,2,0,29,-29,0
202503,25805000,CA,0,7,-7,0
202503,25807000,2,1,3,-2,0.33
202503,25807000,3,0,2,-2,0
202503,25807000,3S2,0,1,-1,0
202503,25807000,CA,0,2,-2,0
202503,25807000,V3,0,1,-1,0
202503,25815000,2,11,125,-114,0.09
202503,25815000,3S2,2,2,0,1
202503,25815000,3S3,3,20,-17,0.15
202503,25815000,CA,0,53,-53,0
202503,25817000,2,9824,5662,4162,1.74
202503,25817000,2B1,6,8,-2,0.75
202503,25817000,2B2,1,0,1,NA
202503,25817000,2R2,8,2,6,4
202503,25817000,2S1,5,14,-9,0.36
202503,25817000,2S2,2432,1197,1235,2.03
202503,25817000,2S3,1213,525,688,2.31
202503,25817000,3,827,94,733,8.8
202503,25817000,3S1,0,4,-4,0
202503,25817000,3S2,1187,806,381,1.47
202503,25817000,3S2S3,1,0,1,NA
202503,25817000,3S3,7416,7261,155,1.02
202503,25817000,3S4,29,15,14,1.93
202503,25817000,4,8,2,6,4
202503,25817000,CA,3132,1473,1659,2.13
202503,25817000,V2,8,4,4,2
202503,25817000,V3,0,19,-19,0
202503,25817001,2,0,1,-1,0
202503,25817001,2S2,0,5,-5,0
202503,25817001,2S3,3,6,-3,0.5
202503,25817001,3S2,0,33,-33,0
202503,25817001,3S3,6,0,6,NA
202503,25817002,2,2,12,-10,0.17
202503,25817002,2S3,0,3,-3,0
202503,25817002,3S2,1,1,0,1
202503,25817002,3S3,22,7,15,3.14
202503,25817002,CA,1,0,1,NA
202503,25817005,2,2,2,0,1
202503,25817005,CA,0,1,-1,0
202503,25817006,2,0,2,-2,0
202503,25817014,3S3,113,60,53,1.88
202503,25823000,2,0,20,-20,0
202503,25823000,3,0,1,-1,0
202503,25823000,CA,0,3,-3,0
202503,25839000,2,3,56,-53,0.05
202503,25839000,3,59,8,51,7.38
202503,25839000,CA,0,25,-25,0
202503,25839000,V3,1722,0,1722,NA
202503,25839003,2,0,5,-5,0
202503,25839003,CA,1,3,-2,0.33
202503,25839004,2,0,1,-1,0
202503,25841000,2,0,54,-54,0
202503,25841000,2S2,0,1,-1,0
202503,25841000,3,0,5,-5,0
202503,25841000,3S2,0,2,-2,0
202503,25841000,3S3,8,67,-59,0.12
202503,25841000,CA,1,12,-11,0.08
202503,25841000,V2,1,0,1,NA
202503,25843000,2,74,444,-370,0.17
202503,25843000,2S2,0,5,-5,0
202503,25843000,2S3,1,5,-4,0.2
202503,25843000,3,51,55,-4,0.93
202503,25843000,3S2,34,6,28,5.67
202503,25843000,3S3,161,165,-4,0.98
202503,25843000,4,0,20,-20,0
202503,25843000,CA,4,245,-241,0.02
202503,25843000,V2,0,88,-88,0
202503,25843000,V3,0,212,-212,0
202503,25843000,V4,0,54,-54,0
202503,25843000,V4R2,0,3,-3,0
202503,25845000,2,0,6,-6,0
202503,25845000,3,0,10,-10,0
202503,25845000,3S2,4,0,4,NA
202503,25845000,3S3,7,3,4,2.33
202503,25845000,CA,0,12,-12,0
202503,25851000,2,0,46,-46,0
202503,25851000,CA,0,56,-56,0
202503,25862000,2,0,13,-13,0
202503,25862000,CA,0,4,-4,0
202503,25867000,2,0,17,-17,0
202503,25867000,CA,0,6,-6,0
202503,25871000,2,0,2,-2,0
202503,25873000,2,14,133,-119,0.11
202503,25873000,2S2,0,1,-1,0
202503,25873000,3,1,7,-6,0.14
202503,25873000,3S2,1,2,-1,0.5
202503,25873000,3S3,157,51,106,3.08
202503,25873000,CA,6,126,-120,0.05
202503,25873000,V2,0,2,-2,0
202503,25875000,2,37,641,-604,0.06
202503,25875000,2S2,1,1,0,1
202503,25875000,2S3,2,2,0,1
202503,25875000,3,5,13,-8,0.38
202503,25875000,3S2,3,6,-3,0.5
202503,25875000,3S2S3,1,0,1,NA
202503,25875000,3S3,10,58,-48,0.17
202503,25875000,CA,1,204,-203,0
202503,25875000,V3,0,1,-1,0
202503,25878000,2,10,72,-62,0.14
202503,25878000,3S3,0,7,-7,0
202503,25878000,CA,0,64,-64,0
202503,25885000,2,10,31,-21,0.32
202503,25885000,CA,0,8,-8,0
202503,25885003,2,0,1,-1,0
202503,25885005,2,0,1,-1,0
202503,25898000,2,1,23,-22,0.04
202503,25898000,2S2,0,1,-1,0
202503,25898000,CA,2,1,1,2
202503,25898001,CA,1,0,1,NA
202503,25898006,3S3,0,2,-2,0
202503,25899000,2,888,2614,-1726,0.34
202503,25899000,2S1,2,0,2,NA
202503,25899000,2S2,164,87,77,1.89
202503,25899000,2S3,155,49,106,3.16
202503,25899000,3,55,80,-25,0.69
202503,25899000,3S1,0,4,-4,0
202503,25899000,3S2,234,54,180,4.33
202503,25899000,3S3,782,538,244,1.45
202503,25899000,4,7,0,7,NA
202503,25899000,CA,191,1889,-1698,0.1
202503,25899000,V2,0,4,-4,0
202503,25899000,V3,90,159,-69,0.57
202503,25899000,V4,19,1,18,19
202503,25899000,V4R2,1,0,1,NA
202503,25899010,2,0,1,-1,0
202503,27001000,2,204,1763,-1559,0.12
202503,27001000,2S2,13,15,-2,0.87
202503,27001000,2S3,0,3,-3,0
202503,27001000,3,10,214,-204,0.05
202503,27001000,3S2,3,23,-20,0.13
202503,27001000,3S3,2,159,-157,0.01
202503,27001000,4,1,27,-26,0.04
202503,27001000,CA,11,140,-129,0.08
202503,27001004,2,0,1,-1,0
202503,27001004,CA,0,1,-1,0
202503,27001024,3S2,0,1,-1,0
202503,27001060,2,0,10,-10,0
202503,27006000,2,0,6,-6,0
202503,27006000,3S3,0,2,-2,0
202503,27050000,2,1,4,-3,0.25
202503,27050000,CA,0,2,-2,0
202503,27073000,2,0,1,-1,0
202503,27073000,CA,0,3,-3,0
202503,27075000,2,0,2,-2,0
202503,27075000,CA,0,2,-2,0
202503,27077024,2,0,1,-1,0
202503,27086000,2,8,55,-47,0.15
202503,27086000,3,1,22,-21,0.05
202503,27086000,3S2,2,0,2,NA
202503,27086000,3S3,0,12,-12,0
202503,27086000,CA,0,14,-14,0
202503,27086003,3,0,1,-1,0
202503,27099000,2,0,2,-2,0
202503,27135000,2,1,4,-3,0.25
202503,27135000,3S2,1,0,1,NA
202503,27150000,2,0,4,-4,0
202503,27150000,3S2,0,1,-1,0
202503,27150001,2,0,1,-1,0
202503,27160000,2,3,6,-3,0.5
202503,27160000,3,0,1,-1,0
202503,27160000,3S2,0,2,-2,0
202503,27160000,3S2S3,0,1,-1,0
202503,27160000,CA,0,2,-2,0
202503,27205000,2,3,148,-145,0.02
202503,27205000,3,0,19,-19,0
202503,27205000,3S2,1,2,-1,0.5
202503,27205000,3S3,0,6,-6,0
202503,27205000,CA,3,15,-12,0.2
202503,27245000,2,5,56,-51,0.09
202503,27245000,2S2,0,2,-2,0
202503,27245000,2S3,0,3,-3,0
202503,27245000,3,0,24,-24,0
202503,27245000,3S2,2,30,-28,0.07
202503,27245000,3S3,67,15,52,4.47
202503,27245000,CA,0,4,-4,0
202503,27245000,V3,0,7,-7,0
202503,27245003,3,0,3,-3,0
202503,27245003,V3,0,1,-1,0
202503,27250000,CA,0,3,-3,0
202503,27250021,CA,0,3,-3,0
202503,27361000,2,68,658,-590,0.1
202503,27361000,2S3,0,1,-1,0
202503,27361000,3,1,87,-86,0.01
202503,27361000,3S2,13,14,-1,0.93
202503,27361000,3S2S2,0,1,-1,0
202503,27361000,3S3,5,30,-25,0.17
202503,27361000,3S4,0,1,-1,0
202503,27361000,4,0,15,-15,0
202503,27361000,CA,3,63,-60,0.05
202503,27361024,3S3,0,1,-1,0
202503,27413000,2,0,9,-9,0
202503,27413000,3,0,2,-2,0
202503,27413000,3S2,0,3,-3,0
202503,27413000,CA,0,1,-1,0
202503,27425000,CA,0,1,-1,0
202503,27430000,2,0,2,-2,0
202503,27430000,3,0,9,-9,0
202503,27430011,2,0,9,-9,0
202503,27430011,3,1,2,-1,0.5
202503,27430011,CA,0,1,-1,0
202503,27450009,2,0,1,-1,0
202503,27450009,3,0,2,-2,0
202503,27491000,2,0,10,-10,0
202503,27491000,3,0,1,-1,0
202503,27491000,3S2,0,19,-19,0
202503,27491000,3S3,0,4,-4,0
202503,27495000,CA,0,1,-1,0
202503,27495007,2S3,0,2,-2,0
202503,27580005,2,0,2,-2,0
202503,27600000,3,0,1,-1,0
202503,27615000,2,0,22,-22,0
202503,27615000,3,2,6,-4,0.33
202503,27615000,3S2,0,5,-5,0
202503,27615000,3S3,0,12,-12,0
202503,27615000,CA,1,1,0,1
202503,27615015,2,0,1,-1,0
202503,27660000,2,0,8,-8,0
202503,27660000,3,0,1,-1,0
202503,27660000,3S2,0,4,-4,0
202503,27660000,3S3,0,1,-1,0
202503,27787000,2,4,67,-63,0.06
202503,27787000,3,0,8,-8,0
202503,27787000,3S2,0,2,-2,0
202503,27787000,3S3,0,1,-1,0
202503,27787000,CA,0,7,-7,0
202503,27787017,CA,0,3,-3,0
202503,27800000,2,0,4,-4,0
202503,27810000,2,1,19,-18,0.05
202503,27810000,3,0,4,-4,0
202503,27810000,3S2,1,3,-2,0.33
202503,27810000,3S3,0,3,-3,0
202503,27810000,CA,0,4,-4,0
202503,27810002,2,1,38,-37,0.03
202503,27810002,3,0,5,-5,0
202503,41001000,2,2751,4015,-1264,0.69
202503,41001000,2B1,0,2,-2,0
202503,41001000,2R2,46,27,19,1.7
202503,41001000,2S2,100,364,-264,0.27
202503,41001000,2S3,22,57,-35,0.39
202503,41001000,3,198,131,67,1.51
202503,41001000,3S1,1,0,1,NA
202503,41001000,3S2,185,295,-110,0.63
202503,41001000,3S3,2055,2180,-125,0.94
202503,41001000,3S4,3,1,2,3
202503,41001000,4,4,12,-8,0.33
202503,41001000,CA,631,909,-278,0.69
202503,41001000,V3,1,0,1,NA
202503,41001001,CA,0,23,-23,0
202503,41001003,2,110,0,110,NA
202503,41001003,3,11,0,11,NA
202503,41001003,3S3,1,3,-2,0.33
202503,41001009,2,0,2,-2,0
202503,41001009,3,0,1,-1,0
202503,41001012,2,0,3,-3,0
202503,41001014,2,0,1,-1,0
202503,41001018,2,0,1,-1,0
202503,41001018,3S3,0,2,-2,0
202503,41006000,2,2,175,-173,0.01
202503,41006000,2S3,0,3,-3,0
202503,41006000,3,0,5,-5,0
202503,41006000,3S2,0,2,-2,0
202503,41006000,3S3,1,24,-23,0.04
202503,41006000,4,1,0,1,NA
202503,41006000,CA,1,35,-34,0.03
202503,41006001,2,0,2,-2,0
202503,41006005,2,0,2,-2,0
202503,41006005,3S3,13,13,0,1
202503,41013000,2,0,15,-15,0
202503,41013000,3S3,0,9,-9,0
202503,41016000,2,72,112,-40,0.64
202503,41016000,2S2,3,8,-5,0.38
202503,41016000,2S3,1,0,1,NA
202503,41016000,3,17,120,-103,0.14
202503,41016000,3S2,13,20,-7,0.65
202503,41016000,3S3,58,136,-78,0.43
202503,41016000,4,4,3,1,1.33
202503,41016000,CA,3,38,-35,0.08
202503,41016001,2,0,9,-9,0
202503,41016008,3,1,0,1,NA
202503,41020000,2,3,42,-39,0.07
202503,41020000,3,0,2,-2,0
202503,41020000,3S3,0,2,-2,0
202503,41020000,CA,0,14,-14,0
202503,41026000,2,4,5,-1,0.8
202503,41026000,3S2,1,0,1,NA
202503,41026000,3S3,0,4,-4,0
202503,41026000,V3,0,1,-1,0
202503,41078000,2,0,6,-6,0
202503,41078000,3S3,0,2,-2,0
202503,41078000,CA,0,4,-4,0
202503,41132000,2,14,196,-182,0.07
202503,41132000,2S1,0,1,-1,0
202503,41132000,2S2,2,1,1,2
202503,41132000,3,20,2,18,10
202503,41132000,3S2,2,0,2,NA
202503,41132000,3S3,63,44,19,1.43
202503,41132000,CA,2,24,-22,0.08
202503,41132000,V3,22,0,22,NA
202503,41206000,2,0,3,-3,0
202503,41206000,3S3,0,1,-1,0
202503,41206000,CA,0,1,-1,0
202503,41298000,2,94,548,-454,0.17
202503,41298000,2S2,0,3,-3,0
202503,41298000,2S3,1,2,-1,0.5
202503,41298000,3,13,51,-38,0.25
202503,41298000,3S2,0,4,-4,0
202503,41298000,3S3,49,210,-161,0.23
202503,41298000,CA,12,91,-79,0.13
202503,41298000,V3,0,1,-1,0
202503,41298002,3,0,3,-3,0
202503,41298004,2,0,2,-2,0
202503,41298004,3S3,0,2,-2,0
202503,41298004,CA,0,2,-2,0
202503,41306000,2,5,64,-59,0.08
202503,41306000,2S2,1,0,1,NA
202503,41306000,2S3,0,1,-1,0
202503,41306000,3,2,2,0,1
202503,41306000,3S2,13,1,12,13
202503,41306000,3S3,55,28,27,1.96
202503,41306000,3S4,0,1,-1,0
202503,41306000,CA,0,8,-8,0
202503,41319000,2,0,37,-37,0
202503,41319000,3,1,5,-4,0.2
202503,41319000,3S2,0,5,-5,0
202503,41319000,3S3,1,12,-11,0.08
202503,41319000,CA,0,2,-2,0
202503,41349000,2,3,26,-23,0.12
202503,41349000,3,26,0,26,NA
202503,41349000,3S2,2,0,2,NA
202503,41349000,3S3,90,3,87,30
202503,41349000,CA,0,5,-5,0
202503,41357000,2,0,6,-6,0
202503,41357000,3S2,0,1,-1,0
202503,41357000,CA,0,3,-3,0
202503,41359000,2,6,105,-99,0.06
202503,41359000,3,1,2,-1,0.5
202503,41359000,3S3,0,14,-14,0
202503,41359000,CA,0,44,-44,0
202503,41359002,3,0,3,-3,0
202503,41359002,3S3,0,13,-13,0
202503,41378000,2,0,22,-22,0
202503,41378000,3,1,10,-9,0.1
202503,41378000,3S3,0,3,-3,0
202503,41378000,CA,0,34,-34,0
202503,41396000,2,31,350,-319,0.09
202503,41396000,2S3,0,3,-3,0
202503,41396000,3,3,17,-14,0.18
202503,41396000,3S3,2,101,-99,0.02
202503,41396000,CA,1,71,-70,0.01
202503,41483000,2,0,8,-8,0
202503,41483000,3,0,2,-2,0
202503,41503000,2,1,11,-10,0.09
202503,41503000,3,1,0,1,NA
202503,41503000,CA,0,23,-23,0
202503,41518000,2,58,13,45,4.46
202503,41518000,3,219,20,199,10.95
202503,41518000,3S1,0,2,-2,0
202503,41518000,3S3,1,8,-7,0.12
202503,41518000,3S4,0,1,-1,0
202503,41518000,CA,4,7,-3,0.57
202503,41524000,2,116,253,-137,0.46
202503,41524000,2S2,0,17,-17,0
202503,41524000,2S3,3,4,-1,0.75
202503,41524000,3,10,9,1,1.11
202503,41524000,3S2,11,37,-26,0.3
202503,41524000,3S3,355,399,-44,0.89
202503,41524000,4,4,2,2,2
202503,41524000,CA,31,55,-24,0.56
202503,41524001,2,0,1,-1,0
202503,41524001,3S3,0,4,-4,0
202503,41524006,2,0,1,-1,0
202503,41530000,2,3,19,-16,0.16
202503,41530000,2S3,0,2,-2,0
202503,41530000,3,1,2,-1,0.5
202503,41530000,3S3,0,3,-3,0
202503,41530000,CA,0,25,-25,0
202503,41548000,2,8,10,-2,0.8
202503,41548000,3S3,0,2,-2,0
202503,41548000,CA,0,6,-6,0
202503,41551000,2,504,2025,-1521,0.25
202503,41551000,2R2,0,1,-1,0
202503,41551000,2S2,8,45,-37,0.18
202503,41551000,2S3,2,64,-62,0.03
202503,41551000,3,10,73,-63,0.14
202503,41551000,3S2,28,60,-32,0.47
202503,41551000,3S3,99,457,-358,0.22
202503,41551000,4,0,2,-2,0
202503,41551000,CA,152,253,-101,0.6
202503,41551000,V3,2,6,-4,0.33
202503,41551001,2,24,25,-1,0.96
202503,41551001,3,1,2,-1,0.5
202503,41551001,3S3,4,9,-5,0.44
202503,41551001,CA,2,25,-23,0.08
202503,41551008,2,1,1,0,1
202503,41551008,2S3,2,0,2,NA
202503,41551008,3S3,6,0,6,NA
202503,41615000,2,128,83,45,1.54
202503,41615000,2S3,60,0,60,NA
202503,41615000,3,21,24,-3,0.88
202503,41615000,3S2,2,0,2,NA
202503,41615000,3S3,175,225,-50,0.78
202503,41615000,CA,32,59,-27,0.54
202503,41615000,V3,0,24,-24,0
202503,41615001,2,1,2,-1,0.5
202503,41615001,CA,0,1,-1,0
202503,41660000,2,0,20,-20,0
202503,41660000,3,0,10,-10,0
202503,41660000,3S3,0,3,-3,0
202503,41660000,CA,0,2,-2,0
202503,41668000,2,29,212,-183,0.14
202503,41668000,2S2,0,2,-2,0
202503,41668000,2S3,1,0,1,NA
202503,41668000,3,2,7,-5,0.29
202503,41668000,3S3,2,29,-27,0.07
202503,41668000,CA,1,23,-22,0.04
202503,41668007,2,0,2,-2,0
202503,41676000,2,0,16,-16,0
202503,41676000,CA,1,7,-6,0.14
202503,41770000,2,1,60,-59,0.02
202503,41770000,3,0,5,-5,0
202503,41770000,3S2,1,6,-5,0.17
202503,41770000,3S3,5,24,-19,0.21
202503,41770000,CA,0,1,-1,0
202503,41770001,2,0,8,-8,0
202503,41770002,2,0,1,-1,0
202503,41791000,2,1,15,-14,0.07
202503,41791000,2S3,0,1,-1,0
202503,41791000,3,1,0,1,NA
202503,41791000,3S3,0,13,-13,0
202503,41791000,CA,0,2,-2,0
202503,41797000,2,4,106,-102,0.04
202503,41797000,2S2,0,16,-16,0
202503,41797000,3,10,204,-194,0.05
202503,41797000,3S1,1,0,1,NA
202503,41797000,3S2,3,4,-1,0.75
202503,41797000,3S3,166,85,81,1.95
202503,41797000,3S4,2,5,-3,0.4
202503,41797000,CA,4,15,-11,0.27
202503,41797001,2,0,1,-1,0
202503,41797001,3,0,2,-2,0
202503,41799000,2,0,22,-22,0
202503,41799000,3,0,1,-1,0
202503,41799000,3S2,0,38,-38,0
202503,41799000,3S3,4,5,-1,0.8
202503,41799000,CA,0,2,-2,0
202503,41801000,2,0,18,-18,0
202503,41801000,3,0,1,-1,0
202503,41801000,CA,0,30,-30,0
202503,41807000,2,5,59,-54,0.08
202503,41807000,3,1,5,-4,0.2
202503,41807000,3S2,0,1,-1,0
202503,41807000,3S3,0,122,-122,0
202503,41807000,CA,1,7,-6,0.14
202503,41872000,2,1,12,-11,0.08
202503,41872000,3,0,1,-1,0
202503,41872000,3S2,31,0,31,NA
202503,41872000,3S3,4,5,-1,0.8
202503,41872000,CA,0,17,-17,0
202503,41872003,3S3,3,0,3,NA
202503,41885000,2,1,28,-27,0.04
202503,41885000,2S3,0,1,-1,0
202503,41885000,3,1,2,-1,0.5
202503,41885000,3S2,2,1,1,2
202503,41885000,3S3,10,8,2,1.25
202503,41885000,4,1,0,1,NA
202503,41885000,CA,0,11,-11,0
202503,44001000,2,377,1547,-1170,0.24
202503,44001000,2B1,0,1,-1,0
202503,44001000,2R2,0,27,-27,0
202503,44001000,2S2,7,36,-29,0.19
202503,44001000,2S3,5,24,-19,0.21
202503,44001000,3,6,39,-33,0.15
202503,44001000,3S2,7,26,-19,0.27
202503,44001000,3S3,166,452,-286,0.37
202503,44001000,3S4,0,4,-4,0
202503,44001000,4,0,2,-2,0
202503,44001000,CA,86,223,-137,0.39
202503,44001000,V2,5,0,5,NA
202503,44001000,V3,22,1,21,22
202503,44001001,2,0,4,-4,0
202503,44001002,3S2,8,8,0,1
202503,44001002,3S3,0,7,-7,0
202503,44001003,2,0,1,-1,0
202503,44001003,2S2,0,1,-1,0
202503,44001003,3S3,0,2,-2,0
202503,44001011,2,3,0,3,NA
202503,44001011,2S3,0,1,-1,0
202503,44001011,3S2,2,1,1,2
202503,44001011,3S3,1,0,1,NA
202503,44001016,2,1,0,1,NA
202503,44001016,2S3,1,0,1,NA
202503,44001016,3S3,0,1,-1,0
202503,44001020,3S2,21,0,21,NA
202503,44001020,3S3,6,0,6,NA
202503,44001025,3S2,73,1,72,73
202503,44001025,3S3,11,0,11,NA
202503,44001025,V3R3,21,0,21,NA
202503,44001026,CA,1,0,1,NA
202503,44001027,2,3,0,3,NA
202503,44035000,2,49,262,-213,0.19
202503,44035000,2S2,127,70,57,1.81
202503,44035000,2S3,9,12,-3,0.75
202503,44035000,3,0,3,-3,0
202503,44035000,3S2,12,19,-7,0.63
202503,44035000,3S3,121,214,-93,0.57
202503,44035000,3S4,7,1,6,7
202503,44035000,CA,4,67,-63,0.06
202503,44035001,2,18,26,-8,0.69
202503,44035001,2S2,0,7,-7,0
202503,44035001,2S3,1,1,0,1
202503,44035001,3,1,0,1,NA
202503,44035001,3S2,2,1,1,2
202503,44035001,3S3,5,16,-11,0.31
202503,44035001,CA,2,1,1,2
202503,44078000,2,15,106,-91,0.14
202503,44078000,2S2,1,1,0,1
202503,44078000,2S3,0,1,-1,0
202503,44078000,3,0,2,-2,0
202503,44078000,3S2,1,0,1,NA
202503,44078000,3S3,0,51,-51,0
202503,44078000,CA,0,28,-28,0
202503,44078000,V2,5,0,5,NA
202503,44078000,V3,4,0,4,NA
202503,44078006,2,0,1,-1,0
202503,44090000,2,11,97,-86,0.11
202503,44090000,2S2,1,2,-1,0.5
202503,44090000,2S3,3,2,1,1.5
202503,44090000,3S2,0,1,-1,0
202503,44090000,3S3,45,1752,-1707,0.03
202503,44090000,3S4,0,1,-1,0
202503,44090000,CA,1,24,-23,0.04
202503,44090003,2,11,19,-8,0.58
202503,44090003,2S3,0,1,-1,0
202503,44090003,3R3,0,6,-6,0
202503,44090003,3S2,1,14,-13,0.07
202503,44090003,3S3,41,2778,-2737,0.01
202503,44090003,CA,2,4,-2,0.5
202503,44090004,2,11,17,-6,0.65
202503,44090004,2S2,0,1,-1,0
202503,44090004,3S3,2,14,-12,0.14
202503,44090004,CA,4,16,-12,0.25
202503,44098000,2,4,8,-4,0.5
202503,44098000,3S3,8,10,-2,0.8
202503,44098000,CA,2,3,-1,0.67
202503,44098001,2,0,4,-4,0
202503,44098001,3,0,1,-1,0
202503,44098002,2,0,1,-1,0
202503,44110000,2,0,9,-9,0
202503,44279000,2,65,310,-245,0.21
202503,44279000,2S2,4,3,1,1.33
202503,44279000,2S3,1,0,1,NA
202503,44279000,3,2,9,-7,0.22
202503,44279000,3S2,2,3,-1,0.67
202503,44279000,3S3,45,113,-68,0.4
202503,44279000,CA,1,54,-53,0.02
202503,44279002,2,0,1,-1,0
202503,44279002,3S3,0,2,-2,0
202503,44378000,2,36,119,-83,0.3
202503,44378000,2S2,0,1,-1,0
202503,44378000,3S3,363,17,346,21.35
202503,44378000,3S4,2,0,2,NA
202503,44378000,CA,1,20,-19,0.05
202503,44420000,2,0,3,-3,0
202503,44430000,2,286,2263,-1977,0.13
202503,44430000,2B1,0,1,-1,0
202503,44430000,2R2,0,25,-25,0
202503,44430000,2S2,5,92,-87,0.05
202503,44430000,2S3,6,40,-34,0.15
202503,44430000,3,11,91,-80,0.12
202503,44430000,3S2,4,42,-38,0.1
202503,44430000,3S3,59,1004,-945,0.06
202503,44430000,CA,9,230,-221,0.04
202503,44430000,V2,0,3,-3,0
202503,44430000,V3,1,18,-17,0.06
202503,44430002,3S3,0,1,-1,0
202503,44430005,3S2,8,8,0,1
202503,44430007,2,7,97,-90,0.07
202503,44430007,2B2,0,1,-1,0
202503,44430007,2R2,0,3,-3,0
202503,44430007,2S2,10,14,-4,0.71
202503,44430007,2S3,6,14,-8,0.43
202503,44430007,3,0,3,-3,0
202503,44430007,3S2,27,42,-15,0.64
202503,44430007,3S3,100,352,-252,0.28
202503,44430007,3S4,0,1,-1,0
202503,44430007,CA,1,21,-20,0.05
202503,44560000,2,5,83,-78,0.06
202503,44560000,2S2,1,6,-5,0.17
202503,44560000,2S3,0,1,-1,0
202503,44560000,3,0,1,-1,0
202503,44560000,3S2,1,0,1,NA
202503,44560000,3S3,1,34,-33,0.03
202503,44560000,CA,2,12,-10,0.17
202503,44560000,V2,0,1,-1,0
202503,44560000,V3,0,1,-1,0
202503,44560001,2,1,0,1,NA
202503,44560003,2S3,1,0,1,NA
202503,44560003,3S3,0,1,-1,0
202503,44560007,2,0,4,-4,0
202503,44560007,2S3,0,1,-1,0
202503,44560007,3S3,3,3,0,1
202503,44650000,2,23,127,-104,0.18
202503,44650000,2R2,0,1,-1,0
202503,44650000,3,0,3,-3,0
202503,44650000,3S2,0,3,-3,0
202503,44650000,3S3,6,28,-22,0.21
202503,44650000,CA,2,23,-21,0.09
202503,44650012,2,1,0,1,NA
202503,44847000,2,203,283,-80,0.72
202503,44847000,2R2,3,0,3,NA
202503,44847000,2S2,7,3,4,2.33
202503,44847000,2S3,3,5,-2,0.6
202503,44847000,3,4,6,-2,0.67
202503,44847000,3S2,8,24,-16,0.33
202503,44847000,3S3,425,228,197,1.86
202503,44847000,3S4,1,0,1,NA
202503,44847000,CA,1,62,-61,0.02
202503,44855000,2,2,17,-15,0.12
202503,44855000,3S3,0,1,-1,0
202503,44855000,CA,0,7,-7,0
202503,44874000,2,4,107,-103,0.04
202503,44874000,2S3,2,0,2,NA
202503,44874000,3,0,1,-1,0
202503,44874000,3S2,0,1,-1,0
202503,44874000,3S3,0,14,-14,0
202503,44874000,CA,0,21,-21,0
202503,47001000,2,2346,6437,-4091,0.36
202503,47001000,2R2,1,213,-212,0
202503,47001000,2S2,645,951,-306,0.68
202503,47001000,2S3,151,251,-100,0.6
202503,47001000,3,82,223,-141,0.37
202503,47001000,3S1,1,1,0,1
202503,47001000,3S2,1331,2638,-1307,0.5
202503,47001000,3S3,13033,8078,4955,1.61
202503,47001000,3S4,9,7,2,1.29
202503,47001000,4,0,4,-4,0
202503,47001000,CA,654,1230,-576,0.53
202503,47001000,V2,4,0,4,NA
202503,47001000,V3,6,0,6,NA
202503,47001000,V3R3,23,43,-20,0.53
202503,47001000,V4,2,0,2,NA
202503,47001001,2,0,1,-1,0
202503,47001002,2,1,3,-2,0.33
202503,47001002,3S2,1,1,0,1
202503,47001003,2,0,1,-1,0
202503,47001003,3S2,22,0,22,NA
202503,47001003,3S3,2,2,0,1
202503,47001005,2,3,2,1,1.5
202503,47001005,3S2,0,1,-1,0
202503,47001005,3S3,0,4,-4,0
202503,47001006,2,10,21,-11,0.48
202503,47001006,3S2,59,46,13,1.28
202503,47001006,3S3,0,6,-6,0
202503,47001006,CA,1,1,0,1
202503,47001009,CA,0,4,-4,0
202503,47001010,2,0,11,-11,0
202503,47001010,3,0,1,-1,0
202503,47001010,3S3,0,1,-1,0
202503,47001010,CA,0,4,-4,0
202503,47001011,2,1,3,-2,0.33
202503,47001011,2S2,0,1,-1,0
202503,47001011,3S2,29,29,0,1
202503,47001011,CA,0,5,-5,0
202503,47001014,3S3,9,0,9,NA
202503,47001019,2,0,2,-2,0
202503,47001019,3S3,5,12,-7,0.42
202503,47030000,2,14,19,-5,0.74
202503,47030000,2S3,1,0,1,NA
202503,47030000,3S2,0,1,-1,0
202503,47030000,3S3,1,5,-4,0.2
202503,47030000,CA,0,6,-6,0
202503,47030004,2,5,2,3,2.5
202503,47053000,2,10,137,-127,0.07
202503,47053000,2S2,0,4,-4,0
202503,47053000,2S3,4,11,-7,0.36
202503,47053000,3,9,0,9,NA
202503,47053000,3S2,40,9,31,4.44
202503,47053000,3S3,216,269,-53,0.8
202503,47053000,CA,1,31,-30,0.03
202503,47053000,V2,0,1,-1,0
202503,47053000,V3R3,15,52,-37,0.29
202503,47053008,2,1,2,-1,0.5
202503,47053008,3,0,1,-1,0
202503,47053008,3S3,0,1,-1,0
202503,47053008,CA,0,1,-1,0
202503,47058000,2,24,82,-58,0.29
202503,47058000,2S2,1,0,1,NA
202503,47058000,2S3,1,0,1,NA
202503,47058000,3,0,1,-1,0
202503,47058000,3S2,5,81,-76,0.06
202503,47058000,3S3,2,123,-121,0.02
202503,47058000,4,0,1,-1,0
202503,47058000,CA,1,5,-4,0.2
202503,47058003,2,0,4,-4,0
202503,47058003,3S3,1,2,-1,0.5
202503,47058005,2,0,1,-1,0
202503,47058005,2S2,1,0,1,NA
202503,47058005,CA,0,3,-3,0
202503,47161000,2,0,2,-2,0
202503,47161000,3,0,1,-1,0
202503,47170000,2,12,46,-34,0.26
202503,47170000,3,1,3,-2,0.33
202503,47170000,3S2,1,1,0,1
202503,47170000,3S3,0,13,-13,0
202503,47170000,CA,1,2,-1,0.5
202503,47170001,2,3,0,3,NA
202503,47170003,2,0,1,-1,0
202503,47170003,3S3,0,4,-4,0
202503,47189000,2,186,1129,-943,0.16
202503,47189000,2R2,0,21,-21,0
202503,47189000,2S2,11,22,-11,0.5
202503,47189000,2S3,6,13,-7,0.46
202503,47189000,3,23,62,-39,0.37
202503,47189000,3S2,36,55,-19,0.65
202503,47189000,3S3,400,413,-13,0.97
202503,47189000,3S4,0,1,-1,0
202503,47189000,CA,12,264,-252,0.05
202503,47189004,2,0,2,-2,0
202503,47189009,2,11,2,9,5.5
202503,47189009,2S3,3,2,1,1.5
202503,47189009,3S3,4,4,0,1
202503,47189018,2,0,1,-1,0
202503,47189022,2,0,1,-1,0
202503,47189022,3S3,1,1,0,1
202503,47189023,2,0,2,-2,0
202503,47205000,2,0,9,-9,0
202503,47205001,2,0,1,-1,0
202503,47205003,2,0,2,-2,0
202503,47245000,2,53,459,-406,0.12
202503,47245000,2R2,0,11,-11,0
202503,47245000,2S3,0,2,-2,0
202503,47245000,3,0,16,-16,0
202503,47245000,3S2,0,1,-1,0
202503,47245000,3S3,6,34,-28,0.18
202503,47245000,4,0,4,-4,0
202503,47245000,CA,13,46,-33,0.28
202503,47245001,2,0,1,-1,0
202503,47245002,3S3,0,1,-1,0
202503,47245005,2,1,0,1,NA
202503,47245018,2,0,1,-1,0
202503,47258000,2,1,28,-27,0.04
202503,47258000,2S3,0,1,-1,0
202503,47258000,3S2,0,1,-1,0
202503,47258000,3S3,0,3,-3,0
202503,47258000,CA,0,5,-5,0
202503,47258003,2,0,2,-2,0
202503,47258003,CA,0,1,-1,0
202503,47258005,2,0,2,-2,0
202503,47258015,3S3,1,0,1,NA
202503,47268000,2,5,67,-62,0.07
202503,47268000,2S2,1,0,1,NA
202503,47268000,2S3,0,2,-2,0
202503,47268000,3S2,24,22,2,1.09
202503,47268000,3S3,3,4,-1,0.75
202503,47268000,CA,0,11,-11,0
202503,47288000,2,90,591,-501,0.15
202503,47288000,2S2,1,23,-22,0.04
202503,47288000,2S3,5,6,-1,0.83
202503,47288000,3,7,13,-6,0.54
202503,47288000,3S2,61,22,39,2.77
202503,47288000,3S3,110,139,-29,0.79
202503,47288000,CA,11,91,-80,0.12
202503,47288011,2,1,2,-1,0.5
202503,47318000,2,35,123,-88,0.28
202503,47318000,2R2,0,1,-1,0
202503,47318000,2S2,1,0,1,NA
202503,47318000,3,0,4,-4,0
202503,47318000,3S2,0,1,-1,0
202503,47318000,3S3,1,13,-12,0.08
202503,47318000,3S4,0,1,-1,0
202503,47318000,CA,8,28,-20,0.29
202503,47318005,2,0,2,-2,0
202503,47318005,3,0,1,-1,0
202503,47318005,3S3,1,0,1,NA
202503,47318012,2,1,6,-5,0.17
202503,47318012,3S3,1,6,-5,0.17
202503,47318012,CA,0,2,-2,0
202503,47318015,2,1,2,-1,0.5
202503,47460000,2,24,33,-9,0.73
202503,47460000,3,1,0,1,NA
202503,47460000,3S2,0,1,-1,0
202503,47460000,3S3,1,7,-6,0.14
202503,47460000,CA,1,3,-2,0.33
202503,47460000,V4,0,1,-1,0
202503,47460001,2,0,3,-3,0
202503,47460001,CA,0,3,-3,0
202503,47460002,2,8,2,6,4
202503,47460004,2,0,1,-1,0
202503,47460004,3,0,1,-1,0
202503,47460005,2,0,7,-7,0
202503,47460005,3S3,0,1,-1,0
202503,47460005,CA,0,5,-5,0
202503,47541000,2,1,5,-4,0.2
202503,47541000,CA,1,0,1,NA
202503,47545000,2,10,12,-2,0.83
202503,47545000,2S2,1,0,1,NA
202503,47545000,2S3,1,0,1,NA
202503,47545000,3S3,0,1,-1,0
202503,47551000,2,9,211,-202,0.04
202503,47551000,2S2,0,1,-1,0
202503,47551000,3S2,5,0,5,NA
202503,47551000,3S3,3,9,-6,0.33
202503,47551000,4,0,1,-1,0
202503,47551000,CA,2,39,-37,0.05
202503,47551009,2,0,2,-2,0
202503,47551009,2S3,0,1,-1,0
202503,47551009,3S3,1,1,0,1
202503,47555000,2,49,307,-258,0.16
202503,47555000,2R2,0,1,-1,0
202503,47555000,2S2,1,2,-1,0.5
202503,47555000,3,4,16,-12,0.25
202503,47555000,3S2,70,7,63,10
202503,47555000,3S3,495,38,457,13.03
202503,47555000,CA,3,42,-39,0.07
202503,47555001,2S2,1,0,1,NA
202503,47555001,3S2,27,0,27,NA
202503,47555001,3S3,76,1,75,76
202503,47555006,2,1,0,1,NA
202503,47555007,2,0,1,-1,0
202503,47570000,2,2,11,-9,0.18
202503,47570000,3S3,0,1,-1,0
202503,47570000,CA,0,13,-13,0
202503,47570004,2,1,0,1,NA
202503,47570004,2S3,0,1,-1,0
202503,47605000,2,0,20,-20,0
202503,47605000,3,0,1,-1,0
202503,47605000,CA,0,3,-3,0
202503,47660000,2,13,6,7,2.17
202503,47660000,3,0,2,-2,0
202503,47660000,3S2,0,1,-1,0
202503,47660000,3S3,4,2,2,2
202503,47660000,CA,0,2,-2,0
202503,47660011,2,2,1,1,2
202503,47660011,2S2,2,0,2,NA
202503,47675000,2,0,13,-13,0
202503,47675000,3S2,0,1,-1,0
202503,47675000,3S3,0,2,-2,0
202503,47675000,3S4,0,1,-1,0
202503,47675000,CA,0,4,-4,0
202503,47675001,2,0,2,-2,0
202503,47675001,3,1,0,1,NA
202503,47692000,2,6,43,-37,0.14
202503,47692000,3,0,12,-12,0
202503,47692000,3S3,159,7,152,22.71
202503,47692000,CA,0,3,-3,0
202503,47692001,3,0,1,-1,0
202503,47703000,2,0,20,-20,0
202503,47707000,2,11,74,-63,0.15
202503,47707000,3,0,3,-3,0
202503,47707000,3S3,1,31,-30,0.03
202503,47707000,3S4,0,4,-4,0
202503,47707000,CA,1,1,0,1
202503,47707001,2,0,4,-4,0
202503,47707004,2,2,0,2,NA
202503,47720000,2,2,5,-3,0.4
202503,47745000,2,19,40,-21,0.48
202503,47745000,2S2,2,94,-92,0.02
202503,47745000,2S3,85,1,84,85
202503,47745000,3,18,6,12,3
202503,47745000,3S2,178,17,161,10.47
202503,47745000,3S3,3694,1119,2575,3.3
202503,47745000,3S4,2,1,1,2
202503,47745000,CA,1,8,-7,0.12
202503,47745000,V2,62,1,61,62
202503,47745000,V3,420,17,403,24.71
202503,47745000,V4,66,0,66,NA
202503,47745003,2,271,77,194,3.52
202503,47745003,2S2,1,3,-2,0.33
202503,47745003,2S3,16,9,7,1.78
202503,47745003,3,92,6,86,15.33
202503,47745003,3S1,0,4,-4,0
202503,47745003,3S2,32,25,7,1.28
202503,47745003,3S3,1707,2799,-1092,0.61
202503,47745003,3S4,1,2,-1,0.5
202503,47745003,CA,9,15,-6,0.6
202503,47745003,V2,0,41,-41,0
202503,47745003,V3,0,172,-172,0
202503,47798000,2,12,6,6,2
202503,47798000,3,1,0,1,NA
202503,47798000,3S2,0,1,-1,0
202503,47798000,3S3,0,1,-1,0
202503,47960000,2,0,6,-6,0
202503,47960000,2S3,1,0,1,NA
202503,47960000,3,0,2,-2,0
202503,47980000,2,156,144,12,1.08
202503,47980000,3,0,4,-4,0
202503,47980000,3S2,555,151,404,3.68
202503,47980000,3S3,29,13,16,2.23
202503,47980000,CA,1,30,-29,0.03
202503,47980001,2,84,33,51,2.55
202503,47980001,2S2,1,0,1,NA
202503,47980001,3S2,123,59,64,2.08
202503,47980001,3S3,8,9,-1,0.89
202503,47980001,CA,0,1,-1,0
202503,47980002,2,8,12,-4,0.67
202503,47980002,2S2,1,0,1,NA
202503,47980002,2S3,2,0,2,NA
202503,47980002,3S2,2,0,2,NA
202503,47980002,3S3,7,8,-1,0.88
202503,47980002,3S3S2,0,2,-2,0
202503,47980003,2,0,5,-5,0
202503,47980003,2R2,0,2,-2,0
202503,47980003,2S2,1,0,1,NA
202503,47980003,2S3,0,2,-2,0
202503,47980003,3S2,53,0,53,NA
202503,47980003,3S3,10,21,-11,0.48
202503,47980004,2,152,79,73,1.92
202503,47980004,2R2,0,10,-10,0
202503,47980004,2S3,0,1,-1,0
202503,47980004,3S2,260,219,41,1.19
202503,47980004,3S3,4,8,-4,0.5
202503,47980004,CA,1,10,-9,0.1
202503,47980006,2,95,98,-3,0.97
202503,47980006,2S2,0,2,-2,0
202503,47980006,2S3,2,1,1,2
202503,47980006,3,0,3,-3,0
202503,47980006,3S2,0,2,-2,0
202503,47980006,3S3,18,29,-11,0.62
202503,47980006,CA,0,5,-5,0
202503,47980007,3S2,0,2,-2,0
202503,47980007,3S3,0,4,-4,0
202503,47980007,CA,0,1,-1,0
202503,47980008,2,102,69,33,1.48
202503,47980008,2S2,1,0,1,NA
202503,47980008,3S2,208,160,48,1.3
202503,47980008,3S3,11,7,4,1.57
202503,47980008,CA,0,1,-1,0
202503,47980010,2,18,23,-5,0.78
202503,47980010,2S2,1,0,1,NA
202503,47980010,2S3,0,1,-1,0
202503,47980010,3,0,2,-2,0
202503,47980010,3S2,178,40,138,4.45
202503,47980010,3S3,46,4,42,11.5
202503,47980010,CA,2,3,-1,0.67
202503,47980010,V3R3,13,0,13,NA
202503,47980011,2,0,2,-2,0
202503,47980011,3S2,0,2,-2,0
202503,47980011,3S3,1,1,0,1
202503,47980012,2,0,5,-5,0
202503,47980012,3S3,6,0,6,NA
202503,47980013,2,2,1,1,2
202503,47980013,3,0,1,-1,0
202503,47980013,3S2,3,2,1,1.5
202503,47980013,3S3,1,0,1,NA
202503,47980014,2S2,0,1,-1,0
202503,47980015,2,0,1,-1,0
202503,50001000,2,3446,6088,-2642,0.57
202503,50001000,2R2,53,16,37,3.31
202503,50001000,2S1,0,3,-3,0
202503,50001000,2S2,184,751,-567,0.25
202503,50001000,2S3,66,125,-59,0.53
202503,50001000,3,421,510,-89,0.83
202503,50001000,3S1,3,7,-4,0.43
202503,50001000,3S2,873,1321,-448,0.66
202503,50001000,3S3,2202,3742,-1540,0.59
202503,50001000,3S4,5,9,-4,0.56
202503,50001000,4,20,14,6,1.43
202503,50001000,CA,1101,1907,-806,0.58
202503,50001000,V2,1,10,-9,0.1
202503,50001000,V2R3,2,0,2,NA
202503,50001000,V3,68,12,56,5.67
202503,50001000,V3R3,62,0,62,NA
202503,50001001,3,0,1,-1,0
202503,50001001,3S2,0,1,-1,0
202503,50001001,3S3,1,12,-11,0.08
202503,50001001,CA,1,2,-1,0.5
202503,50001002,2,1,13,-12,0.08
202503,50001002,2S2,0,1,-1,0
202503,50001002,2S3,1,4,-3,0.25
202503,50001002,3S2,1,12,-11,0.08
202503,50001002,3S3,9,96,-87,0.09
202503,50001002,3S4,3,0,3,NA
202503,50001002,CA,1,3,-2,0.33
202503,50001004,2,0,2,-2,0
202503,50001004,3S3,0,2,-2,0
202503,50001013,2,1,0,1,NA
202503,50001015,2,22,19,3,1.16
202503,50001015,2S2,0,2,-2,0
202503,50001015,3S1,1,0,1,NA
202503,50001015,3S3,4,76,-72,0.05
202503,50001015,CA,6,4,2,1.5
202503,50001019,2,68,11,57,6.18
202503,50001019,2S2,1,1,0,1
202503,50001019,2S3,5,1,4,5
202503,50001019,3,64,0,64,NA
202503,50001019,3S2,40,4,36,10
202503,50001019,3S3,49,104,-55,0.47
202503,50001019,CA,1,8,-7,0.12
202503,50006000,2,367,963,-596,0.38
202503,50006000,2R2,0,7,-7,0
202503,50006000,2S2,45,50,-5,0.9
202503,50006000,2S3,11,28,-17,0.39
202503,50006000,3,168,93,75,1.81
202503,50006000,3R2,1,29,-28,0.03
202503,50006000,3S1,9,6,3,1.5
202503,50006000,3S2,2041,138,1903,14.79
202503,50006000,3S3,1120,750,370,1.49
202503,50006000,3S4,2,4,-2,0.5
202503,50006000,4,4,4,0,1
202503,50006000,CA,40,266,-226,0.15
202503,50006000,V2,2,126,-124,0.02
202503,50006000,V3,177,450,-273,0.39
202503,50006000,V3R2,0,23,-23,0
202503,50006000,V3R3,0,2,-2,0
202503,50006001,2,3,3,0,1
202503,50006001,3S2,1,0,1,NA
202503,50006001,3S3,1,1,0,1
202503,50006001,CA,0,1,-1,0
202503,50006003,2,10,59,-49,0.17
202503,50006003,2S2,3,7,-4,0.43
202503,50006003,2S3,3,1,2,3
202503,50006003,3,0,2,-2,0
202503,50006003,3S1,1,0,1,NA
202503,50006003,3S2,15,35,-20,0.43
202503,50006003,3S3,16,99,-83,0.16
202503,50006003,3S4,0,2,-2,0
202503,50006003,CA,10,11,-1,0.91
202503,50006003,V2,0,1,-1,0
202503,50006003,V3,0,13,-13,0
202503,50110000,2,33,87,-54,0.38
202503,50110000,2S1,0,6,-6,0
202503,50110000,2S2,3,12,-9,0.25
202503,50110000,2S3,6,9,-3,0.67
202503,50110000,3,4,92,-88,0.04
202503,50110000,3S1,0,5,-5,0
202503,50110000,3S2,600,34,566,17.65
202503,50110000,3S3,1169,190,979,6.15
202503,50110000,3S4,1,8,-7,0.12
202503,50110000,4,0,1,-1,0
202503,50110000,CA,6,40,-34,0.15
202503,50110000,V2,0,3,-3,0
202503,50110000,V3,19,120,-101,0.16
202503,50110001,3S3,14,0,14,NA
202503,50110004,3,0,1,-1,0
202503,50110004,3S3,0,6,-6,0
202503,50124000,2,16,75,-59,0.21
202503,50124000,2S1,4,0,4,NA
202503,50124000,2S2,6,4,2,1.5
202503,50124000,2S3,16,4,12,4
202503,50124000,3,5,42,-37,0.12
202503,50124000,3S1,13,0,13,NA
202503,50124000,3S2,1421,21,1400,67.67
202503,50124000,3S3,2768,107,2661,25.87
202503,50124000,3S4,36,2,34,18
202503,50124000,CA,1,3,-2,0.33
202503,50124000,V2,0,88,-88,0
202503,50124000,V3,178,571,-393,0.31
202503,50124004,2S3,0,4,-4,0
202503,50124004,3S3,0,3,-3,0
202503,50150000,2,70,239,-169,0.29
202503,50150000,2S1,0,2,-2,0
202503,50150000,2S2,9,30,-21,0.3
202503,50150000,2S3,4,15,-11,0.27
202503,50150000,3,1,89,-88,0.01
202503,50150000,3S1,4,12,-8,0.33
202503,50150000,3S2,182,374,-192,0.49
202503,50150000,3S3,112,257,-145,0.44
202503,50150000,3S4,0,3,-3,0
202503,50150000,4,1,4,-3,0.25
202503,50150000,CA,9,58,-49,0.16
202503,50150000,V2,16,58,-42,0.28
202503,50150000,V3,28,52,-24,0.54
202503,50150001,3S2,0,2,-2,0
202503,50150001,CA,0,2,-2,0
202503,50150002,2,1,0,1,NA
202503,50223000,2,2,16,-14,0.12
202503,50223000,2S2,0,1,-1,0
202503,50223000,3,2,2,0,1
202503,50223000,3S3,2,4,-2,0.5
202503,50223000,CA,0,14,-14,0
202503,50226000,2,47,197,-150,0.24
202503,50226000,2R2,0,4,-4,0
202503,50226000,2S2,1,1,0,1
202503,50226000,2S3,1,7,-6,0.14
202503,50226000,3,9,60,-51,0.15
202503,50226000,3S2,89,10,79,8.9
202503,50226000,3S3,238,76,162,3.13
202503,50226000,CA,15,110,-95,0.14
202503,50226000,V3,0,1,-1,0
202503,50226004,2,0,2,-2,0
202503,50226004,3S3,0,2,-2,0
202503,50226004,CA,1,0,1,NA
202503,50226005,2,1,0,1,NA
202503,50226005,CA,1,2,-1,0.5
202503,50245000,CA,1,0,1,NA
202503,50251000,2,12,32,-20,0.38
202503,50251000,2S2,0,1,-1,0
202503,50251000,3S3,0,10,-10,0
202503,50251000,CA,1,18,-17,0.06
202503,50270000,2,0,8,-8,0
202503,50270000,2S2,0,1,-1,0
202503,50270000,3,0,3,-3,0
202503,50270000,CA,0,2,-2,0
202503,50287000,2,0,56,-56,0
202503,50287000,2R2,0,2,-2,0
202503,50287000,2S2,0,1,-1,0
202503,50287000,2S3,0,1,-1,0
202503,50287000,3,0,1,-1,0
202503,50287000,3S3,1,20,-19,0.05
202503,50287000,CA,0,13,-13,0
202503,50313000,2,142,1125,-983,0.13
202503,50313000,2R2,0,5,-5,0
202503,50313000,2S2,4,14,-10,0.29
202503,50313000,2S3,1,2,-1,0.5
202503,50313000,3,67,35,32,1.91
202503,50313000,3S2,4,36,-32,0.11
202503,50313000,3S3,201,350,-149,0.57
202503,50313000,4,0,1,-1,0
202503,50313000,CA,22,293,-271,0.08
202503,50313000,V3,206,0,206,NA
202503,50313002,2,0,52,-52,0
202503,50313002,2S2,0,1,-1,0
202503,50313002,CA,3,1,2,3
202503,50313006,2,0,5,-5,0
202503,50313007,3S2,0,1,-1,0
202503,50313007,CA,0,1,-1,0
202503,50318000,2,101,198,-97,0.51
202503,50318000,2R2,0,3,-3,0
202503,50318000,2S2,6,6,0,1
202503,50318000,2S3,3,2,1,1.5
202503,50318000,3,337,44,293,7.66
202503,50318000,3S1,4,0,4,NA
202503,50318000,3S2,1531,273,1258,5.61
202503,50318000,3S3,886,281,605,3.15
202503,50318000,4,6,0,6,NA
202503,50318000,CA,20,72,-52,0.28
202503,50318000,V2,194,7,187,27.71
202503,50318000,V3,652,38,614,17.16
202503,50318001,2,0,2,-2,0
202503,50318001,3S2,1,0,1,NA
202503,50318004,3,0,15,-15,0
202503,50318004,3S2,0,61,-61,0
202503,50325000,2,6,9,-3,0.67
202503,50325000,3,0,1,-1,0
202503,50325000,3S2,22,0,22,NA
202503,50325000,3S3,86,18,68,4.78
202503,50325000,CA,1,1,0,1
202503,50330000,2,2,50,-48,0.04
202503,50330000,2R2,0,4,-4,0
202503,50330000,3S2,1,0,1,NA
202503,50330000,3S3,0,3,-3,0
202503,50330000,4,3,1,2,3
202503,50330000,CA,1,4,-3,0.25
202503,50330008,2,0,1,-1,0
202503,50350000,2,9,18,-9,0.5
202503,50350000,3,0,1,-1,0
202503,50350000,CA,1,0,1,NA
202503,50350003,2,0,1,-1,0
202503,50350003,CA,1,0,1,NA
202503,50370000,2,0,20,-20,0
202503,50370000,3,0,1,-1,0
202503,50370000,3S3,2,9,-7,0.22
202503,50370000,CA,1,3,-2,0.33
202503,50370001,2,2,0,2,NA
202503,50370001,CA,1,0,1,NA
202503,50400000,2,0,28,-28,0
202503,50400000,3S3,0,7,-7,0
202503,50400000,CA,1,33,-32,0.03
202503,50400001,2,0,1,-1,0
202503,50400001,3S3,0,3,-3,0
202503,50450000,2,3,16,-13,0.19
202503,50450000,2S3,2,0,2,NA
202503,50450000,3,0,1,-1,0
202503,50450000,3S3,0,11,-11,0
202503,50450000,3S4,2,0,2,NA
202503,50450000,CA,3,0,3,NA
202503,50450001,2,1,1,0,1
202503,50568000,2,211,939,-728,0.22
202503,50568000,2R2,0,7,-7,0
202503,50568000,2S1,2,1,1,2
202503,50568000,2S2,44,49,-5,0.9
202503,50568000,2S3,22,24,-2,0.92
202503,50568000,3,34,74,-40,0.46
202503,50568000,3R2,0,4,-4,0
202503,50568000,3R3,0,5,-5,0
202503,50568000,3S1,4,0,4,NA
202503,50568000,3S2,1547,475,1072,3.26
202503,50568000,3S3,3314,1821,1493,1.82
202503,50568000,3S4,21,3,18,7
202503,50568000,4,1,0,1,NA
202503,50568000,CA,40,205,-165,0.2
202503,50568000,V2R2,0,1,-1,0
202503,50568000,V2R3,0,74,-74,0
202503,50568000,V3,2,4,-2,0.5
202503,50568000,V3R2,0,16,-16,0
202503,50568000,V3R3,0,229,-229,0
202503,50568000,V4,3,0,3,NA
202503,50568001,2,1,10,-9,0.1
202503,50568001,3S3,5,0,5,NA
202503,50568002,2,0,2,-2,0
202503,50568002,3S3,0,10,-10,0
202503,50568005,3S2,2,1,1,2
202503,50568006,2,0,1,-1,0
202503,50568006,3S3,1,0,1,NA
202503,50568007,2,4,4,0,1
202503,50568007,3,0,1,-1,0
202503,50568007,3S2,0,1,-1,0
202503,50568007,3S3,0,38,-38,0
202503,50568007,CA,1,1,0,1
202503,50568007,V3R2,0,9,-9,0
202503,50568007,V3R3,0,7,-7,0
202503,50568009,3S3,0,2,-2,0
202503,50568010,2,18,37,-19,0.49
202503,50568010,2S2,0,3,-3,0
202503,50568010,2S3,12,18,-6,0.67
202503,50568010,3,1,0,1,NA
202503,50568010,3S2,4,2,2,2
202503,50568010,3S3,8,47,-39,0.17
202503,50568010,3S4,0,1,-1,0
202503,50568010,CA,2,10,-8,0.2
202503,50568011,2,62,236,-174,0.26
202503,50568011,2R3,0,1,-1,0
202503,50568011,2S1,1,0,1,NA
202503,50568011,2S2,5,26,-21,0.19
202503,50568011,2S3,5,19,-14,0.26
202503,50568011,3,3,17,-14,0.18
202503,50568011,3R2,0,1,-1,0
202503,50568011,3R3,0,8,-8,0
202503,50568011,3S1,0,1,-1,0
202503,50568011,3S2,52,411,-359,0.13
202503,50568011,3S3,204,832,-628,0.25
202503,50568011,3S4,6,21,-15,0.29
202503,50568011,CA,8,51,-43,0.16
202503,50568011,V2R3,0,24,-24,0
202503,50568011,V3,3,0,3,NA
202503,50568011,V3R2,0,12,-12,0
202503,50568011,V3R3,0,152,-152,0
202503,50568011,V4R2,0,2,-2,0
202503,50573000,2,70,329,-259,0.21
202503,50573000,2R2,0,5,-5,0
202503,50573000,2R3,1,0,1,NA
202503,50573000,2S2,1,7,-6,0.14
202503,50573000,2S3,16,15,1,1.07
202503,50573000,3,14,27,-13,0.52
202503,50573000,3R2,5,0,5,NA
202503,50573000,3R3,13,0,13,NA
202503,50573000,3S1,0,1,-1,0
202503,50573000,3S2,216,19,197,11.37
202503,50573000,3S3,797,285,512,2.8
202503,50573000,4,0,2,-2,0
202503,50573000,CA,6,74,-68,0.08
202503,50573000,V2,59,0,59,NA
202503,50573000,V2R2,1,0,1,NA
202503,50573000,V2R3,93,0,93,NA
202503,50573000,V3,363,8,355,45.38
202503,50573000,V3R2,27,0,27,NA
202503,50573000,V3R3,310,0,310,NA
202503,50573000,V4R2,2,0,2,NA
202503,50573001,2S2,0,1,-1,0
202503,50573001,3S3,57,0,57,NA
202503,50573001,V3R2,9,0,9,NA
202503,50573001,V3R3,8,0,8,NA
202503,50573003,2,5,9,-4,0.56
202503,50573003,3,2,1,1,2
202503,50573003,3S3,25,5,20,5
202503,50573003,CA,1,1,0,1
202503,50573003,V2R3,2,0,2,NA
202503,50573003,V3R3,6,0,6,NA
202503,50577000,2,4,36,-32,0.11
202503,50577000,2S3,1,0,1,NA
202503,50577000,3,1,0,1,NA
202503,50577000,3S2,1,0,1,NA
202503,50577000,3S3,1,9,-8,0.11
202503,50577000,CA,1,6,-5,0.17
202503,50590000,2,7,53,-46,0.13
202503,50590000,2S2,3,6,-3,0.5
202503,50590000,2S3,2,0,2,NA
202503,50590000,3,1,63,-62,0.02
202503,50590000,3S2,29,0,29,NA
202503,50590000,3S3,104,103,1,1.01
202503,50590000,4,0,1,-1,0
202503,50590000,CA,1,7,-6,0.14
202503,50590000,V3,110,206,-96,0.53
202503,50606000,2,19,272,-253,0.07
202503,50606000,2R2,0,2,-2,0
202503,50606000,2S2,0,2,-2,0
202503,50606000,3,1,56,-55,0.02
202503,50606000,3R2,6,0,6,NA
202503,50606000,3S2,4,32,-28,0.12
202503,50606000,3S3,70,66,4,1.06
202503,50606000,CA,15,77,-62,0.19
202503,50680000,2,23,92,-69,0.25
202503,50680000,2S2,0,2,-2,0
202503,50680000,2S3,7,7,0,1
202503,50680000,3,38,31,7,1.23
202503,50680000,3R2,22,0,22,NA
202503,50680000,3S2,92,144,-52,0.64
202503,50680000,3S3,664,298,366,2.23
202503,50680000,3S4,1,0,1,NA
202503,50680000,CA,1,11,-10,0.09
202503,50680000,V2,0,4,-4,0
202503,50680000,V3,16,312,-296,0.05
202503,50680000,V3R2,23,0,23,NA
202503,50680000,V3R3,2,0,2,NA
202503,50680001,3S2,1,0,1,NA
202503,50680002,2,0,2,-2,0
202503,50680002,3S2,0,2,-2,0
202503,50680003,2,0,1,-1,0
202503,50680003,2S2,1,0,1,NA
202503,50680003,3S3,0,5,-5,0
202503,50683000,2,2,25,-23,0.08
202503,50683000,3S3,1,12,-11,0.08
202503,50683000,CA,1,7,-6,0.14
202503,50686000,CA,1,0,1,NA
202503,50689000,2,109,132,-23,0.83
202503,50689000,2R2,0,3,-3,0
202503,50689000,2S2,1,1,0,1
202503,50689000,2S3,0,1,-1,0
202503,50689000,3,11,11,0,1
202503,50689000,3S2,50,1,49,50
202503,50689000,3S3,322,95,227,3.39
202503,50689000,4,0,1,-1,0
202503,50689000,CA,58,43,15,1.35
202503,50689000,V2,0,6,-6,0
202503,50689000,V3,0,121,-121,0
202503,50711000,2,6,91,-85,0.07
202503,50711000,2S2,1,0,1,NA
202503,50711000,3,1,1,0,1
202503,50711000,3S3,3,17,-14,0.18
202503,50711000,CA,3,14,-11,0.21
202503,50711000,V3,8,2,6,4
202503,50711002,3S3,0,1,-1,0
202503,52001000,2,3224,4794,-1570,0.67
202503,52001000,2B1,0,1,-1,0
202503,52001000,2S2,67,311,-244,0.22
202503,52001000,2S3,12,77,-65,0.16
202503,52001000,3,19,71,-52,0.27
202503,52001000,3S2,163,338,-175,0.48
202503,52001000,3S3,272,1410,-1138,0.19
202503,52001000,CA,1318,519,799,2.54
202503,52001001,2,38,26,12,1.46
202503,52001001,3,0,1,-1,0
202503,52001001,3S2,28,0,28,NA
202503,52001001,3S3,1,2,-1,0.5
202503,52001001,CA,21,16,5,1.31
202503,52001003,2,0,3,-3,0
202503,52001003,3S2,3,0,3,NA
202503,52001003,3S3,1,0,1,NA
202503,52001003,CA,0,17,-17,0
202503,52001004,2,0,1,-1,0
202503,52001004,3S2,0,1,-1,0
202503,52001006,2,4,9,-5,0.44
202503,52001006,3S3,0,2,-2,0
202503,52001007,2,0,1,-1,0
202503,52001010,2,0,4,-4,0
202503,52001024,CA,0,1,-1,0
202503,52001039,3S3,0,1,-1,0
202503,52001052,2,0,1,-1,0
202503,52001058,2,0,1,-1,0
202503,52001061,2,0,2,-2,0
202503,52019000,2,0,36,-36,0
202503,52019000,3,0,3,-3,0
202503,52019000,3S2,0,1,-1,0
202503,52019000,CA,0,1,-1,0
202503,52019003,2,0,6,-6,0
202503,52019003,CA,0,20,-20,0
202503,52022000,2,0,8,-8,0
202503,52022000,CA,0,21,-21,0
202503,52036000,2,0,2,-2,0
202503,52036000,CA,0,20,-20,0
202503,52051000,2,0,10,-10,0
202503,52051000,CA,0,1,-1,0
202503,52079000,2,3,109,-106,0.03
202503,52079000,3S2,0,1,-1,0
202503,52079000,3S3,0,1,-1,0
202503,52079000,CA,1,26,-25,0.04
202503,52079012,2,0,7,-7,0
202503,52079019,CA,0,2,-2,0
202503,52083000,2,6,21,-15,0.29
202503,52083000,CA,0,20,-20,0
202503,52110000,2,8,49,-41,0.16
202503,52110000,3,2,2,0,1
202503,52110000,3S3,2,8,-6,0.25
202503,52110000,CA,0,18,-18,0
202503,52203000,2,0,18,-18,0
202503,52203000,3,0,5,-5,0
202503,52203000,CA,0,30,-30,0
202503,52203001,2,0,1,-1,0
202503,52203001,CA,0,1,-1,0
202503,52203004,2,1,1,0,1
202503,52203007,2,0,5,-5,0
202503,52203007,CA,0,1,-1,0
202503,52207000,2,4,24,-20,0.17
202503,52207000,CA,0,18,-18,0
202503,52207011,2,0,1,-1,0
202503,52210000,2,0,6,-6,0
202503,52210000,CA,0,10,-10,0
202503,52215000,2,2,34,-32,0.06
202503,52215000,3,0,1,-1,0
202503,52215000,CA,0,29,-29,0
202503,52215004,2,0,1,-1,0
202503,52224000,2,0,27,-27,0
202503,52224000,3S3,8,0,8,NA
202503,52224000,CA,0,4,-4,0
202503,52227000,2,5,107,-102,0.05
202503,52227000,3,1,0,1,NA
202503,52227000,3S3,3,14,-11,0.21
202503,52227000,CA,0,36,-36,0
202503,52233000,2,1,3,-2,0.33
202503,52233000,CA,0,3,-3,0
202503,52233011,2,0,1,-1,0
202503,52240000,2,9,40,-31,0.22
202503,52240000,3,1,1,0,1
202503,52240000,3S2,6,1,5,6
202503,52240000,3S3,0,4,-4,0
202503,52240000,CA,63,42,21,1.5
202503,52250000,2,0,5,-5,0
202503,52250000,CA,0,3,-3,0
202503,52250006,CA,0,3,-3,0
202503,52254000,2,0,19,-19,0
202503,52254002,2,0,2,-2,0
202503,52256000,2,0,5,-5,0
202503,52256000,CA,0,20,-20,0
202503,52256003,2,0,3,-3,0
202503,52256005,2,0,3,-3,0
202503,52256016,2,0,3,-3,0
202503,52256017,2,0,6,-6,0
202503,52256021,2,0,2,-2,0
202503,52256021,3S3,0,1,-1,0
202503,52258000,2,1,33,-32,0.03
202503,52258000,CA,0,1,-1,0
202503,52258001,2,0,1,-1,0
202503,52258003,2,0,7,-7,0
202503,52258003,CA,0,3,-3,0
202503,52260000,2,13,63,-50,0.21
202503,52260000,CA,1,23,-22,0.04
202503,52260009,2,0,3,-3,0
202503,52287000,2,0,6,-6,0
202503,52287000,3S3,0,1,-1,0
202503,52287000,CA,0,8,-8,0
202503,52317000,2,1,132,-131,0.01
202503,52317000,3,0,3,-3,0
202503,52317000,3S3,2,29,-27,0.07
202503,52317000,CA,0,39,-39,0
202503,52320000,2,0,27,-27,0
202503,52320000,CA,0,5,-5,0
202503,52320001,2,0,1,-1,0
202503,52320001,2S2,0,1,-1,0
202503,52320001,2S3,0,3,-3,0
202503,52320001,CA,0,4,-4,0
202503,52323000,2,0,10,-10,0
202503,52323000,3S3,0,1,-1,0
202503,52352000,2,0,22,-22,0
202503,52352000,CA,0,16,-16,0
202503,52354000,2,1,4,-3,0.25
202503,52354000,3S3,0,1,-1,0
202503,52354000,CA,0,21,-21,0
202503,52354002,2,1,0,1,NA
202503,52354002,3S3,0,1,-1,0
202503,52354004,2,0,2,-2,0
202503,52354004,3,0,1,-1,0
202503,52356000,2,583,3087,-2504,0.19
202503,52356000,2S2,42,92,-50,0.46
202503,52356000,2S3,16,33,-17,0.48
202503,52356000,3,11,30,-19,0.37
202503,52356000,3S2,65,129,-64,0.5
202503,52356000,3S3,988,899,89,1.1
202503,52356000,3S4,0,1,-1,0
202503,52356000,CA,193,324,-131,0.6
202503,52356001,CA,0,1,-1,0
202503,52356002,2,0,1,-1,0
202503,52356002,CA,0,2,-2,0
202503,52356003,2,0,21,-21,0
202503,52356003,3S2,0,2,-2,0
202503,52356003,3S3,0,60,-60,0
202503,52356003,CA,0,1,-1,0
202503,52356006,2,0,6,-6,0
202503,52356009,2,0,2,-2,0
202503,52378000,2,3,49,-46,0.06
202503,52378000,3,0,7,-7,0
202503,52378000,3S3,0,2,-2,0
202503,52378000,CA,1,28,-27,0.04
202503,52381000,2,0,5,-5,0
202503,52381000,3S2,1,0,1,NA
202503,52381000,CA,0,21,-21,0
202503,52385000,2,0,13,-13,0
202503,52385000,3,0,1,-1,0
202503,52385000,CA,0,12,-12,0
202503,52385007,2,0,1,-1,0
202503,52390000,CA,0,3,-3,0
202503,52399000,2,122,273,-151,0.45
202503,52399000,2S2,0,1,-1,0
202503,52399000,3,0,3,-3,0
202503,52399000,3S2,0,2,-2,0
202503,52399000,3S3,4,46,-42,0.09
202503,52399000,CA,20,72,-52,0.28
202503,52399003,3,0,2,-2,0
202503,52399014,2,0,2,-2,0
202503,52405000,2,1,27,-26,0.04
202503,52405000,CA,0,1,-1,0
202503,52405000,V2,0,2,-2,0
202503,52405001,2,0,2,-2,0
202503,52405005,2,0,1,-1,0
202503,52405005,3S3,0,3,-3,0
202503,52405007,2,0,1,-1,0
202503,52405008,2,6,0,6,NA
202503,52405008,CA,0,7,-7,0
202503,52411000,2,0,40,-40,0
202503,52411000,CA,0,27,-27,0
202503,52418000,2,0,22,-22,0
202503,52418000,CA,0,2,-2,0
202503,52427006,2,0,1,-1,0
202503,52435000,2,2,2,0,1
202503,52435000,3S2,0,1,-1,0
202503,52435000,CA,0,11,-11,0
202503,52473000,2,4,2,2,2
202503,52473000,2S2,0,1,-1,0
202503,52473000,3S3,0,1,-1,0
202503,52473000,CA,3,3,0,1
202503,52473004,CA,0,2,-2,0
202503,52473010,2,0,1,-1,0
202503,52480000,2,2,26,-24,0.08
202503,52480000,3S3,0,1,-1,0
202503,52480000,CA,0,2,-2,0
202503,52490000,CA,0,1,-1,0
202503,52506000,2,0,7,-7,0
202503,52506000,3S3,0,1,-1,0
202503,52506000,CA,0,13,-13,0
202503,52520000,CA,0,1,-1,0
202503,52520001,2,0,2,-2,0
202503,52520003,2,0,1,-1,0
202503,52540000,2,0,21,-21,0
202503,52540000,3S2,0,1,-1,0
202503,52540000,CA,0,9,-9,0
202503,52540002,2,0,8,-8,0
202503,52540005,2,0,1,-1,0
202503,52560000,2,0,11,-11,0
202503,52560000,CA,0,25,-25,0
202503,52565000,2,3,4,-1,0.75
202503,52565000,CA,0,11,-11,0
202503,52573000,2,2,30,-28,0.07
202503,52573000,CA,0,23,-23,0
202503,52573004,2,0,2,-2,0
202503,52585000,2,1,94,-93,0.01
202503,52585000,2S3,0,1,-1,0
202503,52585000,3S2,0,1,-1,0
202503,52585000,3S3,14,15,-1,0.93
202503,52585000,CA,0,41,-41,0
202503,52612000,2,3,38,-35,0.08
202503,52612000,3S3,0,1,-1,0
202503,52612000,CA,0,12,-12,0
202503,52621000,2,0,1,-1,0
202503,52678000,2,10,101,-91,0.1
202503,52678000,3S2,2,8,-6,0.25
202503,52678000,3S3,0,2,-2,0
202503,52678000,CA,1,27,-26,0.04
202503,52678017,2,2,9,-7,0.22
202503,52678017,2S2,0,8,-8,0
202503,52678017,2S3,0,4,-4,0
202503,52683000,2,27,78,-51,0.35
202503,52683000,3,0,2,-2,0
202503,52683000,3S2,1,0,1,NA
202503,52683000,3S3,2,21,-19,0.1
202503,52683000,CA,1,34,-33,0.03
202503,52683003,2,0,2,-2,0
202503,52683021,CA,0,11,-11,0
202503,52685000,2,6,45,-39,0.13
202503,52685000,3,0,1,-1,0
202503,52685000,CA,0,11,-11,0
202503,52687000,2,1,22,-21,0.05
202503,52687000,3S3,0,9,-9,0
202503,52687000,CA,1,24,-23,0.04
202503,52693000,2,1,70,-69,0.01
202503,52693000,3,0,3,-3,0
202503,52693000,3S3,1,5,-4,0.2
202503,52693000,CA,0,32,-32,0
202503,52694000,2,0,3,-3,0
202503,52694000,CA,0,1,-1,0
202503,52696000,CA,0,1,-1,0
202503,52720000,2,0,6,-6,0
202503,52720000,3S3,2,0,2,NA
202503,52720000,CA,0,6,-6,0
202503,52720001,2,3,0,3,NA
202503,52720001,3,1,0,1,NA
202503,52720001,3S2,0,2,-2,0
202503,52720006,2,0,2,-2,0
202503,52786000,2,0,84,-84,0
202503,52786000,3,0,7,-7,0
202503,52786000,3S2,0,2,-2,0
202503,52786000,CA,1,33,-32,0.03
202503,52786019,2,1,29,-28,0.03
202503,52786019,3,0,1,-1,0
202503,52786019,3S2,11,3,8,3.67
202503,52786019,3S3,1,13,-12,0.08
202503,52786019,CA,0,1,-1,0
202503,52788000,2,19,6,13,3.17
202503,52788000,3,0,1,-1,0
202503,52788000,CA,2,12,-10,0.17
202503,52788001,2,0,1,-1,0
202503,52788001,CA,0,1,-1,0
202503,52835000,2,65,1137,-1072,0.06
202503,52835000,2S2,1,10,-9,0.1
202503,52835000,3,7,35,-28,0.2
202503,52835000,3S2,5,22,-17,0.23
202503,52835000,3S3,88,217,-129,0.41
202503,52835000,3S4,0,1,-1,0
202503,52835000,CA,26,133,-107,0.2
202503,52835017,3S3,0,1,-1,0
202503,52835031,2,4,73,-69,0.05
202503,52835031,3,0,2,-2,0
202503,52835031,3S2,9,0,9,NA
202503,52835031,3S3,6,6,0,1
202503,52835031,CA,0,4,-4,0
202503,52835032,2,0,1,-1,0
202503,52835046,2,0,1,-1,0
202503,52835046,CA,0,1,-1,0
202503,52835060,2,0,4,-4,0
202503,52835062,2,0,2,-2,0
202503,52835159,2,0,1,-1,0
202503,52835160,3S3,3,0,3,NA
202503,52838000,2,26,330,-304,0.08
202503,52838000,2S2,1,2,-1,0.5
202503,52838000,2S3,1,0,1,NA
202503,52838000,3,0,8,-8,0
202503,52838000,3S3,2,49,-47,0.04
202503,52838000,CA,106,87,19,1.22
202503,52838001,3S3,0,2,-2,0
202503,52885000,2,1,20,-19,0.05
202503,52885000,3,0,1,-1,0
202503,52885000,3S3,0,2,-2,0
202503,52885000,CA,0,13,-13,0
202503,54001000,2,4570,9458,-4888,0.48
202503,54001000,2R2,89,14,75,6.36
202503,54001000,2S2,181,488,-307,0.37
202503,54001000,2S3,48,92,-44,0.52
202503,54001000,3,213,318,-105,0.67
202503,54001000,3R3,0,3,-3,0
202503,54001000,3S2,267,569,-302,0.47
202503,54001000,3S3,4498,4480,18,1
202503,54001000,3S4,6,2,4,3
202503,54001000,4,6,4,2,1.5
202503,54001000,CA,1084,1293,-209,0.84
202503,54001000,V2,306,232,74,1.32
202503,54001000,V3,112,18,94,6.22
202503,54001000,V4,83,383,-300,0.22
202503,54001001,2,1,21,-20,0.05
202503,54001001,3S3,5,35,-30,0.14
202503,54001001,CA,0,22,-22,0
202503,54001002,3,0,1,-1,0
202503,54001017,2,2,0,2,NA
202503,54001017,2S2,1,0,1,NA
202503,54001017,3S3,95,0,95,NA
202503,54001018,V2,48,0,48,NA
202503,54001025,2,0,1,-1,0
202503,54001025,3S3,0,4,-4,0
202503,54001026,3S2,1,0,1,NA
202503,54001026,3S3,0,6,-6,0
202503,54001027,2,1,0,1,NA
202503,54001027,3S3,1,0,1,NA
202503,54001027,CA,1,0,1,NA
202503,54001042,2,3,10,-7,0.3
202503,54001042,3S3,6,18,-12,0.33
202503,54001045,2,1,0,1,NA
202503,54001045,2S2,1,1,0,1
202503,54001047,2,0,9,-9,0
202503,54001047,3,0,9,-9,0
202503,54003000,2,32,340,-308,0.09
202503,54003000,3,0,9,-9,0
202503,54003000,3S2,2,1,1,2
202503,54003000,3S3,6,34,-28,0.18
202503,54003000,CA,0,11,-11,0
202503,54003012,2,0,2,-2,0
202503,54003018,2,0,3,-3,0
202503,54003020,2,0,1,-1,0
202503,54051000,2,1,30,-29,0.03
202503,54051000,2S2,0,1,-1,0
202503,54051000,CA,0,31,-31,0
202503,54099000,2,37,25,12,1.48
202503,54099000,2S2,1,0,1,NA
202503,54099000,3,17,0,17,NA
202503,54099000,3R3,3,0,3,NA
202503,54099000,3S2,2,0,2,NA
202503,54099000,3S3,352,8,344,44
202503,54099000,CA,0,1,-1,0
202503,54099000,V2,71,3,68,23.67
202503,54099000,V3,18,0,18,NA
202503,54099000,V4,2,0,2,NA
202503,54099002,2,14,1,13,14
202503,54099002,2S2,1,1,0,1
202503,54099002,3S2,1,0,1,NA
202503,54099002,3S3,3,1,2,3
202503,54099002,V2,17,8,9,2.12
202503,54099002,V3,1,0,1,NA
202503,54109000,2,0,24,-24,0
202503,54109000,3S3,1,0,1,NA
202503,54109000,CA,0,1,-1,0
202503,54128000,2,0,6,-6,0
202503,54128000,3,1,1,0,1
202503,54128000,CA,0,4,-4,0
202503,54128007,2,0,3,-3,0
202503,54172000,2,5,93,-88,0.05
202503,54172000,2S2,4,6,-2,0.67
202503,54172000,3,0,26,-26,0
202503,54172000,3S2,1,1,0,1
202503,54172000,3S3,0,6,-6,0
202503,54172000,CA,1,38,-37,0.03
202503,54172000,V2,0,24,-24,0
202503,54174000,2,31,21,10,1.48
202503,54174000,2S2,0,1,-1,0
202503,54174000,3S3,0,9,-9,0
202503,54174000,CA,0,10,-10,0
202503,54174000,V2,43,0,43,NA
202503,54206000,2,0,16,-16,0
202503,54206010,2,1,10,-9,0.1
202503,54206010,3,4,0,4,NA
202503,54206010,3S3,3,6,-3,0.5
202503,54206013,2,0,20,-20,0
202503,54206013,2S2,0,2,-2,0
202503,54206013,3,0,1,-1,0
202503,54206013,CA,0,1,-1,0
202503,54223000,2,5,13,-8,0.38
202503,54223000,3S2,1,0,1,NA
202503,54223000,CA,0,31,-31,0
202503,54239000,2,6,14,-8,0.43
202503,54239000,3,0,3,-3,0
202503,54239000,V2,30,0,30,NA
202503,54245000,2,0,8,-8,0
202503,54245000,CA,0,1,-1,0
202503,54245006,2,0,6,-6,0
202503,54250000,3S3,1,0,1,NA
202503,54261000,2,93,243,-150,0.38
202503,54261000,2S2,5,5,0,1
202503,54261000,3,15,14,1,1.07
202503,54261000,3S2,7,6,1,1.17
202503,54261000,3S3,1613,66,1547,24.44
202503,54261000,CA,0,59,-59,0
202503,54261000,V2,23,190,-167,0.12
202503,54261000,V3,5,0,5,NA
202503,54261003,2,1,10,-9,0.1
202503,54261005,2,4,0,4,NA
202503,54261005,3,1,0,1,NA
202503,54261007,2,3,2,1,1.5
202503,54261007,2S2,3,0,3,NA
202503,54261007,3S2,1,0,1,NA
202503,54261007,3S3,2,3,-1,0.67
202503,54261007,CA,0,23,-23,0
202503,54313000,2,1,2,-1,0.5
202503,54313001,2,0,1,-1,0
202503,54344000,2,0,9,-9,0
202503,54347000,V2,24,0,24,NA
202503,54377000,2,0,9,-9,0
202503,54377000,CA,0,29,-29,0
202503,54385000,2,11,29,-18,0.38
202503,54385000,2S2,0,2,-2,0
202503,54385000,3,0,3,-3,0
202503,54385000,3S3,25,4,21,6.25
202503,54385000,CA,0,14,-14,0
202503,54385000,V3,1,0,1,NA
202503,54385001,2,1,0,1,NA
202503,54398000,2,0,17,-17,0
202503,54405000,2,644,478,166,1.35
202503,54405000,2S2,2,10,-8,0.2
202503,54405000,2S3,2,5,-3,0.4
202503,54405000,3,71,13,58,5.46
202503,54405000,3S2,2,9,-7,0.22
202503,54405000,3S3,285,916,-631,0.31
202503,54405000,CA,18,170,-152,0.11
202503,54405000,V2,196,59,137,3.32
202503,54405000,V3,0,51,-51,0
202503,54405003,2,19,0,19,NA
202503,54405003,3S3,1,0,1,NA
202503,54405003,CA,0,1,-1,0
202503,54405004,2,2,2,0,1
202503,54405004,3,1,0,1,NA
202503,54418000,2,1,0,1,NA
202503,54480000,2,3,7,-4,0.43
202503,54480000,CA,0,2,-2,0
202503,54480001,2,0,4,-4,0
202503,54498000,2,210,2338,-2128,0.09
202503,54498000,2S2,1,7,-6,0.14
202503,54498000,2S3,0,4,-4,0
202503,54498000,3,5,81,-76,0.06
202503,54498000,3S2,0,7,-7,0
202503,54498000,3S2S3,0,1,-1,0
202503,54498000,3S3,31,345,-314,0.09
202503,54498000,CA,14,101,-87,0.14
202503,54498000,V2,0,1,-1,0
202503,54498000,V3,0,7,-7,0
202503,54498001,2,0,8,-8,0
202503,54498002,2,0,3,-3,0
202503,54498003,3S3,0,1,-1,0
202503,54498009,2,0,1,-1,0
202503,54498011,2,0,4,-4,0
202503,54498021,CA,0,2,-2,0
202503,54518000,2,26,463,-437,0.06
202503,54518000,2S2,1,0,1,NA
202503,54518000,3,1,11,-10,0.09
202503,54518000,3S2,4,4,0,1
202503,54518000,3S3,488,107,381,4.56
202503,54518000,3S4,7,1,6,7
202503,54518000,CA,4,77,-73,0.05
202503,54518000,V2,0,43,-43,0
202503,54518000,V3,0,30,-30,0
202503,54520000,2,5,9,-4,0.56
202503,54520000,2S2,1,1,0,1
202503,54520000,2S3,0,1,-1,0
202503,54520000,3S3,2,0,2,NA
202503,54520000,CA,0,2,-2,0
202503,54520000,V2,34,0,34,NA
202503,54520001,2S2,1,2,-1,0.5
202503,54520001,3S3,0,1,-1,0
202503,54553000,2,3,44,-41,0.07
202503,54553000,2S2,1,0,1,NA
202503,54553000,3,0,5,-5,0
202503,54553000,3S3,0,2,-2,0
202503,54553000,CA,0,31,-31,0
202503,54599000,2,0,8,-8,0
202503,54599000,CA,0,1,-1,0
202503,54660000,2,30,12,18,2.5
202503,54660000,2S2,2,0,2,NA
202503,54660000,CA,0,37,-37,0
202503,54660000,V2,33,0,33,NA
202503,54670000,2,0,4,-4,0
202503,54673000,2,5,88,-83,0.06
202503,54673000,2S2,10,2,8,5
202503,54673000,2S3,3,0,3,NA
202503,54673000,3,0,27,-27,0
202503,54673000,3S2,2,1,1,2
202503,54673000,3S3,720,4,716,180
202503,54673000,4,0,6,-6,0
202503,54673000,CA,1,40,-39,0.03
202503,54673000,V2,1,213,-212,0
202503,54673000,V3,2,324,-322,0.01
202503,54673000,V4,22,101,-79,0.22
202503,54673002,3S2,1,1,0,1
202503,54673002,3S3,0,1,-1,0
202503,54673005,3S2,0,1,-1,0
202503,54673005,3S3,96,0,96,NA
202503,54673005,V2,0,86,-86,0
202503,54673005,V3,0,7,-7,0
202503,54680000,2,0,7,-7,0
202503,54680000,3S2,1,1,0,1
202503,54680000,CA,0,31,-31,0
202503,54680000,V2,0,23,-23,0
202503,54680000,V3,3,0,3,NA
202503,54720000,2,58,87,-29,0.67
202503,54720000,2S2,1,1,0,1
202503,54720000,2S3,1,0,1,NA
202503,54720000,3,22,9,13,2.44
202503,54720000,3S2,15,1,14,15
202503,54720000,3S3,2355,22,2333,107.05
202503,54720000,4,6,0,6,NA
202503,54720000,CA,0,7,-7,0
202503,54720000,V2,132,1,131,132
202503,54720000,V3,296,0,296,NA
202503,54720000,V4,439,0,439,NA
202503,54720002,2,0,8,-8,0
202503,54720024,2,0,7,-7,0
202503,54743000,2,0,20,-20,0
202503,54743000,CA,0,10,-10,0
202503,54800000,2,0,9,-9,0
202503,54800000,CA,0,1,-1,0
202503,54810000,2,11,118,-107,0.09
202503,54810000,2S2,2,2,0,1
202503,54810000,3,0,14,-14,0
202503,54810000,3S1,1,0,1,NA
202503,54810000,3S2,10,0,10,NA
202503,54810000,3S3,523,76,447,6.88
202503,54810000,4,0,1,-1,0
202503,54810000,CA,0,29,-29,0
202503,54810000,V2,0,2,-2,0
202503,54810002,2,0,1,-1,0
202503,54810017,2,2,0,2,NA
202503,54810017,2S2,0,3,-3,0
202503,54810017,3S2,13,1,12,13
202503,54810017,3S3,161,2,159,80.5
202503,54810017,CA,0,23,-23,0
202503,54820000,2,5,43,-38,0.12
202503,54820000,2S2,0,1,-1,0
202503,54820000,3,5,2,3,2.5
202503,54820000,3S3,155,2,153,77.5
202503,54820000,CA,0,26,-26,0
202503,54820000,V3,30,3,27,10
202503,54820008,2,1,3,-2,0.33
202503,54820015,2,0,1,-1,0
202503,54874000,2,165,338,-173,0.49
202503,54874000,2S2,7,10,-3,0.7
202503,54874000,2S3,2,0,2,NA
202503,54874000,3,6,13,-7,0.46
202503,54874000,3S2,3,15,-12,0.2
202503,54874000,3S3,12,749,-737,0.02
202503,54874000,CA,3,296,-293,0.01
202503,54874000,V2,0,28,-28,0
202503,54874001,3,0,4,-4,0
202503,54874005,2,21,1,20,21
202503,54874005,3,1,0,1,NA
202503,54874005,3S3,11,0,11,NA
202503,63001000,2,1972,5101,-3129,0.39
202503,63001000,2R2,0,32,-32,0
202503,63001000,2S2,9,172,-163,0.05
202503,63001000,2S3,7,50,-43,0.14
202503,63001000,3,93,226,-133,0.41
202503,63001000,3S1,0,1,-1,0
202503,63001000,3S2,33,81,-48,0.41
202503,63001000,3S3,458,1155,-697,0.4
202503,63001000,3S4,0,1,-1,0
202503,63001000,4,18,5,13,3.6
202503,63001000,CA,429,1349,-920,0.32
202503,63001000,V2,1,1,0,1
202503,63001000,V2R2,0,2,-2,0
202503,63001001,2,4,3,1,1.33
202503,63111000,2,11,12,-1,0.92
202503,63111000,3,0,26,-26,0
202503,63130000,2,162,608,-446,0.27
202503,63130000,2S2,0,2,-2,0
202503,63130000,2S3,0,2,-2,0
202503,63130000,3,0,57,-57,0
202503,63130000,3S1,1,1,0,1
202503,63130000,3S2,114,112,2,1.02
202503,63130000,3S3,62,353,-291,0.18
202503,63130000,3S4,0,1,-1,0
202503,63130000,CA,10,184,-174,0.05
202503,63130000,V2,1,0,1,NA
202503,63130000,V2R2,0,1,-1,0
202503,63130000,V3,1,2,-1,0.5
202503,63130001,2,1,19,-18,0.05
202503,63130001,CA,0,7,-7,0
202503,63130001,V2,0,1,-1,0
202503,63130001,V2R2,1,0,1,NA
202503,63130001,V3,2,0,2,NA
202503,63130004,CA,0,2,-2,0
202503,63130012,3S3,2,0,2,NA
202503,63190000,2,64,318,-254,0.2
202503,63190000,3,1,68,-67,0.01
202503,63190000,3S3,0,8,-8,0
202503,63190000,CA,8,59,-51,0.14
202503,63212000,2,1,25,-24,0.04
202503,63212000,CA,0,7,-7,0
202503,63272000,2,69,106,-37,0.65
202503,63272000,3,0,1,-1,0
202503,63272000,3S3,0,12,-12,0
202503,63272000,CA,1,56,-55,0.02
202503,63272000,V2,0,6,-6,0
202503,63302000,2,13,25,-12,0.52
202503,63302000,3,0,1,-1,0
202503,63302000,3S3,0,4,-4,0
202503,63302000,CA,0,35,-35,0
202503,63302000,V2,1,0,1,NA
202503,63401000,2,809,911,-102,0.89
202503,63401000,2R2,27,4,23,6.75
202503,63401000,2S2,62,50,12,1.24
202503,63401000,2S3,13,21,-8,0.62
202503,63401000,3,4,22,-18,0.18
202503,63401000,3S2,222,72,150,3.08
202503,63401000,3S3,117,153,-36,0.76
202503,63401000,CA,18,178,-160,0.1
202503,63401001,2,1,0,1,NA
202503,63401001,2S2,1,1,0,1
202503,63401001,2S3,3,1,2,3
202503,63401001,3S2,0,9,-9,0
202503,63401001,3S3,12,2,10,6
202503,63401001,CA,2,0,2,NA
202503,63470000,2,92,251,-159,0.37
202503,63470000,2S2,13,12,1,1.08
202503,63470000,3,2,22,-20,0.09
202503,63470000,3S2,0,9,-9,0
202503,63470000,3S3,0,24,-24,0
202503,63470000,CA,2,109,-107,0.02
202503,63470003,2,4,12,-8,0.33
202503,63470003,3,0,3,-3,0
202503,63470003,3S2,1,0,1,NA
202503,63470003,3S3,0,1,-1,0
202503,63548000,2,54,31,23,1.74
202503,63548000,3,0,6,-6,0
202503,63548000,CA,0,18,-18,0
202503,63594000,2,129,258,-129,0.5
202503,63594000,2S2,1,2,-1,0.5
202503,63594000,3,0,78,-78,0
202503,63594000,3S2,1,0,1,NA
202503,63594000,3S3,14,26,-12,0.54
202503,63594000,4,1,1,0,1
202503,63594000,CA,1,123,-122,0.01
202503,63690000,2,8,98,-90,0.08
202503,63690000,3S3,0,1,-1,0
202503,63690000,CA,1,32,-31,0.03
202503,66001000,2,12427,9855,2572,1.26
202503,66001000,2B2,1,0,1,NA
202503,66001000,2R2,175,3,172,58.33
202503,66001000,2S1,0,3,-3,0
202503,66001000,2S2,1427,1385,42,1.03
202503,66001000,2S3,120,323,-203,0.37
202503,66001000,3,416,218,198,1.91
202503,66001000,3S1,2,6,-4,0.33
202503,66001000,3S2,625,994,-369,0.63
202503,66001000,3S3,1316,3227,-1911,0.41
202503,66001000,3S4,4,3,1,1.33
202503,66001000,4,3,9,-6,0.33
202503,66001000,CA,3146,3141,5,1
202503,66001000,V2,0,1,-1,0
202503,66001001,2,0,3,-3,0
202503,66001005,2,58,9,49,6.44
202503,66001005,3,0,18,-18,0
202503,66001010,2,0,3,-3,0
202503,66001015,2,1,4,-3,0.25
202503,66001015,2S2,1,0,1,NA
202503,66001015,2S3,2,0,2,NA
202503,66001015,3S2,0,2,-2,0
202503,66001015,3S3,1,3,-2,0.33
202503,66001018,2,1,8,-7,0.12
202503,66001018,3S3,1,13,-12,0.08
202503,66001018,CA,0,1,-1,0
202503,66001020,2,0,1,-1,0
202503,66001031,2,0,5,-5,0
202503,66001031,3S3,0,1,-1,0
202503,66001036,2,0,2,-2,0
202503,66001053,2,0,29,-29,0
202503,66001053,3S3,0,3,-3,0
202503,66001056,2,1,2,-1,0.5
202503,66001058,2,1,0,1,NA
202503,66001069,2,0,1,-1,0
202503,66001072,2,1,1,0,1
202503,66001072,3,0,4,-4,0
202503,66001080,2,32,526,-494,0.06
202503,66001080,3S2,42,0,42,NA
202503,66045000,2,30,117,-87,0.26
202503,66045000,3,2,0,2,NA
202503,66045000,3S2,0,2,-2,0
202503,66045000,3S3,1,2,-1,0.5
202503,66045000,CA,0,35,-35,0
202503,66075000,2,11,27,-16,0.41
202503,66075000,3,0,1,-1,0
202503,66075000,3S2,1,2,-1,0.5
202503,66075000,3S3,280,39,241,7.18
202503,66075000,CA,0,12,-12,0
202503,66088000,2,20,176,-156,0.11
202503,66088000,2S2,0,1,-1,0
202503,66088000,3,0,2,-2,0
202503,66088000,3S3,0,2,-2,0
202503,66088000,CA,1,77,-76,0.01
202503,66170000,2,8925,4293,4632,2.08
202503,66170000,2R2,3,1,2,3
202503,66170000,2S2,348,423,-75,0.82
202503,66170000,2S3,54,101,-47,0.53
202503,66170000,3,125,221,-96,0.57
202503,66170000,3S2,1312,826,486,1.59
202503,66170000,3S3,475,1269,-794,0.37
202503,66170000,3S4,5,0,5,NA
202503,66170000,4,2,0,2,NA
202503,66170000,CA,5989,675,5314,8.87
202503,66170011,2,0,5,-5,0
202503,66318000,2,9,84,-75,0.11
202503,66318000,3S2,10,1,9,10
202503,66318000,3S3,22,22,0,1
202503,66318000,CA,0,29,-29,0
202503,66318002,3S2,1,0,1,NA
202503,66318002,3S3,3,0,3,NA
202503,66318002,CA,0,1,-1,0
202503,66318003,CA,1,0,1,NA
202503,66383000,2,3,21,-18,0.14
202503,66383000,CA,0,17,-17,0
202503,66400000,2,1095,529,566,2.07
202503,66400000,2S2,4,20,-16,0.2
202503,66400000,2S3,7,42,-35,0.17
202503,66400000,3,10,36,-26,0.28
202503,66400000,3S2,22,71,-49,0.31
202503,66400000,3S3,89,137,-48,0.65
202503,66400000,4,0,1,-1,0
202503,66400000,CA,24,150,-126,0.16
202503,66440000,2,5,70,-65,0.07
202503,66440000,3,0,3,-3,0
202503,66440000,3S3,0,2,-2,0
202503,66440000,CA,0,55,-55,0
202503,66456000,2,2,96,-94,0.02
202503,66456000,3,0,3,-3,0
202503,66456000,CA,0,131,-131,0
202503,66572000,2,10,65,-55,0.15
202503,66572000,3,0,1,-1,0
202503,66572000,3S2,0,5,-5,0
202503,66572000,3S3,0,2,-2,0
202503,66572000,CA,1,161,-160,0.01
202503,66572001,2,1,11,-10,0.09
202503,66572001,3,0,1,-1,0
202503,66572001,CA,1,3,-2,0.33
202503,66594000,2,13,129,-116,0.1
202503,66594000,3,2,0,2,NA
202503,66594000,CA,0,51,-51,0
202503,66594002,2,7,13,-6,0.54
202503,66594002,2S2,1,2,-1,0.5
202503,66594002,3,0,1,-1,0
202503,66594002,3S3,1,38,-37,0.03
202503,66594002,3S4,0,1,-1,0
202503,66594002,CA,0,1,-1,0
202503,66594019,3S3,1,0,1,NA
202503,66682000,2,132,818,-686,0.16
202503,66682000,2R2,0,3,-3,0
202503,66682000,2S2,37,20,17,1.85
202503,66682000,2S3,3,2,1,1.5
202503,66682000,3,1,14,-13,0.07
202503,66682000,3S2,3,4,-1,0.75
202503,66682000,3S3,83,62,21,1.34
202503,66682000,3S4,0,3,-3,0
202503,66682000,CA,2,294,-292,0.01
202503,66687000,2,67,112,-45,0.6
202503,66687000,2S3,1,0,1,NA
202503,66687000,3,0,11,-11,0
202503,66687000,CA,3,20,-17,0.15
202503,68001000,2,14052,13292,760,1.06
202503,68001000,2B1,0,3,-3,0
202503,68001000,2R2,0,30,-30,0
202503,68001000,2S1,4,2,2,2
202503,68001000,2S2,159,772,-613,0.21
202503,68001000,2S3,42,224,-182,0.19
202503,68001000,3,1464,468,996,3.13
202503,68001000,3S2,513,877,-364,0.58
202503,68001000,3S2S3,0,1,-1,0
202503,68001000,3S3,2869,6475,-3606,0.44
202503,68001000,3S4,2,5,-3,0.4
202503,68001000,4,1,7,-6,0.14
202503,68001000,CA,2055,4108,-2053,0.5
202503,68001000,V2,23,393,-370,0.06
202503,68001000,V3,22,1,21,22
202503,68001002,2S2,3,0,3,NA
202503,68001005,3S3,10,2,8,5
202503,68001006,3,0,6,-6,0
202503,68001010,2,1,53,-52,0.02
202503,68001010,2S2,1,0,1,NA
202503,68001010,3,0,9,-9,0
202503,68001010,3S3,5,15,-10,0.33
202503,68001011,2,0,1,-1,0
202503,68013000,2,0,6,-6,0
202503,68013000,3,0,1,-1,0
202503,68020000,3S2,0,1,-1,0
202503,68020000,CA,0,1,-1,0
202503,68051000,2,45,207,-162,0.22
202503,68051000,3,1,44,-43,0.02
202503,68051000,3S3,3,1,2,3
202503,68051000,CA,0,13,-13,0
202503,68051000,V2,0,1,-1,0
202503,68077000,2,96,718,-622,0.13
202503,68077000,2S2,0,20,-20,0
202503,68077000,2S3,1,3,-2,0.33
202503,68077000,3,20,31,-11,0.65
202503,68077000,3S2,7,14,-7,0.5
202503,68077000,3S2S3,0,1,-1,0
202503,68077000,3S3,4,168,-164,0.02
202503,68077000,CA,15,104,-89,0.14
202503,68077000,V2,0,19,-19,0
202503,68079000,2,5,39,-34,0.13
202503,68079000,CA,1,10,-9,0.1
202503,68081000,2,1134,2850,-1716,0.4
202503,68081000,2R2,0,62,-62,0
202503,68081000,2S2,24,137,-113,0.18
202503,68081000,2S3,11,19,-8,0.58
202503,68081000,3,173,570,-397,0.3
202503,68081000,3S1,6,2,4,3
202503,68081000,3S2,428,646,-218,0.66
202503,68081000,3S2S3,2,3,-1,0.67
202503,68081000,3S3,4833,3757,1076,1.29
202503,68081000,3S3S2,3,4,-1,0.75
202503,68081000,3S4,3,7,-4,0.43
202503,68081000,4,0,10,-10,0
202503,68081000,CA,232,730,-498,0.32
202503,68081000,V2,53,8,45,6.62
202503,68081000,V3,86,34,52,2.53
202503,68081001,2,3,6,-3,0.5
202503,68081001,3,1,0,1,NA
202503,68081001,3S2S3,0,1,-1,0
202503,68081001,3S3,11,17,-6,0.65
202503,68081001,3S3S2,1,1,0,1
202503,68081001,CA,0,3,-3,0
202503,68081002,2,0,4,-4,0
202503,68081002,3S2S3,2,0,2,NA
202503,68081002,3S3,1,1,0,1
202503,68081002,3S3S2,1,2,-1,0.5
202503,68081002,CA,0,4,-4,0
202503,68081003,2,8,34,-26,0.24
202503,68081003,2S2,0,4,-4,0
202503,68081003,3,0,4,-4,0
202503,68081003,3S2,5,2,3,2.5
202503,68081003,3S3,19,96,-77,0.2
202503,68081003,3S3S2,1,0,1,NA
202503,68081003,CA,2,1,1,2
202503,68081004,2,1,1,0,1
202503,68081010,2,8,3,5,2.67
202503,68081010,3S2,30,10,20,3
202503,68081010,3S2S3,0,2,-2,0
202503,68081010,3S3,462,224,238,2.06
202503,68081010,3S3S2,3,1,2,3
202503,68092000,2,21,13,8,1.62
202503,68092000,2S3,2,3,-1,0.67
202503,68092000,3,36,64,-28,0.56
202503,68092000,3S2,18,8,10,2.25
202503,68092000,3S3,535,338,197,1.58
202503,68092000,CA,0,17,-17,0
202503,68092000,V2,4,16,-12,0.25
202503,68092000,V3,12,20,-8,0.6
202503,68092003,3S3,12,34,-22,0.35
202503,68092005,CA,0,2,-2,0
202503,68092007,3S3,0,3,-3,0
202503,68101000,2,5,31,-26,0.16
202503,68101000,2S2,0,4,-4,0
202503,68101000,3S2,1,0,1,NA
202503,68101000,3S3,1,1,0,1
202503,68101000,4,0,1,-1,0
202503,68101000,CA,1,4,-3,0.25
202503,68101010,2,17,17,0,1
202503,68101010,CA,1,1,0,1
202503,68121000,2,0,9,-9,0
202503,68121000,CA,0,17,-17,0
202503,68132000,2,0,5,-5,0
202503,68132000,CA,0,8,-8,0
202503,68147000,2,21,50,-29,0.42
202503,68147000,3S3,52,0,52,NA
202503,68147000,CA,0,3,-3,0
202503,68152000,2,0,7,-7,0
202503,68152002,2,1,0,1,NA
202503,68160000,2,0,4,-4,0
202503,68162000,2,0,19,-19,0
202503,68162000,3S2,0,1,-1,0
202503,68162000,3S3,6,13,-7,0.46
202503,68162000,CA,16,27,-11,0.59
202503,68167000,2,3,123,-120,0.02
202503,68167000,3,1,1,0,1
202503,68167000,3S2,2,0,2,NA
202503,68167000,CA,0,14,-14,0
202503,68169000,2,0,5,-5,0
202503,68169000,CA,0,2,-2,0
202503,68176000,2,2,2,0,1
202503,68179000,2,0,2,-2,0
202503,68179000,V2,0,2,-2,0
202503,68179007,2,0,4,-4,0
202503,68190000,2,86,235,-149,0.37
202503,68190000,2S2,2,0,2,NA
202503,68190000,2S3,6,0,6,NA
202503,68190000,3,18,7,11,2.57
202503,68190000,3S1,1,0,1,NA
202503,68190000,3S2,154,32,122,4.81
202503,68190000,3S3,2403,408,1995,5.89
202503,68190000,3S4,4,1,3,4
202503,68190000,CA,2,57,-55,0.04
202503,68190000,V3,0,7,-7,0
202503,68190002,2,25,27,-2,0.93
202503,68190002,3S2,0,1,-1,0
202503,68190002,3S3,6,7,-1,0.86
202503,68190002,3S4,1,2,-1,0.5
202503,68190002,4,1,0,1,NA
202503,68190002,CA,0,2,-2,0
202503,68190003,2,61,0,61,NA
202503,68190003,2S2,1,0,1,NA
202503,68190003,3,9,0,9,NA
202503,68190003,3S2,4,0,4,NA
202503,68190003,3S3,35,9,26,3.89
202503,68190004,2,0,1,-1,0
202503,68190004,3,0,1,-1,0
202503,68190004,3S3,0,5,-5,0
202503,68190014,CA,0,1,-1,0
202503,68207000,2,0,6,-6,0
202503,68207000,3S3,0,4,-4,0
202503,68209000,2,1,19,-18,0.05
202503,68209001,2,0,1,-1,0
202503,68211000,2,2,11,-9,0.18
202503,68217000,2,0,4,-4,0
202503,68229000,2,9,112,-103,0.08
202503,68229000,2R2,5,0,5,NA
202503,68229000,2S2,0,1,-1,0
202503,68229000,3,0,14,-14,0
202503,68229000,3S3,151,2,149,75.5
202503,68229000,CA,0,8,-8,0
202503,68235000,2,3,35,-32,0.09
202503,68235000,2S2,0,1,-1,0
202503,68235000,3,1,10,-9,0.1
202503,68235000,CA,1,18,-17,0.06
202503,68235000,V2,0,4,-4,0
202503,68235000,V4,0,1,-1,0
202503,68235007,2,0,1,-1,0
202503,68245000,2,0,2,-2,0
202503,68250000,2,0,3,-3,0
202503,68250003,CA,0,1,-1,0
202503,68255000,2,6,146,-140,0.04
202503,68255000,3,0,21,-21,0
202503,68255000,3S3,0,11,-11,0
202503,68255000,CA,16,47,-31,0.34
202503,68255000,V2,0,5,-5,0
202503,68264000,2,0,3,-3,0
202503,68264000,CA,0,1,-1,0
202503,68266000,2,1,4,-3,0.25
202503,68266000,3S3,62,0,62,NA
202503,68266000,CA,0,1,-1,0
202503,68271000,2,2,21,-19,0.1
202503,68271000,3,1,1,0,1
202503,68271000,CA,0,7,-7,0
202503,68276000,2,2702,5249,-2547,0.51
202503,68276000,2R2,3,2,1,1.5
202503,68276000,2S1,0,4,-4,0
202503,68276000,2S2,5,51,-46,0.1
202503,68276000,2S3,1,5,-4,0.2
202503,68276000,3,202,95,107,2.13
202503,68276000,3S2,269,169,100,1.59
202503,68276000,3S3,88,174,-86,0.51
202503,68276000,CA,949,1074,-125,0.88
202503,68276000,V2,322,0,322,NA
202503,68276011,3S3,0,1,-1,0
202503,68276013,2,0,4,-4,0
202503,68276013,CA,0,16,-16,0
202503,68276014,2,0,4,-4,0
202503,68296000,2,1,6,-5,0.17
202503,68298000,2,0,14,-14,0
202503,68298000,V2,0,2,-2,0
202503,68307000,2,11848,5209,6639,2.27
202503,68307000,2R2,0,6,-6,0
202503,68307000,2S2,59,145,-86,0.41
202503,68307000,2S3,17,21,-4,0.81
202503,68307000,3,891,355,536,2.51
202503,68307000,3S1,2,4,-2,0.5
202503,68307000,3S2,836,717,119,1.17
202503,68307000,3S3,901,3866,-2965,0.23
202503,68307000,3S4,4,2,2,2
202503,68307000,4,14,2,12,7
202503,68307000,CA,4129,599,3530,6.89
202503,68307000,V2,44,27,17,1.63
202503,68307000,V3,0,33,-33,0
202503,68307007,2,0,19,-19,0
202503,68307007,3,0,6,-6,0
202503,68307007,V2,0,1,-1,0
202503,68307018,3S2,17,14,3,1.21
202503,68318000,2,0,9,-9,0
202503,68318000,3,0,9,-9,0
202503,68318000,CA,0,6,-6,0
202503,68318007,2,0,1,-1,0
202503,68320000,2,1,14,-13,0.07
202503,68320000,V2,0,1,-1,0
202503,68322000,2,0,8,-8,0
202503,68324000,2,0,16,-16,0
202503,68324000,3,1,0,1,NA
202503,68324000,CA,1,0,1,NA
202503,68324000,V2,0,1,-1,0
202503,68327000,2,2,16,-14,0.12
202503,68327000,3S2,1,0,1,NA
202503,68327000,3S3,0,1,-1,0
202503,68327000,CA,1,1,0,1
202503,68344000,2,0,8,-8,0
202503,68344000,V2,0,2,-2,0
202503,68368000,2,2,16,-14,0.12
202503,68368000,3S3,1,0,1,NA
202503,68370000,3S3,1,0,1,NA
202503,68377000,2,0,19,-19,0
202503,68377000,3,1,4,-3,0.25
202503,68377000,3S2,2,0,2,NA
202503,68377000,3S3,3,2,1,1.5
202503,68377000,CA,1,3,-2,0.33
202503,68385000,2,17,48,-31,0.35
202503,68385000,3,37,22,15,1.68
202503,68385000,3S2,3,3,0,1
202503,68385000,3S3,420,0,420,NA
202503,68385000,CA,49,53,-4,0.92
202503,68385000,V2,98,0,98,NA
202503,68385000,V3,185,2,183,92.5
202503,68385000,V4,17,0,17,NA
202503,68385009,2,2,0,2,NA
202503,68385012,2,0,2,-2,0
202503,68397000,2,0,5,-5,0
202503,68406000,2,1702,2002,-300,0.85
202503,68406000,2R2,0,1,-1,0
202503,68406000,2S2,1,59,-58,0.02
202503,68406000,2S3,6,1,5,6
202503,68406000,3,158,155,3,1.02
202503,68406000,3S2,119,56,63,2.12
202503,68406000,3S3,42,297,-255,0.14
202503,68406000,3S4,0,4,-4,0
202503,68406000,CA,620,321,299,1.93
202503,68406000,V2,19,14,5,1.36
202503,68406000,V3,0,21,-21,0
202503,68406001,3,0,1,-1,0
202503,68406008,2,0,1,-1,0
202503,68406008,V2,0,1,-1,0
202503,68406009,3,1,0,1,NA
202503,68406009,3S2,1,0,1,NA
202503,68406015,3S3,0,2,-2,0
202503,68418000,2,562,1337,-775,0.42
202503,68418000,3,2,443,-441,0
202503,68418000,3S2,2,87,-85,0.02
202503,68418000,3S3,8,10,-2,0.8
202503,68418000,CA,2,39,-37,0.05
202503,68418000,V2,2,25,-23,0.08
202503,68425000,2,0,1,-1,0
202503,68432000,2,10,161,-151,0.06
202503,68432000,2S2,1,0,1,NA
202503,68432000,3,0,3,-3,0
202503,68432000,3S2,28,0,28,NA
202503,68432000,3S3,26,15,11,1.73
202503,68432000,4,0,1,-1,0
202503,68432000,CA,9,31,-22,0.29
202503,68444000,2,0,12,-12,0
202503,68444000,3S2,1,0,1,NA
202503,68444000,CA,0,6,-6,0
202503,68464000,2,4,102,-98,0.04
202503,68464000,3,3,0,3,NA
202503,68464000,3S2,1,0,1,NA
202503,68464000,3S3,0,1,-1,0
202503,68464000,CA,0,1,-1,0
202503,68464002,2,0,1,-1,0
202503,68468000,2,0,1,-1,0
202503,68498000,2,0,13,-13,0
202503,68498000,V2,0,1,-1,0
202503,68500000,2,21,172,-151,0.12
202503,68500000,2S3,3,0,3,NA
202503,68500000,3,0,15,-15,0
202503,68500000,3S3,7,11,-4,0.64
202503,68500000,CA,2,15,-13,0.13
202503,68500000,V2,0,26,-26,0
202503,68502000,2,0,6,-6,0
202503,68502000,CA,0,3,-3,0
202503,68522000,2,0,1,-1,0
202503,68524000,2,9,15,-6,0.6
202503,68524000,CA,23,32,-9,0.72
202503,68524000,V2,0,1,-1,0
202503,68533000,2,0,75,-75,0
202503,68533000,3,0,7,-7,0
202503,68533000,CA,1,1,0,1
202503,68547000,2,1737,2068,-331,0.84
202503,68547000,2S2,10,35,-25,0.29
202503,68547000,2S3,0,2,-2,0
202503,68547000,3,167,185,-18,0.9
202503,68547000,3S2,34,17,17,2
202503,68547000,3S3,1458,486,972,3
202503,68547000,CA,210,616,-406,0.34
202503,68547000,V2,0,1,-1,0
202503,68547001,2,0,1,-1,0
202503,68547003,2,0,5,-5,0
202503,68547008,2,0,4,-4,0
202503,68547008,3S2,1,1,0,1
202503,68547008,3S3,0,1,-1,0
202503,68547009,2S2,0,1,-1,0
202503,68547011,2,0,1,-1,0
202503,68547011,3S3,288,0,288,NA
202503,68547015,2,0,1,-1,0
202503,68547015,3S3,0,1,-1,0
202503,68549000,2,1,92,-91,0.01
202503,68549000,3S3,7,60,-53,0.12
202503,68549000,CA,0,2,-2,0
202503,68549000,V2,0,1,-1,0
202503,68572000,2,2,155,-153,0.01
202503,68572000,2S2,0,1,-1,0
202503,68572000,3,0,10,-10,0
202503,68572000,3S2,0,1,-1,0
202503,68572000,3S3,89,99,-10,0.9
202503,68572000,CA,2,15,-13,0.13
202503,68573000,2,15,53,-38,0.28
202503,68573000,2S2,1,1,0,1
202503,68573000,3,0,30,-30,0
202503,68573000,3S2,16,1,15,16
202503,68573000,3S3,108,33,75,3.27
202503,68573000,CA,0,4,-4,0
202503,68573000,V2,13,8,5,1.62
202503,68573000,V3,125,4,121,31.25
202503,68573001,2,4,0,4,NA
202503,68573002,CA,0,5,-5,0
202503,68575000,2,26,171,-145,0.15
202503,68575000,2S2,1,3,-2,0.33
202503,68575000,2S3,1,2,-1,0.5
202503,68575000,3,7,20,-13,0.35
202503,68575000,3S2,113,9,104,12.56
202503,68575000,3S3,619,91,528,6.8
202503,68575000,CA,6,36,-30,0.17
202503,68575000,V2,19,10,9,1.9
202503,68575000,V3,18,162,-144,0.11
202503,68575000,V3R3,3,0,3,NA
202503,68575001,3S3,0,1,-1,0
202503,68575002,3S3,0,3,-3,0
202503,68575015,2,0,1,-1,0
202503,68575015,CA,0,7,-7,0
202503,68575024,CA,0,1,-1,0
202503,68615000,2,103,840,-737,0.12
202503,68615000,2S2,1,1,0,1
202503,68615000,2S3,0,1,-1,0
202503,68615000,3,150,49,101,3.06
202503,68615000,3S2,103,41,62,2.51
202503,68615000,3S3,83,35,48,2.37
202503,68615000,CA,1,34,-33,0.03
202503,68615000,V2,1,3,-2,0.33
202503,68615000,V3,13,0,13,NA
202503,68615013,3S3,19,0,19,NA
202503,68615013,CA,0,5,-5,0
202503,68615031,2,3,1,2,3
202503,68615031,3,20,0,20,NA
202503,68615031,3S3,0,1,-1,0
202503,68655000,2,866,287,579,3.02
202503,68655000,2S2,7,9,-2,0.78
202503,68655000,2S3,3,9,-6,0.33
202503,68655000,3,145,412,-267,0.35
202503,68655000,3S2,12,4,8,3
202503,68655000,3S2S3,1,0,1,NA
202503,68655000,3S3,205,297,-92,0.69
202503,68655000,3S4,1,1,0,1
202503,68655000,4,0,8,-8,0
202503,68655000,CA,6,127,-121,0.05
202503,68655000,V2,17,3,14,5.67
202503,68655000,V3,44,10,34,4.4
202503,68655001,2,1,0,1,NA
202503,68669000,2,0,25,-25,0
202503,68669000,2S3,0,1,-1,0
202503,68669000,3,0,9,-9,0
202503,68669000,3S3,0,6,-6,0
202503,68669000,CA,0,3,-3,0
202503,68673000,2,0,1,-1,0
202503,68673001,2,0,1,-1,0
202503,68673001,V2,0,1,-1,0
202503,68679000,2,113,1086,-973,0.1
202503,68679000,2S2,0,3,-3,0
202503,68679000,2S3,1,2,-1,0.5
202503,68679000,3,3,38,-35,0.08
202503,68679000,3S2,0,15,-15,0
202503,68679000,3S3,166,478,-312,0.35
202503,68679000,CA,40,197,-157,0.2
202503,68679001,3S3,0,2,-2,0
202503,68682000,2,0,5,-5,0
202503,68682000,3,0,1,-1,0
202503,68682000,CA,0,1,-1,0
202503,68684000,2,0,2,-2,0
202503,68686000,2,10,9,1,1.11
202503,68686000,3S3,0,1,-1,0
202503,68686000,CA,0,3,-3,0
202503,68689000,2,14,113,-99,0.12
202503,68689000,3,3,1,2,3
202503,68689000,3S2,2,8,-6,0.25
202503,68689000,3S3,27,6,21,4.5
202503,68689000,CA,20,77,-57,0.26
202503,68689000,V2,0,6,-6,0
202503,68689000,V3,0,21,-21,0
202503,68689012,2,2,0,2,NA
202503,68689012,3,1,1,0,1
202503,68689012,3S3,10,0,10,NA
202503,68689012,CA,28,41,-13,0.68
202503,68689012,V2,0,1,-1,0
202503,68689024,2,19,1,18,19
202503,68689024,3,18,0,18,NA
202503,68689024,3S2,0,1,-1,0
202503,68689024,3S3,152,19,133,8
202503,68705000,2,1,19,-18,0.05
202503,68705000,3S2,0,1,-1,0
202503,68705000,CA,0,1,-1,0
202503,68720000,2,0,33,-33,0
202503,68745000,2,154,27,127,5.7
202503,68745000,3,0,82,-82,0
202503,68745000,3S2,5,0,5,NA
202503,68745000,3S3,70,0,70,NA
202503,68745000,CA,0,6,-6,0
202503,68745009,2,2,0,2,NA
202503,68745009,3S4,0,2,-2,0
202503,68755000,2,75,522,-447,0.14
202503,68755000,2S2,0,1,-1,0
202503,68755000,2S3,7,5,2,1.4
202503,68755000,3,1,10,-9,0.1
202503,68755000,3S2,1,2,-1,0.5
202503,68755000,3S3,15,73,-58,0.21
202503,68755000,CA,28,146,-118,0.19
202503,68755000,V2,76,0,76,NA
202503,68770000,2,3,41,-38,0.07
202503,68770000,3,0,16,-16,0
202503,68770000,3S2,2,0,2,NA
202503,68770000,CA,1,13,-12,0.08
202503,68770001,2,2,12,-10,0.17
202503,68770001,3,0,1,-1,0
202503,68770003,2,3,4,-1,0.75
202503,68773000,2,0,2,-2,0
202503,68773003,2,0,1,-1,0
202503,68773003,3S3,1,0,1,NA
202503,68780000,2,4,5,-1,0.8
202503,68780000,CA,0,2,-2,0
202503,68820000,2,5,69,-64,0.07
202503,68820000,3,0,4,-4,0
202503,68820000,CA,0,9,-9,0
202503,68820001,2,1,20,-19,0.05
202503,68820001,3,3,0,3,NA
202503,68820001,3S3,0,1,-1,0
202503,68820001,CA,0,8,-8,0
202503,68820002,CA,1,0,1,NA
202503,68855000,2,1,47,-46,0.02
202503,68855000,3S3,4,0,4,NA
202503,68855000,V2,0,11,-11,0
202503,68861000,2,3,214,-211,0.01
202503,68861000,3,0,4,-4,0
202503,68861000,3S2,4,0,4,NA
202503,68861000,3S3,5,36,-31,0.14
202503,68861000,3S4,1,1,0,1
202503,68861000,CA,11,42,-31,0.26
202503,68861000,V2,0,4,-4,0
202503,68867000,CA,0,3,-3,0
202503,68872000,2,6,127,-121,0.05
202503,68872000,3S3,0,1,-1,0
202503,68872000,CA,1,1,0,1
202503,68872000,V2,0,19,-19,0
202503,68895000,2,59,226,-167,0.26
202503,68895000,3,6,31,-25,0.19
202503,68895000,3S1,3,0,3,NA
202503,68895000,3S2,2,0,2,NA
202503,68895000,CA,25,45,-20,0.56
202503,70001000,2,1429,3283,-1854,0.44
202503,70001000,2R2,0,43,-43,0
202503,70001000,2S2,10,106,-96,0.09
202503,70001000,2S3,7,30,-23,0.23
202503,70001000,3,20,282,-262,0.07
202503,70001000,3S2,115,422,-307,0.27
202503,70001000,3S3,93,727,-634,0.13
202503,70001000,3S4,1,0,1,NA
202503,70001000,4,0,6,-6,0
202503,70001000,CA,311,502,-191,0.62
202503,70001000,V3,1,0,1,NA
202503,70001001,2,0,9,-9,0
202503,70001002,2,0,7,-7,0
202503,70001003,2,4,3,1,1.33
202503,70001005,2,1,2,-1,0.5
202503,70001007,2,1,0,1,NA
202503,70110000,2,1,25,-24,0.04
202503,70110000,3,0,5,-5,0
202503,70110000,3S3,0,1,-1,0
202503,70124000,2,4,36,-32,0.11
202503,70124000,2R2,0,2,-2,0
202503,70124000,3,4,0,4,NA
202503,70124000,3S2,8,2,6,4
202503,70124000,3S3,9,18,-9,0.5
202503,70124000,CA,0,1,-1,0
202503,70204000,2,2,11,-9,0.18
202503,70215000,2,290,393,-103,0.74
202503,70215000,2R2,0,1,-1,0
202503,70215000,2S2,0,1,-1,0
202503,70215000,3,6,20,-14,0.3
202503,70215000,3S2,14,7,7,2
202503,70215000,3S3,258,382,-124,0.68
202503,70215000,CA,47,72,-25,0.65
202503,70215009,2,1,1,0,1
202503,70215009,CA,2,1,1,2
202503,70221000,2,18,200,-182,0.09
202503,70221000,2R2,0,16,-16,0
202503,70221000,2S2,3,0,3,NA
202503,70221000,3,1,20,-19,0.05
202503,70221000,3S2,2,4,-2,0.5
202503,70221000,3S3,2,41,-39,0.05
202503,70221000,CA,5,32,-27,0.16
202503,70230000,2,0,9,-9,0
202503,70230000,3,0,1,-1,0
202503,70230000,3S2,1,0,1,NA
202503,70230000,CA,0,2,-2,0
202503,70230001,2,0,3,-3,0
202503,70233000,2,0,9,-9,0
202503,70233000,2S3,4,2,2,2
202503,70233000,3,0,10,-10,0
202503,70233000,3S2,1,1,0,1
202503,70233000,3S3,3,17,-14,0.18
202503,70233000,CA,0,5,-5,0
202503,70233008,2,0,2,-2,0
202503,70233013,2,0,1,-1,0
202503,70235000,2,14,119,-105,0.12
202503,70235000,CA,2,3,-1,0.67
202503,70235002,2,0,2,-2,0
202503,70235008,3S3,0,46,-46,0
202503,70265000,2,7,75,-68,0.09
202503,70265000,3,0,29,-29,0
202503,70265000,3S2,0,4,-4,0
202503,70265000,3S3,1,2,-1,0.5
202503,70265000,CA,0,20,-20,0
202503,70400000,2,2,68,-66,0.03
202503,70400000,2S2,0,2,-2,0
202503,70400000,2S3,0,8,-8,0
202503,70400000,3,17,17,0,1
202503,70400000,3S1,0,1,-1,0
202503,70400000,3S2,0,6,-6,0
202503,70400000,3S3,1,32,-31,0.03
202503,70400000,3S4,1,29,-28,0.03
202503,70400000,4,0,1,-1,0
202503,70400000,CA,0,1,-1,0
202503,70418000,2,2,20,-18,0.1
202503,70418000,3,0,2,-2,0
202503,70418000,3S2,1,0,1,NA
202503,70418000,3S3,0,2,-2,0
202503,70418000,CA,7,13,-6,0.54
202503,70429000,2,58,70,-12,0.83
202503,70429000,2S2,2,0,2,NA
202503,70429000,2S3,2,0,2,NA
202503,70429000,3,2,32,-30,0.06
202503,70429000,3S3,1,10,-9,0.1
202503,70429000,4,0,3,-3,0
202503,70429000,CA,0,5,-5,0
202503,70429015,2,0,2,-2,0
202503,70429025,2,0,2,-2,0
202503,70473000,2,5,13,-8,0.38
202503,70473000,3S3,0,2,-2,0
202503,70473005,3,0,1,-1,0
202503,70473005,3S2,0,11,-11,0
202503,70473009,2,0,1,-1,0
202503,70508000,2,9,68,-59,0.13
202503,70508000,2S3,0,1,-1,0
202503,70508000,3S2,2,0,2,NA
202503,70508000,3S3,0,48,-48,0
202503,70508000,3S4,0,1,-1,0
202503,70508000,CA,3,14,-11,0.21
202503,70508002,2,0,1,-1,0
202503,70508011,2,0,3,-3,0
202503,70523000,2,39,29,10,1.34
202503,70523000,2S2,2,0,2,NA
202503,70523000,3,0,3,-3,0
202503,70523000,3S2,2,11,-9,0.18
202503,70523000,3S3,0,10,-10,0
202503,70523000,CA,0,4,-4,0
202503,70670000,2,83,163,-80,0.51
202503,70670000,2R2,0,1,-1,0
202503,70670000,2S2,1,1,0,1
202503,70670000,3,0,7,-7,0
202503,70670000,3S2,0,1,-1,0
202503,70670000,3S3,1,4,-3,0.25
202503,70670000,CA,15,30,-15,0.5
202503,70670000,V2,1,0,1,NA
202503,70670012,2,0,1,-1,0
202503,70678000,2,2,27,-25,0.07
202503,70678000,2S2,0,1,-1,0
202503,70678000,3,0,1,-1,0
202503,70678000,3S2,2,0,2,NA
202503,70678000,3S3,1,0,1,NA
202503,70678000,3S4,1,0,1,NA
202503,70678000,CA,4,6,-2,0.67
202503,70678010,2,1,2,-1,0.5
202503,70702000,2,1,27,-26,0.04
202503,70702000,CA,0,2,-2,0
202503,70702004,2,0,8,-8,0
202503,70708000,2,104,302,-198,0.34
202503,70708000,2R2,9,2,7,4.5
202503,70708000,2S2,10,7,3,1.43
202503,70708000,2S3,20,12,8,1.67
202503,70708000,3,22,33,-11,0.67
202503,70708000,3S1,1,0,1,NA
202503,70708000,3S2,13,8,5,1.62
202503,70708000,3S3,38,98,-60,0.39
202503,70708000,3S4,4,4,0,1
202503,70708000,4,1,2,-1,0.5
202503,70708000,CA,4,60,-56,0.07
202503,70708003,2,43,4,39,10.75
202503,70708006,2R2,3,1,2,3
202503,70708006,3S3,0,2,-2,0
202503,70708007,2,2,0,2,NA
202503,70708007,2S3,1,0,1,NA
202503,70708007,3S1,1,0,1,NA
202503,70708007,3S2,1,0,1,NA
202503,70708007,3S3,0,1,-1,0
202503,70708016,2,0,3,-3,0
202503,70713000,2,141,177,-36,0.8
202503,70713000,2R2,0,2,-2,0
202503,70713000,2S2,1,0,1,NA
202503,70713000,2S3,0,1,-1,0
202503,70713000,3,0,33,-33,0
202503,70713000,3S2,2,4,-2,0.5
202503,70713000,3S3,0,8,-8,0
202503,70713000,CA,3,30,-27,0.1
202503,70713000,V3,0,1,-1,0
202503,70713003,2,0,7,-7,0
202503,70713006,2,0,8,-8,0
202503,70713007,2,0,1,-1,0
202503,70713008,2R2,1,1,0,1
202503,70713010,2,0,1,-1,0
202503,70713012,2,0,4,-4,0
202503,70717000,2,9,35,-26,0.26
202503,70717000,2S2,1,6,-5,0.17
202503,70717000,2S3,0,8,-8,0
202503,70717000,3,1,1,0,1
202503,70717000,3S3,1,51,-50,0.02
202503,70717000,3S4,0,10,-10,0
202503,70717000,CA,1,3,-2,0.33
202503,70742000,2,9,103,-94,0.09
202503,70742000,2S3,0,1,-1,0
202503,70742000,3,0,1,-1,0
202503,70742000,3S3,1,2,-1,0.5
202503,70742000,CA,1,11,-10,0.09
202503,70742005,2,0,5,-5,0
202503,70742011,2,0,6,-6,0
202503,70771000,2,2,5,-3,0.4
202503,70771000,2S2,0,1,-1,0
202503,70771000,3,0,9,-9,0
202503,70771000,3S2,0,1,-1,0
202503,70771000,3S3,0,10,-10,0
202503,70771000,3S4,0,1,-1,0
202503,70771000,CA,0,2,-2,0
202503,70771007,2,0,2,-2,0
202503,70771007,CA,0,1,-1,0
202503,70771013,2,8,9,-1,0.89
202503,70771013,3S3,0,3,-3,0
202503,70771018,2,0,1,-1,0
202503,70771020,2,0,1,-1,0
202503,70771026,2,1,2,-1,0.5
202503,70771026,3S3,0,2,-2,0
202503,70820000,2,71,224,-153,0.32
202503,70820000,2S2,1,1,0,1
202503,70820000,2S3,4,0,4,NA
202503,70820000,3,1,18,-17,0.06
202503,70820000,3S2,1,73,-72,0.01
202503,70820000,3S3,3513,815,2698,4.31
202503,70820000,3S4,0,2,-2,0
202503,70820000,CA,1,36,-35,0.03
202503,70820001,2,10,9,1,1.11
202503,70820001,2S2,0,1,-1,0
202503,70820001,3S3,1,1,0,1
202503,70820001,CA,0,1,-1,0
202503,70820003,2,0,1,-1,0
202503,70820008,2,0,1,-1,0
202503,70820008,3S2,0,41,-41,0
202503,70820008,3S3,0,424,-424,0
202503,70820008,V3,0,4,-4,0
202503,70823000,2,926,108,818,8.57
202503,70823000,2R2,0,8,-8,0
202503,70823000,2S2,4,0,4,NA
202503,70823000,2S3,1,4,-3,0.25
202503,70823000,3,432,16,416,27
202503,70823000,3S2,389,20,369,19.45
202503,70823000,3S3,735,268,467,2.74
202503,70823000,3S4,0,2,-2,0
202503,70823000,CA,1,34,-33,0.03
202503,70823000,V3,1,0,1,NA
202503,70823005,2,0,3,-3,0
202503,73001000,2,4210,6746,-2536,0.62
202503,73001000,2R2,37,129,-92,0.29
202503,73001000,2S2,253,658,-405,0.38
202503,73001000,2S3,20,94,-74,0.21
202503,73001000,3,120,309,-189,0.39
202503,73001000,3S2,629,730,-101,0.86
202503,73001000,3S3,3881,2258,1623,1.72
202503,73001000,3S4,3,2,1,1.5
202503,73001000,4,1,6,-5,0.17
202503,73001000,CA,1546,1690,-144,0.91
202503,73001000,V2,1,2,-1,0.5
202503,73001000,V3,8,8,0,1
202503,73001001,2,0,4,-4,0
202503,73001001,CA,0,6,-6,0
202503,73001009,2,1,0,1,NA
202503,73001031,2,0,4,-4,0
202503,73001032,3S3,0,15,-15,0
202503,73001032,CA,0,1,-1,0
202503,73024000,2,0,7,-7,0
202503,73024000,CA,9,13,-4,0.69
202503,73024004,2,0,4,-4,0
202503,73024004,3,1,0,1,NA
202503,73024004,3S3,3,3,0,1
202503,73024004,CA,0,4,-4,0
202503,73026000,2,109,107,2,1.02
202503,73026000,2S2,2,0,2,NA
202503,73026000,2S3,0,1,-1,0
202503,73026000,3,2,2,0,1
202503,73026000,3S2,0,3,-3,0
202503,73026000,3S3,14,8,6,1.75
202503,73026000,CA,7,18,-11,0.39
202503,73026001,2,1,1,0,1
202503,73026008,2,0,1,-1,0
202503,73030000,2,22,29,-7,0.76
202503,73030000,3,0,1,-1,0
202503,73030000,3S2,0,1,-1,0
202503,73030000,3S3,28,6,22,4.67
202503,73030000,CA,1,6,-5,0.17
202503,73043000,2,0,37,-37,0
202503,73043000,CA,0,5,-5,0
202503,73055000,2,43,75,-32,0.57
202503,73055000,3,0,1,-1,0
202503,73055000,3S2,42,1,41,42
202503,73055000,3S3,9,5,4,1.8
202503,73055000,CA,0,10,-10,0
202503,73055004,2,3,4,-1,0.75
202503,73067000,2,1,36,-35,0.03
202503,73067000,3,0,18,-18,0
202503,73067000,3S2,1,1,0,1
202503,73067000,3S3,0,1,-1,0
202503,73067000,3S4,1,1,0,1
202503,73067000,4,1,0,1,NA
202503,73067000,CA,24,27,-3,0.89
202503,73067005,CA,0,1,-1,0
202503,73067007,2,0,11,-11,0
202503,73067015,CA,0,6,-6,0
202503,73124000,2,6,98,-92,0.06
202503,73124000,3,0,3,-3,0
202503,73124000,3S2,6,1,5,6
202503,73124000,3S3,1,0,1,NA
202503,73124000,CA,5,41,-36,0.12
202503,73124001,2,1,3,-2,0.33
202503,73124001,CA,0,1,-1,0
202503,73148000,2,10,131,-121,0.08
202503,73148000,2R2,0,7,-7,0
202503,73148000,2S2,2,1,1,2
202503,73148000,3,0,2,-2,0
202503,73148000,3S2,1,3,-2,0.33
202503,73148000,3S3,0,16,-16,0
202503,73148000,CA,3,65,-62,0.05
202503,73152000,2,15,19,-4,0.79
202503,73152000,CA,1,2,-1,0.5
202503,73168000,2,77,371,-294,0.21
202503,73168000,2R2,0,6,-6,0
202503,73168000,2S2,3,4,-1,0.75
202503,73168000,2S3,1,1,0,1
202503,73168000,3,108,41,67,2.63
202503,73168000,3S1,4,0,4,NA
202503,73168000,3S2,8,4,4,2
202503,73168000,3S3,228,56,172,4.07
202503,73168000,CA,25,138,-113,0.18
202503,73200000,2,549,27,522,20.33
202503,73200000,2S2,58,0,58,NA
202503,73200000,3,166,0,166,NA
202503,73200000,3S2,0,18,-18,0
202503,73200000,3S3,112,73,39,1.53
202503,73200000,CA,0,16,-16,0
202503,73200001,2,134,13,121,10.31
202503,73200001,2S2,66,0,66,NA
202503,73200001,3,114,2,112,57
202503,73200001,3S2,3,9,-6,0.33
202503,73200001,3S3,89,100,-11,0.89
202503,73200001,CA,0,2,-2,0
202503,73217000,2,1,53,-52,0.02
202503,73217000,2S2,1,0,1,NA
202503,73217000,3,0,3,-3,0
202503,73217000,3S2,0,6,-6,0
202503,73217000,3S3,3,21,-18,0.14
202503,73217000,3S4,1,0,1,NA
202503,73217000,CA,0,5,-5,0
202503,73217001,2,1,1,0,1
202503,73217001,3S2,0,1,-1,0
202503,73217001,3S3,0,2,-2,0
202503,73226000,2,0,32,-32,0
202503,73226000,CA,0,9,-9,0
202503,73236000,2,6,37,-31,0.16
202503,73236000,CA,0,14,-14,0
202503,73268000,2,662,970,-308,0.68
202503,73268000,2R2,10,1,9,10
202503,73268000,2S2,6,38,-32,0.16
202503,73268000,2S3,6,7,-1,0.86
202503,73268000,3,65,18,47,3.61
202503,73268000,3S2,25,18,7,1.39
202503,73268000,3S3,1007,329,678,3.06
202503,73268000,4,13,0,13,NA
202503,73268000,CA,103,331,-228,0.31
202503,73268001,2,36,19,17,1.89
202503,73268001,3S2,1,0,1,NA
202503,73268001,3S3,21,5,16,4.2
202503,73268001,CA,4,2,2,2
202503,73270000,2,2,5,-3,0.4
202503,73270000,CA,0,4,-4,0
202503,73270004,2,0,2,-2,0
202503,73270004,2S2,0,1,-1,0
202503,73270004,CA,0,8,-8,0
202503,73275000,2,311,301,10,1.03
202503,73275000,2R2,0,1,-1,0
202503,73275000,2S2,1,1,0,1
202503,73275000,2S3,1,2,-1,0.5
202503,73275000,3,1,8,-7,0.12
202503,73275000,3S2,24,41,-17,0.59
202503,73275000,3S3,64,41,23,1.56
202503,73275000,CA,1,94,-93,0.01
202503,73275001,2,0,1,-1,0
202503,73283000,2,51,269,-218,0.19
202503,73283000,3,0,10,-10,0
202503,73283000,3S3,1,76,-75,0.01
202503,73283000,CA,5,42,-37,0.12
202503,73283000,V3,0,1,-1,0
202503,73319000,2,16,168,-152,0.1
202503,73319000,2R2,0,3,-3,0
202503,73319000,3,0,36,-36,0
202503,73319000,3S2,3,2,1,1.5
202503,73319000,3S3,6,4,2,1.5
202503,73319000,CA,6,61,-55,0.1
202503,73319002,2S2,1,0,1,NA
202503,73319011,2,0,1,-1,0
202503,73347000,2,1,5,-4,0.2
202503,73347000,3S3,12,1,11,12
202503,73347000,CA,0,14,-14,0
202503,73347001,3S3,0,5,-5,0
202503,73347003,2,58,1,57,58
202503,73347003,3,9,0,9,NA
202503,73347003,3S3,93,2,91,46.5
202503,73347004,2,2,0,2,NA
202503,73347005,2,2,5,-3,0.4
202503,73347005,3S2,2,0,2,NA
202503,73349000,2,32,287,-255,0.11
202503,73349000,2R2,0,1,-1,0
202503,73349000,2S2,2,3,-1,0.67
202503,73349000,2S3,0,1,-1,0
202503,73349000,3,0,18,-18,0
202503,73349000,3S2,0,13,-13,0
202503,73349000,3S3,149,198,-49,0.75
202503,73349000,3S4,0,7,-7,0
202503,73349000,CA,9,61,-52,0.15
202503,73352000,2,3,34,-31,0.09
202503,73352000,CA,0,10,-10,0
202503,73408000,2,19,105,-86,0.18
202503,73408000,2R2,1,0,1,NA
202503,73408000,3,6,5,1,1.2
202503,73408000,3S2,0,1,-1,0
202503,73408000,3S3,33,48,-15,0.69
202503,73408000,CA,2,55,-53,0.04
202503,73408000,V2,1,0,1,NA
202503,73411000,2,34,204,-170,0.17
202503,73411000,3,1,28,-27,0.04
202503,73411000,3S3,4,21,-17,0.19
202503,73411000,CA,5,41,-36,0.12
202503,73411000,V3,4,6,-2,0.67
202503,73411009,2,0,6,-6,0
202503,73411009,3,1,4,-3,0.25
202503,73443000,2,296,478,-182,0.62
202503,73443000,2R2,0,1,-1,0
202503,73443000,2S2,4,13,-9,0.31
202503,73443000,2S3,5,6,-1,0.83
202503,73443000,3,42,14,28,3
202503,73443000,3S2,20,18,2,1.11
202503,73443000,3S3,468,181,287,2.59
202503,73443000,4,1,2,-1,0.5
202503,73443000,CA,13,86,-73,0.15
202503,73443000,V3,0,1,-1,0
202503,73449000,2,29,508,-479,0.06
202503,73449000,2R2,0,6,-6,0
202503,73449000,2S2,1,2,-1,0.5
202503,73449000,2S3,0,2,-2,0
202503,73449000,3,2,25,-23,0.08
202503,73449000,3S2,1,4,-3,0.25
202503,73449000,3S3,4,60,-56,0.07
202503,73449000,CA,15,283,-268,0.05
202503,73461000,2,1,14,-13,0.07
202503,73483000,2,30,124,-94,0.24
202503,73483000,2R2,0,1,-1,0
202503,73483000,2S2,0,12,-12,0
202503,73483000,3,0,2,-2,0
202503,73483000,3S3,0,6,-6,0
202503,73483000,CA,2,11,-9,0.18
202503,73483002,2,2,0,2,NA
202503,73504000,2,11,72,-61,0.15
202503,73504000,2R2,0,3,-3,0
202503,73504000,2S2,0,8,-8,0
202503,73504000,3,16,7,9,2.29
202503,73504000,3S2,0,2,-2,0
202503,73504000,3S3,22,3,19,7.33
202503,73504000,CA,0,4,-4,0
202503,73520000,2,2,26,-24,0.08
202503,73520000,CA,0,7,-7,0
202503,73547000,2,59,25,34,2.36
202503,73547000,2S2,1,0,1,NA
202503,73547000,3,4,2,2,2
202503,73547000,3S3,98,20,78,4.9
202503,73547000,CA,2,17,-15,0.12
202503,73547002,2,10,4,6,2.5
202503,73547002,3S3,3,2,1,1.5
202503,73547002,CA,10,2,8,5
202503,73555000,2,13,72,-59,0.18
202503,73555000,3,1,1,0,1
202503,73555000,3S3,0,1,-1,0
202503,73555000,CA,9,27,-18,0.33
202503,73555001,2,1,1,0,1
202503,73555002,2,2,2,0,1
202503,73555002,3S2,0,1,-1,0
202503,73555002,CA,1,0,1,NA
202503,73555005,3S3,2,0,2,NA
202503,73555005,CA,0,1,-1,0
202503,73563000,2,15,45,-30,0.33
202503,73563000,3,0,1,-1,0
202503,73563000,3S2,0,1,-1,0
202503,73563000,CA,0,8,-8,0
202503,73585000,2,14,125,-111,0.11
202503,73585000,2R2,0,5,-5,0
202503,73585000,2S2,0,1,-1,0
202503,73585000,2S3,1,0,1,NA
202503,73585000,3,43,18,25,2.39
202503,73585000,3S2,3,4,-1,0.75
202503,73585000,3S3,165,22,143,7.5
202503,73585000,CA,5,28,-23,0.18
202503,73616000,2,1,57,-56,0.02
202503,73616000,CA,1,5,-4,0.2
202503,73616001,2,1,0,1,NA
202503,73616003,2,0,1,-1,0
202503,73616003,3,0,1,-1,0
202503,73622000,2,0,5,-5,0
202503,73622000,3,0,1,-1,0
202503,73622000,CA,12,17,-5,0.71
202503,73624000,2,3,101,-98,0.03
202503,73624000,3,0,1,-1,0
202503,73624000,3S3,4,0,4,NA
202503,73624000,CA,0,49,-49,0
202503,73671000,2,22,106,-84,0.21
202503,73671000,2R2,0,1,-1,0
202503,73671000,2S2,5,1,4,5
202503,73671000,2S3,1,0,1,NA
202503,73671000,3,1,6,-5,0.17
202503,73671000,3S2,601,1,600,601
202503,73671000,3S3,328,79,249,4.15
202503,73671000,CA,7,35,-28,0.2
202503,73671000,V3,2,0,2,NA
202503,73675000,2,0,29,-29,0
202503,73675000,3,0,1,-1,0
202503,73675000,CA,0,5,-5,0
202503,73678000,2,5,50,-45,0.1
202503,73678000,3,0,1,-1,0
202503,73678000,3S2,1,0,1,NA
202503,73678000,3S3,2,1,1,2
202503,73678000,4,1,0,1,NA
202503,73678000,CA,0,25,-25,0
202503,73678000,V2,1,0,1,NA
202503,73678000,V3,16,0,16,NA
202503,73678000,V4,3,0,3,NA
202503,73678004,2,3,2,1,1.5
202503,73678004,2S3,0,1,-1,0
202503,73678004,3,0,21,-21,0
202503,73678004,3S3,24,0,24,NA
202503,73678004,CA,0,2,-2,0
202503,73686000,2,1,8,-7,0.12
202503,73686000,CA,1,7,-6,0.14
202503,73770000,2,4,18,-14,0.22
202503,73770000,2S2,1,0,1,NA
202503,73770000,3,10,1,9,10
202503,73770000,3S2,18,1,17,18
202503,73770000,3S3,34,2,32,17
202503,73770000,4,3,0,3,NA
202503,73770000,CA,0,1,-1,0
202503,73770000,V2,11,0,11,NA
202503,73770000,V3,270,0,270,NA
202503,73770000,V4,17,0,17,NA
202503,73854000,2,5,6,-1,0.83
202503,73854000,CA,0,6,-6,0
202503,73854000,V3,2,0,2,NA
202503,73861000,2,17,56,-39,0.3
202503,73861000,3,11,2,9,5.5
202503,73861000,3R2,1,0,1,NA
202503,73861000,3S2,1,1,0,1
202503,73861000,3S3,96,34,62,2.82
202503,73861000,CA,4,13,-9,0.31
202503,73861000,V2,0,1,-1,0
202503,73861000,V3,5,0,5,NA
202503,73870000,2,27,12,15,2.25
202503,73873000,2,14,40,-26,0.35
202503,73873000,CA,1,6,-5,0.17
202503,76001000,2,14060,26557,-12497,0.53
202503,76001000,2B2,0,2,-2,0
202503,76001000,2R2,1,50,-49,0.02
202503,76001000,2S1,0,6,-6,0
202503,76001000,2S2,868,2750,-1882,0.32
202503,76001000,2S3,191,579,-388,0.33
202503,76001000,3,118,930,-812,0.13
202503,76001000,3S1,14,2,12,7
202503,76001000,3S2,2359,1966,393,1.2
202503,76001000,3S2S3,1,1,0,1
202503,76001000,3S3,2424,5222,-2798,0.46
202503,76001000,3S4,6,8,-2,0.75
202503,76001000,4,5,10,-5,0.5
202503,76001000,CA,4806,9868,-5062,0.49
202503,76001000,V2,141,0,141,NA
202503,76001003,2,1,0,1,NA
202503,76001004,3S2,0,1,-1,0
202503,76001013,2,0,218,-218,0
202503,76001013,3S2,0,4,-4,0
202503,76001013,CA,0,387,-387,0
202503,76001016,2,0,3,-3,0
202503,76001016,3S2,0,1,-1,0
202503,76001016,3S3,1,4,-3,0.25
202503,76001019,2,3,11,-8,0.27
202503,76001019,3S3,1,33,-32,0.03
202503,76001043,2,0,1,-1,0
202503,76020000,2,146,193,-47,0.76
202503,76020000,2S2,3,0,3,NA
202503,76020000,3,3,37,-34,0.08
202503,76020000,3S3,0,7,-7,0
202503,76020000,CA,0,24,-24,0
202503,76036000,2,123,137,-14,0.9
202503,76036000,2S2,0,1,-1,0
202503,76036000,2S3,0,1,-1,0
202503,76036000,3,1,24,-23,0.04
202503,76036000,3S2,1,13,-12,0.08
202503,76036000,3S3,19,75,-56,0.25
202503,76036000,CA,3,41,-38,0.07
202503,76036001,2,0,1,-1,0
202503,76041000,2,20,178,-158,0.11
202503,76041000,3,0,17,-17,0
202503,76041000,3S2,2,1,1,2
202503,76041000,3S3,2,45,-43,0.04
202503,76041000,CA,0,111,-111,0
202503,76041006,2,0,2,-2,0
202503,76054000,2,5,26,-21,0.19
202503,76054000,3,1,9,-8,0.11
202503,76054000,CA,0,1,-1,0
202503,76100000,2,14,67,-53,0.21
202503,76100000,3,1,0,1,NA
202503,76100000,3S2,1,0,1,NA
202503,76100000,3S3,0,2,-2,0
202503,76100000,CA,0,15,-15,0
202503,76100001,2,0,1,-1,0
202503,76100001,3,0,1,-1,0
202503,76100004,3S3,1,1,0,1
202503,76100007,2,0,2,-2,0
202503,76100009,2,0,1,-1,0
202503,76109000,2,4616,3496,1120,1.32
202503,76109000,2R2,0,4,-4,0
202503,76109000,2S1,6,3,3,2
202503,76109000,2S2,12896,6056,6840,2.13
202503,76109000,2S3,3627,2003,1624,1.81
202503,76109000,3,159,62,97,2.56
202503,76109000,3S1,1,6,-5,0.17
202503,76109000,3S2,4422,2720,1702,1.63
202503,76109000,3S3,35184,11528,23656,3.05
202503,76109000,3S4,31,9,22,3.44
202503,76109000,4,36,13,23,2.77
202503,76109000,CA,1087,817,270,1.33
202503,76109000,V2,4,0,4,NA
202503,76109000,V4,8,0,8,NA
202503,76109006,2,0,6,-6,0
202503,76109006,2S2,1,0,1,NA
202503,76109006,3S3,0,87,-87,0
202503,76109006,CA,0,8,-8,0
202503,76109008,2,12,2,10,6
202503,76109008,3S3,19,3,16,6.33
202503,76109008,CA,1,4,-3,0.25
202503,76109009,2,19,4,15,4.75
202503,76109009,2S2,0,1,-1,0
202503,76109009,3S2,1,1,0,1
202503,76109009,3S3,38,3,35,12.67
202503,76109009,CA,0,1,-1,0
202503,76109015,2,60,1,59,60
202503,76109015,2S2,1,0,1,NA
202503,76109015,3S3,2,0,2,NA
202503,76109015,CA,2,0,2,NA
202503,76109048,2,0,1,-1,0
202503,76109056,2,0,11,-11,0
202503,76109056,3S3,0,6,-6,0
202503,76109066,2,0,1,-1,0
202503,76109076,2,1,3,-2,0.33
202503,76109076,3S2,1,0,1,NA
202503,76109076,3S3,94,0,94,NA
202503,76109078,3S3,8,2,6,4
202503,76111000,2,4659,3604,1055,1.29
202503,76111000,2R2,0,5,-5,0
202503,76111000,2S1,1,0,1,NA
202503,76111000,2S2,65,75,-10,0.87
202503,76111000,2S3,56,18,38,3.11
202503,76111000,3,833,71,762,11.73
202503,76111000,3S2,654,351,303,1.86
202503,76111000,3S3,2701,6110,-3409,0.44
202503,76111000,4,5,1,4,5
202503,76111000,CA,708,598,110,1.18
202503,76111000,V2,0,2,-2,0
202503,76111000,V3,5,0,5,NA
202503,76111000,V4,1,0,1,NA
202503,76111001,2,0,2,-2,0
202503,76111002,CA,0,4,-4,0
202503,76111005,2,1,0,1,NA
202503,76111016,3S3,4,0,4,NA
202503,76111020,2,2,2,0,1
202503,76111022,CA,0,1,-1,0
202503,76113000,2,187,507,-320,0.37
202503,76113000,2R2,0,1,-1,0
202503,76113000,2S1,0,1,-1,0
202503,76113000,2S2,18,50,-32,0.36
202503,76113000,2S3,18,21,-3,0.86
202503,76113000,3,28,25,3,1.12
202503,76113000,3S2,221,46,175,4.8
202503,76113000,3S3,267,409,-142,0.65
202503,76113000,4,1,0,1,NA
202503,76113000,CA,11,202,-191,0.05
202503,76113000,V3,0,3,-3,0
202503,76113001,2,5,5,0,1
202503,76113004,2,0,1,-1,0
202503,76113004,3S3,0,4,-4,0
202503,76113008,2,0,1,-1,0
202503,76113013,2,3,3,0,1
202503,76113013,CA,1,0,1,NA
202503,76122000,2,43,248,-205,0.17
202503,76122000,2S3,1,0,1,NA
202503,76122000,3,0,3,-3,0
202503,76122000,3S2,2,2,0,1
202503,76122000,3S3,16,22,-6,0.73
202503,76122000,CA,1,110,-109,0.01
202503,76126000,2,12,189,-177,0.06
202503,76126000,2R2,0,1,-1,0
202503,76126000,2S2,0,2,-2,0
202503,76126000,3,1,4,-3,0.25
202503,76126000,3S3,1,0,1,NA
202503,76126000,CA,0,95,-95,0
202503,76126013,2,1,3,-2,0.33
202503,76126013,CA,1,1,0,1
202503,76130000,2,1665,2622,-957,0.64
202503,76130000,2S1,40,0,40,NA
202503,76130000,2S2,171,37,134,4.62
202503,76130000,2S3,47,18,29,2.61
202503,76130000,3,438,124,314,3.53
202503,76130000,3S1,26,0,26,NA
202503,76130000,3S2,272,214,58,1.27
202503,76130000,3S3,874,1305,-431,0.67
202503,76130000,3S4,2,1,1,2
202503,76130000,4,0,1,-1,0
202503,76130000,CA,590,482,108,1.22
202503,76130000,V2,1,0,1,NA
202503,76130002,3S2,0,1,-1,0
202503,76130002,3S3,0,5,-5,0
202503,76130003,2,2,2,0,1
202503,76130003,CA,0,1,-1,0
202503,76130004,2,2,4,-2,0.5
202503,76130004,CA,0,2,-2,0
202503,76130006,2,1,4,-3,0.25
202503,76130007,2,9,12,-3,0.75
202503,76130007,3S3,2,4,-2,0.5
202503,76130007,CA,1,0,1,NA
202503,76130008,2,484,60,424,8.07
202503,76130008,2S1,0,4,-4,0
202503,76130008,2S2,5,16,-11,0.31
202503,76130008,2S3,0,5,-5,0
202503,76130008,3,7,48,-41,0.15
202503,76130008,3S1,0,4,-4,0
202503,76130008,3S2,65,12,53,5.42
202503,76130008,3S3,7,19,-12,0.37
202503,76130008,CA,617,10,607,61.7
202503,76130009,3S3,17,0,17,NA
202503,76130016,2,0,17,-17,0
202503,76130016,3,0,1,-1,0
202503,76130016,CA,0,2,-2,0
202503,76147000,2,2249,2102,147,1.07
202503,76147000,2R2,0,5,-5,0
202503,76147000,2S2,22,112,-90,0.2
202503,76147000,2S3,13,27,-14,0.48
202503,76147000,3,65,179,-114,0.36
202503,76147000,3S2,91,75,16,1.21
202503,76147000,3S3,1174,2512,-1338,0.47
202503,76147000,3S4,0,1,-1,0
202503,76147000,4,1,6,-5,0.17
202503,76147000,CA,47,587,-540,0.08
202503,76147000,V3,9,0,9,NA
202503,76147002,2,1,0,1,NA
202503,76147010,2,245,168,77,1.46
202503,76147010,2S2,1,1,0,1
202503,76147010,3,4,1,3,4
202503,76147010,3S2,1,0,1,NA
202503,76147010,3S3,55,21,34,2.62
202503,76147010,CA,30,1,29,30
202503,76147010,V2,6,0,6,NA
202503,76233000,2,266,180,86,1.48
202503,76233000,3,0,1,-1,0
202503,76233000,3S2,105,0,105,NA
202503,76233000,3S3,168,8,160,21
202503,76233000,CA,2,173,-171,0.01
202503,76233000,V2,1,0,1,NA
202503,76233002,2,0,5,-5,0
202503,76233004,2,0,1,-1,0
202503,76233005,2,0,2,-2,0
202503,76233008,2,1,0,1,NA
202503,76233009,2,0,10,-10,0
202503,76233011,2,0,25,-25,0
202503,76233011,CA,0,8,-8,0
202503,76233012,2,0,2,-2,0
202503,76233017,2,13,25,-12,0.52
202503,76233017,2S2,0,6,-6,0
202503,76233017,2S3,0,2,-2,0
202503,76233017,3,0,1,-1,0
202503,76233017,3S2,0,13,-13,0
202503,76233017,3S3,6,19,-13,0.32
202503,76233017,CA,3,15,-12,0.2
202503,76233023,2,1,0,1,NA
202503,76233024,2,0,4,-4,0
202503,76233025,2S3,1,0,1,NA
202503,76233025,3S3,2,0,2,NA
202503,76243000,2,3,17,-14,0.18
202503,76243000,CA,2,3,-1,0.67
202503,76243010,3S2,0,1,-1,0
202503,76246000,2,5,30,-25,0.17
202503,76246000,CA,1,24,-23,0.04
202503,76248000,2,417,478,-61,0.87
202503,76248000,2R2,0,4,-4,0
202503,76248000,2S2,1,35,-34,0.03
202503,76248000,2S3,0,5,-5,0
202503,76248000,3,1,38,-37,0.03
202503,76248000,3S1,0,1,-1,0
202503,76248000,3S2,420,11,409,38.18
202503,76248000,3S3,783,78,705,10.04
202503,76248000,4,0,2,-2,0
202503,76248000,CA,90,319,-229,0.28
202503,76248001,2,0,3,-3,0
202503,76248001,3S2,1,0,1,NA
202503,76248001,3S3,2,0,2,NA
202503,76248005,3S3,21,38,-17,0.55
202503,76248005,CA,0,2,-2,0
202503,76248009,2,2,14,-12,0.14
202503,76248009,3,0,4,-4,0
202503,76248009,3S3,0,2,-2,0
202503,76248009,CA,2,2,0,1
202503,76250000,2,3,84,-81,0.04
202503,76250000,3,0,35,-35,0
202503,76250000,CA,1,12,-11,0.08
202503,76250000,V2,1,0,1,NA
202503,76250013,3S3,0,1,-1,0
202503,76275000,2,26,279,-253,0.09
202503,76275000,2R2,0,1,-1,0
202503,76275000,2S2,0,5,-5,0
202503,76275000,3,5,23,-18,0.22
202503,76275000,3S1,0,1,-1,0
202503,76275000,3S2,3,2,1,1.5
202503,76275000,3S3,171,7,164,24.43
202503,76275000,CA,4,238,-234,0.02
202503,76275000,V2,1,0,1,NA
202503,76275004,2,1,0,1,NA
202503,76275008,2,0,48,-48,0
202503,76275008,3,0,9,-9,0
202503,76275008,3S3,2,21,-19,0.1
202503,76275008,CA,0,17,-17,0
202503,76306000,2,1067,881,186,1.21
202503,76306000,2S1,0,8,-8,0
202503,76306000,2S2,21,21,0,1
202503,76306000,2S3,0,5,-5,0
202503,76306000,3,0,33,-33,0
202503,76306000,3S1,0,5,-5,0
202503,76306000,3S2,0,32,-32,0
202503,76306000,3S3,3,62,-59,0.05
202503,76306000,CA,39,125,-86,0.31
202503,76306001,2,0,2,-2,0
202503,76318000,2,119,320,-201,0.37
202503,76318000,2R2,0,1,-1,0
202503,76318000,2S1,0,2,-2,0
202503,76318000,2S2,0,2,-2,0
202503,76318000,2S3,0,2,-2,0
202503,76318000,3,2,30,-28,0.07
202503,76318000,3S2,19,29,-10,0.66
202503,76318000,3S3,333,53,280,6.28
202503,76318000,CA,3,170,-167,0.02
202503,76318004,2,0,1,-1,0
202503,76318004,V2,2,0,2,NA
202503,76318006,3S3,3,0,3,NA
202503,76318008,2,3,10,-7,0.3
202503,76318008,3S3,0,21,-21,0
202503,76318008,CA,0,1,-1,0
202503,76364000,2,764,2294,-1530,0.33
202503,76364000,2R2,0,3,-3,0
202503,76364000,2S1,0,7,-7,0
202503,76364000,2S2,4,79,-75,0.05
202503,76364000,2S3,1,24,-23,0.04
202503,76364000,3,42,71,-29,0.59
202503,76364000,3S1,0,3,-3,0
202503,76364000,3S2,14,122,-108,0.11
202503,76364000,3S3,84,366,-282,0.23
202503,76364000,3S4,3,1,2,3
202503,76364000,CA,137,1173,-1036,0.12
202503,76364002,2,0,2,-2,0
202503,76364004,2,0,2,-2,0
202503,76364006,2,0,2,-2,0
202503,76364006,3S3,0,2,-2,0
202503,76364007,2,0,1,-1,0
202503,76364009,2,0,1,-1,0
202503,76364010,2,0,18,-18,0
202503,76364013,2,2,21,-19,0.1
202503,76364013,3,0,1,-1,0
202503,76364015,2,0,6,-6,0
202503,76364021,2,0,1,-1,0
202503,76377000,2,2,58,-56,0.03
202503,76377000,CA,0,42,-42,0
202503,76377001,2,0,20,-20,0
202503,76377004,2,2,1,1,2
202503,76377004,CA,0,1,-1,0
202503,76377005,CA,0,1,-1,0
202503,76400000,2,290,281,9,1.03
202503,76400000,2S2,1,2,-1,0.5
202503,76400000,3,12,45,-33,0.27
202503,76400000,3S2,36,6,30,6
202503,76400000,3S3,51,178,-127,0.29
202503,76400000,CA,2,66,-64,0.03
202503,76400007,2,29,36,-7,0.81
202503,76400007,3,0,5,-5,0
202503,76400007,3S3,3,31,-28,0.1
202503,76400007,CA,0,2,-2,0
202503,76403000,2,118,128,-10,0.92
202503,76403000,2S2,0,2,-2,0
202503,76403000,2S3,0,4,-4,0
202503,76403000,3,242,14,228,17.29
202503,76403000,3S2,24,0,24,NA
202503,76403000,3S3,23,1,22,23
202503,76403000,4,0,1,-1,0
202503,76403000,CA,0,8,-8,0
202503,76403003,2,1,0,1,NA
202503,76403003,3,1,0,1,NA
202503,76403007,2,0,3,-3,0
202503,76403007,3,0,5,-5,0
202503,76403007,3S3,3,5,-2,0.6
202503,76403007,CA,0,1,-1,0
202503,76403010,2,0,2,-2,0
202503,76497000,2,16,72,-56,0.22
202503,76497000,2S2,0,2,-2,0
202503,76497000,3,4,33,-29,0.12
202503,76497000,3S2,0,1,-1,0
202503,76497000,3S3,1,2,-1,0.5
202503,76497000,4,0,1,-1,0
202503,76497000,CA,0,32,-32,0
202503,76497001,2,0,2,-2,0
202503,76520000,2,10527,5025,5502,2.09
202503,76520000,2B1,0,6,-6,0
202503,76520000,2B2,0,1,-1,0
202503,76520000,2R2,158,1,157,158
202503,76520000,2S1,0,5,-5,0
202503,76520000,2S2,1448,1504,-56,0.96
202503,76520000,2S3,352,277,75,1.27
202503,76520000,3,246,252,-6,0.98
202503,76520000,3S1,1,1,0,1
202503,76520000,3S2,1788,1778,10,1.01
202503,76520000,3S3,2852,3683,-831,0.77
202503,76520000,3S4,2,8,-6,0.25
202503,76520000,4,1,3,-2,0.33
202503,76520000,CA,1537,1750,-213,0.88
202503,76520000,V2,0,145,-145,0
202503,76520001,2,0,6,-6,0
202503,76520002,2,139,4,135,34.75
202503,76520002,2S2,0,11,-11,0
202503,76520002,2S3,0,5,-5,0
202503,76520002,3,0,11,-11,0
202503,76520002,3S1,0,1,-1,0
202503,76520002,3S2,0,18,-18,0
202503,76520002,3S3,5,3,2,1.67
202503,76520002,CA,0,2,-2,0
202503,76520003,3S3,1,1,0,1
202503,76520004,3S2,1,0,1,NA
202503,76520005,2,0,3,-3,0
202503,76520007,2,0,2,-2,0
202503,76520009,2,0,1,-1,0
202503,76520009,CA,0,4,-4,0
202503,76520010,2,13,5,8,2.6
202503,76520010,3S2,0,1,-1,0
202503,76520010,3S3,4,0,4,NA
202503,76520014,4,0,1,-1,0
202503,76520016,2,0,3,-3,0
202503,76520016,3S2,1,0,1,NA
202503,76520022,2,0,15,-15,0
202503,76520022,3S3,0,6,-6,0
202503,76520023,2,0,9,-9,0
202503,76520023,CA,0,1,-1,0
202503,76520024,2,353,14,339,25.21
202503,76520024,2S1,3,0,3,NA
202503,76520024,2S2,332,456,-124,0.73
202503,76520024,3S2,5,5,0,1
202503,76520024,3S3,1,3,-2,0.33
202503,76520024,CA,15,0,15,NA
202503,76520025,2,0,1,-1,0
202503,76520026,2,98,56,42,1.75
202503,76520026,2S2,1,5,-4,0.2
202503,76520026,2S3,0,10,-10,0
202503,76520026,3,9,7,2,1.29
202503,76520026,3S2,4,9,-5,0.44
202503,76520026,3S3,2,24,-22,0.08
202503,76520026,3S4,1,1,0,1
202503,76520026,CA,3,40,-37,0.07
202503,76520028,2,2,3,-1,0.67
202503,76520029,2,1,1,0,1
202503,76520029,CA,0,1,-1,0
202503,76520032,2,0,1,-1,0
202503,76520038,2,60,16,44,3.75
202503,76520038,3,1,0,1,NA
202503,76520038,3S2,2,12,-10,0.17
202503,76520038,3S3,3,49,-46,0.06
202503,76520038,CA,2,1,1,2
202503,76563000,2,110,282,-172,0.39
202503,76563000,2R2,0,1,-1,0
202503,76563000,2S2,0,20,-20,0
202503,76563000,2S3,2,4,-2,0.5
202503,76563000,3,1,8,-7,0.12
202503,76563000,3S2,29,7,22,4.14
202503,76563000,3S3,195,132,63,1.48
202503,76563000,4,0,1,-1,0
202503,76563000,CA,19,202,-183,0.09
202503,76563018,2,0,6,-6,0
202503,76563018,2S3,0,2,-2,0
202503,76606000,2,274,295,-21,0.93
202503,76606000,2R2,0,1,-1,0
202503,76606000,2S1,3,0,3,NA
202503,76606000,2S2,0,20,-20,0
202503,76606000,2S3,0,1,-1,0
202503,76606000,3,6,102,-96,0.06
202503,76606000,3S1,0,1,-1,0
202503,76606000,3S2,1,7,-6,0.14
202503,76606000,3S3,0,11,-11,0
202503,76606000,CA,2,83,-81,0.02
202503,76606004,2,0,1,-1,0
202503,76616000,2,14,103,-89,0.14
202503,76616000,2R2,0,1,-1,0
202503,76616000,2S3,0,1,-1,0
202503,76616000,3,2,37,-35,0.05
202503,76616000,3S2,15,1,14,15
202503,76616000,3S3,235,13,222,18.08
202503,76616000,CA,0,51,-51,0
202503,76616000,V3,0,3,-3,0
202503,76616002,2,0,2,-2,0
202503,76616009,2,2,7,-5,0.29
202503,76622000,2,31,370,-339,0.08
202503,76622000,2S2,0,7,-7,0
202503,76622000,2S3,1,2,-1,0.5
202503,76622000,3,2,31,-29,0.06
202503,76622000,3S2,5,11,-6,0.45
202503,76622000,3S3,44,55,-11,0.8
202503,76622000,4,2,2,0,1
202503,76622000,CA,5,161,-156,0.03
202503,76622000,V3,0,3,-3,0
202503,76622005,2,4,31,-27,0.13
202503,76622005,2S2,4,2,2,2
202503,76622005,2S3,0,1,-1,0
202503,76622005,3S2,1,2,-1,0.5
202503,76622005,3S3,26,58,-32,0.45
202503,76622005,CA,3,15,-12,0.2
202503,76622007,3S3,0,1,-1,0
202503,76670000,2,52,95,-43,0.55
202503,76670000,2S2,0,8,-8,0
202503,76670000,2S3,0,2,-2,0
202503,76670000,3,3,14,-11,0.21
202503,76670000,3S2,1,3,-2,0.33
202503,76670000,3S3,33,191,-158,0.17
202503,76670000,CA,1,18,-17,0.06
202503,76670004,2,1,0,1,NA
202503,76670007,2,6,14,-8,0.43
202503,76670007,3,0,2,-2,0
202503,76670007,3S2,0,4,-4,0
202503,76670007,3S3,0,4,-4,0
202503,76670011,2,0,1,-1,0
202503,76670015,2,1,1,0,1
202503,76736000,2,34,490,-456,0.07
202503,76736000,3,1,4,-3,0.25
202503,76736000,3S2,16,2,14,8
202503,76736000,3S3,5,14,-9,0.36
202503,76736000,CA,2,175,-173,0.01
202503,76736000,V2R2,1,1,0,1
202503,76823000,2,15,119,-104,0.13
202503,76823000,3,3,3,0,1
202503,76823000,3S2,0,2,-2,0
202503,76823000,3S3,0,4,-4,0
202503,76823000,CA,10,61,-51,0.16
202503,76828000,2,74,128,-54,0.58
202503,76828000,2R2,0,3,-3,0
202503,76828000,3,1,20,-19,0.05
202503,76828000,CA,1,57,-56,0.02
202503,76828004,2,1,0,1,NA
202503,76828004,CA,0,1,-1,0
202503,76828017,CA,0,3,-3,0
202503,76834000,2,864,2892,-2028,0.3
202503,76834000,2R2,0,37,-37,0
202503,76834000,2S1,2,10,-8,0.2
202503,76834000,2S2,14,93,-79,0.15
202503,76834000,2S3,16,25,-9,0.64
202503,76834000,3,45,78,-33,0.58
202503,76834000,3S1,0,2,-2,0
202503,76834000,3S2,146,89,57,1.64
202503,76834000,3S3,699,1142,-443,0.61
202503,76834000,3S4,1,2,-1,0.5
202503,76834000,4,1,1,0,1
202503,76834000,CA,590,1062,-472,0.56
202503,76834000,V2,0,1,-1,0
202503,76834000,V4,1,0,1,NA
202503,76834002,3S3,0,6,-6,0
202503,76834003,2,0,1,-1,0
202503,76834003,3,0,1,-1,0
202503,76834010,2,1,5,-4,0.2
202503,76834010,CA,0,1,-1,0
202503,76834023,2,0,3,-3,0
202503,76845000,2,20,26,-6,0.77
202503,76845000,CA,0,20,-20,0
202503,76863000,2,50,25,25,2
202503,76863000,3,1,0,1,NA
202503,76863000,CA,0,48,-48,0
202503,76863012,2,0,1,-1,0
202503,76869000,2,46,103,-57,0.45
202503,76869000,2S2,1,2,-1,0.5
202503,76869000,2S3,1,0,1,NA
202503,76869000,3,11,2,9,5.5
202503,76869000,3S2,0,14,-14,0
202503,76869000,3S3,41,82,-41,0.5
202503,76869000,CA,1,92,-91,0.01
202503,76869000,V2,13,0,13,NA
202503,76869004,2,0,2,-2,0
202503,76890000,2,748,255,493,2.93
202503,76890000,2S1,0,4,-4,0
202503,76890000,2S2,1610,2607,-997,0.62
202503,76890000,2S3,194,132,62,1.47
202503,76890000,3,51,77,-26,0.66
202503,76890000,3S1,0,5,-5,0
202503,76890000,3S2,32,364,-332,0.09
202503,76890000,3S3,902,2485,-1583,0.36
202503,76890000,3S4,1,1,0,1
202503,76890000,4,13,0,13,NA
202503,76890000,CA,0,77,-77,0
202503,76890000,V2,0,1,-1,0
202503,76890006,2,36,4,32,9
202503,76890006,2S2,1,0,1,NA
202503,76890006,2S3,1,0,1,NA
202503,76890006,3,8,0,8,NA
202503,76890006,3S2,0,2,-2,0
202503,76890006,3S3,14,0,14,NA
202503,76890006,CA,0,1,-1,0
202503,76890007,2,0,1,-1,0
202503,76892000,2,36190,7872,28318,4.6
202503,76892000,2B1,0,5,-5,0
202503,76892000,2B2,0,1,-1,0
202503,76892000,2R2,1,5,-4,0.2
202503,76892000,2R3,4,6,-2,0.67
202503,76892000,2S1,2,7,-5,0.29
202503,76892000,2S2,1766,2644,-878,0.67
202503,76892000,2S3,439,655,-216,0.67
202503,76892000,3,1336,184,1152,7.26
202503,76892000,3S1,2,39,-37,0.05
202503,76892000,3S2,3043,3900,-857,0.78
202503,76892000,3S3,8075,8739,-664,0.92
202503,76892000,3S4,17,6,11,2.83
202503,76892000,4,27,9,18,3
202503,76892000,CA,11650,1341,10309,8.69
202503,76892000,V4,4,1,3,4
202503,76892002,2,0,27,-27,0
202503,76892002,CA,0,4,-4,0
202503,76892004,2,125,118,7,1.06
202503,76892004,2S2,1,2,-1,0.5
202503,76892004,3,1,5,-4,0.2
202503,76892004,3S2,12,4,8,3
202503,76892004,3S3,26,13,13,2
202503,76892004,CA,7,5,2,1.4
202503,76892005,2,40,6,34,6.67
202503,76892005,3,5,0,5,NA
202503,76892005,3S2,3,0,3,NA
202503,76892005,3S3,28,12,16,2.33
202503,76892008,2,149,1,148,149
202503,76892008,3,15,0,15,NA
202503,76892008,3S2,1,0,1,NA
202503,76892008,3S3,53,0,53,NA
202503,76892010,2,0,4,-4,0
202503,76892010,2S2,0,2,-2,0
202503,76892010,3S3,0,1,-1,0
202503,76892012,2,0,8,-8,0
202503,76892017,2,281,6,275,46.83
202503,76892017,3S2,9,22,-13,0.41
202503,76892017,3S3,23,57,-34,0.4
202503,76892017,CA,167,0,167,NA
202503,76895000,2,51,567,-516,0.09
202503,76895000,2R2,0,9,-9,0
202503,76895000,2S2,1,14,-13,0.07
202503,76895000,2S3,4,7,-3,0.57
202503,76895000,3,3,9,-6,0.33
202503,76895000,3S2,77,23,54,3.35
202503,76895000,3S3,459,128,331,3.59
202503,76895000,4,1,1,0,1
202503,76895000,CA,4,162,-158,0.02
202503,76895002,2,208,402,-194,0.52
202503,76895002,2R2,0,2,-2,0
202503,76895002,2S2,38,21,17,1.81
202503,76895002,2S3,22,30,-8,0.73
202503,76895002,3,3,1,2,3
202503,76895002,3S1,0,1,-1,0
202503,76895002,3S2,99,79,20,1.25
202503,76895002,3S3,292,209,83,1.4
202503,76895002,CA,1,81,-80,0.01
202503,76895002,V2,0,6,-6,0
202503,76895005,2,0,3,-3,0
202503,76895007,2,0,1,-1,0
202503,81001000,2,219,2498,-2279,0.09
202503,81001000,2S2,0,3,-3,0
202503,81001000,2S3,0,1,-1,0
202503,81001000,3,5,52,-47,0.1
202503,81001000,3S2,2,9,-7,0.22
202503,81001000,3S3,24,440,-416,0.05
202503,81001000,CA,10,76,-66,0.13
202503,81001000,V2,0,9,-9,0
202503,81001000,V3,4,56,-52,0.07
202503,81065000,2,43,235,-192,0.18
202503,81065000,3,1,2,-1,0.5
202503,81065000,3S2,5,2,3,2.5
202503,81065000,3S3,18,21,-3,0.86
202503,81065000,CA,2,9,-7,0.22
202503,81065008,2,0,22,-22,0
202503,81065008,3,0,1,-1,0
202503,81065009,2,0,1,-1,0
202503,81065017,2,2,23,-21,0.09
202503,81220000,2,3,18,-15,0.17
202503,81300000,2,6,89,-83,0.07
202503,81300000,3,0,6,-6,0
202503,81300000,3S2,0,2,-2,0
202503,81300000,3S3,0,11,-11,0
202503,81300000,CA,0,7,-7,0
202503,81591000,2,4,4,0,1
202503,81591000,3,0,2,-2,0
202503,81591000,3S3,0,1,-1,0
202503,81736000,2,162,1090,-928,0.15
202503,81736000,2S3,2,1,1,2
202503,81736000,3,189,25,164,7.56
202503,81736000,3S1,1,8,-7,0.12
202503,81736000,3S2,6,10,-4,0.6
202503,81736000,3S3,26,159,-133,0.16
202503,81736000,3S4,1,3,-2,0.33
202503,81736000,4,10,3,7,3.33
202503,81736000,CA,12,32,-20,0.38
202503,81736000,V2,14,0,14,NA
202503,81736000,V3,66,0,66,NA
202503,81736008,2,0,5,-5,0
202503,81794000,2,131,645,-514,0.2
202503,81794000,2S2,1,0,1,NA
202503,81794000,2S3,4,1,3,4
202503,81794000,3,2,22,-20,0.09
202503,81794000,3S1,6,2,4,3
202503,81794000,3S2,13,6,7,2.17
202503,81794000,3S3,1312,73,1239,17.97
202503,81794000,3S4,2,1,1,2
202503,81794000,CA,3,41,-38,0.07
202503,81794004,2,4,5,-1,0.8
202503,81794004,3S1,4,0,4,NA
202503,81794004,3S3,3,14,-11,0.21
202503,81794004,CA,0,5,-5,0
202503,81794006,3S3,0,1,-1,0
202503,81794010,2,0,2,-2,0
202503,85001000,2,1277,3589,-2312,0.36
202503,85001000,2R2,0,1,-1,0
202503,85001000,2S1,5,2,3,2.5
202503,85001000,2S2,118,214,-96,0.55
202503,85001000,2S3,37,61,-24,0.61
202503,85001000,3,163,312,-149,0.52
202503,85001000,3S1,16,7,9,2.29
202503,85001000,3S2,620,1167,-547,0.53
202503,85001000,3S3,3344,3694,-350,0.91
202503,85001000,3S4,28,21,7,1.33
202503,85001000,4,7,6,1,1.17
202503,85001000,4S2,4,2,2,2
202503,85001000,CA,295,657,-362,0.45
202503,85001000,V2,77,0,77,NA
202503,85001000,V3,619,26,593,23.81
202503,85001000,V4,0,2,-2,0
202503,85001001,2,2,3,-1,0.67
202503,85001001,3,6,0,6,NA
202503,85001001,3S1,0,1,-1,0
202503,85001001,3S2,1,6,-5,0.17
202503,85001001,3S3,57,9,48,6.33
202503,85001001,CA,0,3,-3,0
202503,85001002,2,8,18,-10,0.44
202503,85001002,2S2,1,0,1,NA
202503,85001002,3,3,2,1,1.5
202503,85001002,3S2,7,32,-25,0.22
202503,85001002,3S3,68,361,-293,0.19
202503,85001002,4S2,1,0,1,NA
202503,85001002,CA,0,1,-1,0
202503,85001002,V3,22,3,19,7.33
202503,85001002,V4,3,0,3,NA
202503,85001003,2,5,2,3,2.5
202503,85001003,2S2,0,1,-1,0
202503,85001003,3S2,20,3,17,6.67
202503,85001003,3S3,28,8,20,3.5
202503,85001003,CA,0,4,-4,0
202503,85001005,3S2,0,1,-1,0
202503,85001005,3S3,2,1,1,2
202503,85001006,2,0,1,-1,0
202503,85001006,2S3,0,1,-1,0
202503,85001006,3S2,0,16,-16,0
202503,85001006,3S3,0,6,-6,0
202503,85001006,V2,2,0,2,NA
202503,85001006,V3,1,0,1,NA
202503,85001007,2,0,3,-3,0
202503,85001007,3S2,1,0,1,NA
202503,85001007,3S3,9,0,9,NA
202503,85001009,2,0,14,-14,0
202503,85001009,2S2,0,1,-1,0
202503,85010000,2,154,263,-109,0.59
202503,85010000,2S2,6,3,3,2
202503,85010000,2S3,1,13,-12,0.08
202503,85010000,3,231,102,129,2.26
202503,85010000,3S1,1,18,-17,0.06
202503,85010000,3S2,413,1275,-862,0.32
202503,85010000,3S3,1192,1020,172,1.17
202503,85010000,3S4,3,3,0,1
202503,85010000,CA,6,57,-51,0.11
202503,85010000,V2,8,52,-44,0.15
202503,85010000,V3,63,703,-640,0.09
202503,85010000,V4,9,39,-30,0.23
202503,85010001,2,0,3,-3,0
202503,85010001,3S2,5,1,4,5
202503,85010001,3S3,197,14,183,14.07
202503,85010005,2,0,2,-2,0
202503,85010005,3S2,1,0,1,NA
202503,85010005,3S3,0,4,-4,0
202503,85010005,V3,0,6,-6,0
202503,85010010,3S3,15,0,15,NA
202503,85015000,2,1,1,0,1
202503,85015000,3,0,1,-1,0
202503,85015000,3S2,1,1,0,1
202503,85015000,V3,0,14,-14,0
202503,85125000,2,20,114,-94,0.18
202503,85125000,3,3,11,-8,0.27
202503,85125000,3S2,1,22,-21,0.05
202503,85125000,3S3,0,85,-85,0
202503,85125000,CA,1,6,-5,0.17
202503,85125000,V3,0,4,-4,0
202503,85139000,2,28,155,-127,0.18
202503,85139000,2S2,8,9,-1,0.89
202503,85139000,2S3,3,5,-2,0.6
202503,85139000,3,15,40,-25,0.38
202503,85139000,3S2,123,103,20,1.19
202503,85139000,3S3,393,566,-173,0.69
202503,85139000,3S4,0,2,-2,0
202503,85139000,4,1,2,-1,0.5
202503,85139000,CA,7,52,-45,0.13
202503,85139000,V2,0,13,-13,0
202503,85139000,V3,0,95,-95,0
202503,85139003,3S3,2,0,2,NA
202503,85139005,3S2,1,1,0,1
202503,85139005,3S3,4,1,3,4
202503,85162000,2,20,95,-75,0.21
202503,85162000,2S1,0,1,-1,0
202503,85162000,2S2,5,4,1,1.25
202503,85162000,2S3,0,1,-1,0
202503,85162000,3,17,77,-60,0.22
202503,85162000,3S2,11,881,-870,0.01
202503,85162000,3S3,10,2195,-2185,0
202503,85162000,CA,4,29,-25,0.14
202503,85162000,V3,1,2,-1,0.5
202503,85162004,3S3,0,55,-55,0
202503,85225000,2,21,39,-18,0.54
202503,85225000,2S2,0,2,-2,0
202503,85225000,3,7,4,3,1.75
202503,85225000,3S1,1,0,1,NA
202503,85225000,3S2,3,6,-3,0.5
202503,85225000,3S3,113,28,85,4.04
202503,85225000,3S4,1,0,1,NA
202503,85225000,CA,2,6,-4,0.33
202503,85225000,V3,40,15,25,2.67
202503,85225006,3S3,0,1,-1,0
202503,85225006,CA,1,0,1,NA
202503,85225009,2,1,3,-2,0.33
202503,85225009,2S2,0,1,-1,0
202503,85225009,2S3,0,1,-1,0
202503,85225009,CA,3,3,0,1
202503,85225016,2,0,1,-1,0
202503,85225016,3S2,1,0,1,NA
202503,85230000,2,48,200,-152,0.24
202503,85230000,2S1,8,0,8,NA
202503,85230000,2S2,39,40,-1,0.98
202503,85230000,2S3,16,12,4,1.33
202503,85230000,3,11,74,-63,0.15
202503,85230000,3S1,13,4,9,3.25
202503,85230000,3S2,548,41,507,13.37
202503,85230000,3S3,1557,247,1310,6.3
202503,85230000,3S4,14,2,12,7
202503,85230000,4S2,1,3,-2,0.33
202503,85230000,CA,6,28,-22,0.21
202503,85230000,V2,12,32,-20,0.38
202503,85230000,V3,82,527,-445,0.16
202503,85230000,V4,8,3,5,2.67
202503,85230003,2,0,4,-4,0
202503,85230003,3S2,283,0,283,NA
202503,85230003,3S3,95,2,93,47.5
202503,85230006,3S3,18,0,18,NA
202503,85250000,2,114,473,-359,0.24
202503,85250000,2S1,0,2,-2,0
202503,85250000,2S2,4,6,-2,0.67
202503,85250000,2S3,0,4,-4,0
202503,85250000,3,0,38,-38,0
202503,85250000,3S1,0,4,-4,0
202503,85250000,3S2,165,34,131,4.85
202503,85250000,3S3,370,307,63,1.21
202503,85250000,3S4,0,4,-4,0
202503,85250000,4,0,1,-1,0
202503,85250000,4S2,2,2,0,1
202503,85250000,CA,12,83,-71,0.14
202503,85250000,V3,0,17,-17,0
202503,85250001,3S3,4,0,4,NA
202503,85250002,3S2,6,0,6,NA
202503,85250002,4S2,1,1,0,1
202503,85250003,2S2,0,3,-3,0
202503,85250003,2S3,0,2,-2,0
202503,85250003,3S2,1,2,-1,0.5
202503,85250003,3S3,20,34,-14,0.59
202503,85250003,3S4,0,1,-1,0
202503,85250005,2,0,2,-2,0
202503,85250006,2,2,2,0,1
202503,85263000,2,40,88,-48,0.45
202503,85263000,2S2,1,0,1,NA
202503,85263000,3,2,14,-12,0.14
202503,85263000,3S1,5,6,-1,0.83
202503,85263000,3S2,9,14,-5,0.64
202503,85263000,3S3,219,150,69,1.46
202503,85263000,3S4,0,1,-1,0
202503,85263000,CA,9,25,-16,0.36
202503,85263000,V2,0,5,-5,0
202503,85263000,V3,10,16,-6,0.62
202503,85263000,V4,0,8,-8,0
202503,85279000,2,0,1,-1,0
202503,85300000,2,2,6,-4,0.33
202503,85300000,3,0,1,-1,0
202503,85300000,3S2,1,0,1,NA
202503,85300001,2,2,2,0,1
202503,85300001,3,1,2,-1,0.5
202503,85300001,3S3,0,2,-2,0
202503,85300001,CA,0,23,-23,0
202503,85315000,2,1,6,-5,0.17
202503,85315000,3S2,0,1,-1,0
202503,85315000,3S3,0,3,-3,0
202503,85325000,2,26,93,-67,0.28
202503,85325000,2S2,1,7,-6,0.14
202503,85325000,2S3,1,0,1,NA
202503,85325000,3,2,13,-11,0.15
202503,85325000,3S2,43,20,23,2.15
202503,85325000,3S3,259,111,148,2.33
202503,85325000,3S4,2,2,0,1
202503,85325000,CA,1,10,-9,0.1
202503,85325000,V3,0,10,-10,0
202503,85400000,2,2,3,-1,0.67
202503,85400000,3,0,2,-2,0
202503,85400000,3S3,0,1,-1,0
202503,85400000,CA,0,2,-2,0
202503,85410000,2,60,261,-201,0.23
202503,85410000,2S2,14,5,9,2.8
202503,85410000,2S3,3,7,-4,0.43
202503,85410000,3,28,193,-165,0.15
202503,85410000,3S2,238,1627,-1389,0.15
202503,85410000,3S3,1072,3895,-2823,0.28
202503,85410000,3S4,1,0,1,NA
202503,85410000,4,0,8,-8,0
202503,85410000,CA,9,68,-59,0.13
202503,85410000,V2,5,6,-1,0.83
202503,85410000,V3,50,9,41,5.56
202503,85410001,3S2,0,41,-41,0
202503,85410001,3S3,0,217,-217,0
202503,85410002,3S2,0,2,-2,0
202503,85410002,3S3,0,2,-2,0
202503,85410003,2S2,0,4,-4,0
202503,85410003,3S2,0,6,-6,0
202503,85410003,3S3,0,11,-11,0
202503,85410005,3S3,0,11,-11,0
202503,85430000,2,27,117,-90,0.23
202503,85430000,2S2,4,6,-2,0.67
202503,85430000,2S3,1,3,-2,0.33
202503,85430000,3,1,7,-6,0.14
202503,85430000,3S2,11,19,-8,0.58
202503,85430000,3S3,21,95,-74,0.22
202503,85430000,3S4,2,3,-1,0.67
202503,85430000,4S2,1,2,-1,0.5
202503,85430000,CA,3,18,-15,0.17
202503,85430000,V3,0,45,-45,0
202503,85430001,2,0,1,-1,0
202503,85430001,V3,17,0,17,NA
202503,85430006,3S2,0,1,-1,0
202503,85440000,2,92,524,-432,0.18
202503,85440000,2R2,0,2,-2,0
202503,85440000,2S1,1,8,-7,0.12
202503,85440000,2S2,23,82,-59,0.28
202503,85440000,2S3,11,35,-24,0.31
202503,85440000,3,129,89,40,1.45
202503,85440000,3S1,3,6,-3,0.5
202503,85440000,3S2,560,110,450,5.09
202503,85440000,3S3,439,653,-214,0.67
202503,85440000,3S4,2,56,-54,0.04
202503,85440000,4,0,1,-1,0
202503,85440000,CA,35,112,-77,0.31
202503,85440000,V2,34,0,34,NA
202503,85440000,V3,661,2,659,330.5
202503,85440001,2,4,2,2,2
202503,85440001,2S2,0,1,-1,0
202503,85440001,2S3,0,3,-3,0
202503,85440001,3,3,3,0,1
202503,85440001,3S2,0,1,-1,0
202503,85440001,3S3,8,13,-5,0.62
202503,85440001,CA,0,1,-1,0
202503,85440002,2,1,0,1,NA
202503,85440002,3S3,7,7,0,1
202503,85440003,2S2,4,0,4,NA
202503,85440003,3S2,6,0,6,NA
202503,85440003,3S3,11,0,11,NA
202503,86001000,2,226,435,-209,0.52
202503,86001000,2R2,0,5,-5,0
202503,86001000,2S2,1,46,-45,0.02
202503,86001000,2S3,0,13,-13,0
202503,86001000,3,54,17,37,3.18
202503,86001000,3S2,1,6,-5,0.17
202503,86001000,3S3,9,170,-161,0.05
202503,86001000,CA,101,123,-22,0.82
202503,86001000,V2,2,1,1,2
202503,86001004,2,1,0,1,NA
202503,86001004,3,26,3,23,8.67
202503,86219000,2,0,4,-4,0
202503,86320000,2,129,180,-51,0.72
202503,86320000,2R2,0,7,-7,0
202503,86320000,2S1,0,2,-2,0
202503,86320000,2S2,0,1,-1,0
202503,86320000,2S3,0,2,-2,0
202503,86320000,3,198,9,189,22
202503,86320000,3S1,3,1,2,3
202503,86320000,3S2,12,214,-202,0.06
202503,86320000,3S3,66,325,-259,0.2
202503,86320000,CA,1,42,-41,0.02
202503,86320000,V2,1,0,1,NA
202503,86320008,2,0,1,-1,0
202503,86320010,2,0,2,-2,0
202503,86320012,CA,0,8,-8,0
202503,86568000,2,115,804,-689,0.14
202503,86568000,2R2,0,4,-4,0
202503,86568000,2S2,3,11,-8,0.27
202503,86568000,2S3,5,7,-2,0.71
202503,86568000,3,6,168,-162,0.04
202503,86568000,3S1,0,4,-4,0
202503,86568000,3S2,293,68,225,4.31
202503,86568000,3S3,598,581,17,1.03
202503,86568000,3S4,10,7,3,1.43
202503,86568000,4,0,2,-2,0
202503,86568000,CA,32,110,-78,0.29
202503,86568012,2,0,4,-4,0
202503,86568012,3S3,0,2,-2,0
202503,86568012,CA,1,0,1,NA
202503,86568013,2,3,54,-51,0.06
202503,86568013,3,0,3,-3,0
202503,86568013,3S2,1,0,1,NA
202503,86568013,3S3,46,7,39,6.57
202503,86568013,CA,0,12,-12,0
202503,86568014,2,2,0,2,NA
202503,86568016,2,0,2,-2,0
202503,86568016,3S2,6,0,6,NA
202503,86568016,3S3,3,1,2,3
202503,86568016,CA,0,1,-1,0
202503,86568017,2,2,1,1,2
202503,86568017,3S2,8,0,8,NA
202503,86568017,3S3,23,0,23,NA
202503,86568019,2,0,3,-3,0
202503,86568019,3S2,0,1,-1,0
202503,86568020,2,0,1,-1,0
202503,86568021,3S3,4,0,4,NA
202503,86568026,2,6,1,5,6
202503,86568026,2S3,2,0,2,NA
202503,86568026,3S2,1,0,1,NA
202503,86568026,3S3,17,0,17,NA
202503,86568026,CA,5,1,4,5
202503,86568028,2,0,1,-1,0
202503,86569000,2,1,27,-26,0.04
202503,86569000,3,50,23,27,2.17
202503,86569000,3S2,1,2,-1,0.5
202503,86569000,3S3,0,5,-5,0
202503,86569000,CA,0,21,-21,0
202503,86569000,V2,1,1,0,1
202503,86571000,2,0,38,-38,0
202503,86571000,3,0,1,-1,0
202503,86571000,3S3,0,5,-5,0
202503,86571000,V2,0,1,-1,0
202503,86573000,2,0,3,-3,0
202503,86573000,3,0,1,-1,0
202503,86749000,2,8,78,-70,0.1
202503,86749000,3,0,3,-3,0
202503,86749000,3S2,1,2,-1,0.5
202503,86749000,3S3,7,14,-7,0.5
202503,86749000,4,1,1,0,1
202503,86749000,CA,4,23,-19,0.17
202503,86749003,2,0,1,-1,0
202503,86749003,3S3,0,2,-2,0
202503,86749006,2,0,1,-1,0
202503,86755000,2,2,27,-25,0.07
202503,86755000,2S2,0,6,-6,0
202503,86755000,2S3,0,3,-3,0
202503,86755000,3S2,1,3,-2,0.33
202503,86755000,3S3,0,6,-6,0
202503,86755000,CA,0,22,-22,0
202503,86757000,2,12,92,-80,0.13
202503,86757000,2S1,2,0,2,NA
202503,86757000,2S2,1,2,-1,0.5
202503,86757000,3,1,182,-181,0.01
202503,86757000,3S1,0,2,-2,0
202503,86757000,3S2,3,116,-113,0.03
202503,86757000,3S3,34,864,-830,0.04
202503,86757000,CA,1,19,-18,0.05
202503,86757001,2,0,9,-9,0
202503,86757001,CA,0,2,-2,0
202503,86760000,2,0,8,-8,0
202503,86760000,3S3,0,2,-2,0
202503,86760000,CA,0,11,-11,0
202503,86865000,2,30,568,-538,0.05
202503,86865000,2S3,0,4,-4,0
202503,86865000,3,8,24,-16,0.33
202503,86865000,3S2,5,4,1,1.25
202503,86865000,3S3,3,71,-68,0.04
202503,86865000,CA,2,37,-35,0.05
202503,86865005,2,0,1,-1,0
202503,86865017,2,0,1,-1,0
202503,86865017,CA,0,15,-15,0
202503,86885000,2,20,150,-130,0.13
202503,86885000,2S2,0,1,-1,0
202503,86885000,3,52,127,-75,0.41
202503,86885000,3S1,4,0,4,NA
202503,86885000,3S2,92,0,92,NA
202503,86885000,3S3,675,74,601,9.12
202503,86885000,3S4,3,0,3,NA
202503,86885000,CA,26,36,-10,0.72
202503,86885000,V2,0,1,-1,0
202503,86885001,2,0,2,-2,0
202503,86885001,3,41,4,37,10.25
202503,86885001,3S2,1,0,1,NA
202503,86885001,3S3,25,0,25,NA
202503,86885009,3S3,0,2,-2,0
202503,86885010,2,0,4,-4,0
202503,88001000,2,0,5,-5,0
202503,88001000,2S2,0,3,-3,0
202503,88564000,2,0,2,-2,0
202503,88564000,2S2,0,1,-1,0
202503,88564000,3S3,0,2,-2,0
202503,91001000,2,0,28,-28,0
202503,91001000,3S3,0,8,-8,0
202503,91263000,2,0,1,-1,0
202503,94001000,2,0,17,-17,0
202503,94001000,3,0,10,-10,0
202503,94001000,3S2,0,22,-22,0
202503,94001000,3S3,0,30,-30,0
202503,94001000,CA,0,1,-1,0
202503,94884000,3S3,0,1,-1,0
202503,95001000,2,123,1506,-1383,0.08
202503,95001000,2R2,0,3,-3,0
202503,95001000,2S2,0,4,-4,0
202503,95001000,2S3,0,3,-3,0
202503,95001000,3,2,61,-59,0.03
202503,95001000,3S2,0,21,-21,0
202503,95001000,3S3,8,383,-375,0.02
202503,95001000,4,0,1,-1,0
202503,95001000,CA,33,333,-300,0.1
202503,95001000,V3,0,11,-11,0
202503,95015000,2,1,55,-54,0.02
202503,95015000,3,1,5,-4,0.2
202503,95015000,3S3,0,10,-10,0
202503,95015000,CA,1,7,-6,0.14
202503,95025000,2,2,29,-27,0.07
202503,95025000,3S3,1,8,-7,0.12
202503,95025000,CA,0,5,-5,0
202503,95025001,2,0,1,-1,0
202503,95025001,2S2,0,1,-1,0
202503,95200000,CA,0,2,-2,0
202503,97001000,2,0,15,-15,0
202503,97001000,2S2,0,2,-2,0
202503,97001000,3,0,15,-15,0
202503,97001000,3S3,0,3,-3,0
202503,97001000,CA,0,4,-4,0
202503,97161000,3,0,1,-1,0
202503,99001000,2,43,60,-17,0.72
202503,99001000,2S3,0,4,-4,0
202503,99001000,3,3,30,-27,0.1
202503,99001000,3S2,0,28,-28,0
202503,99001000,3S3,1,117,-116,0.01
202503,99001000,4,0,2,-2,0
202503,99001000,CA,0,7,-7,0
202503,99001000,V2,0,2,-2,0
202503,99001000,V3,0,1,-1,0
202503,99001001,3S3,2,0,2,NA
202503,99001005,2,0,1,-1,0
202503,99524000,2,1,91,-90,0.01
202503,99524000,3,0,10,-10,0
202503,99524000,3S2,7,0,7,NA
202503,99524000,3S3,15,16,-1,0.94
202503,99524000,CA,0,2,-2,0
202503,99524000,V2,0,1,-1,0
202503,99524000,V3,0,10,-10,0
202503,99524001,3,0,2,-2,0
202503,99524001,CA,0,1,-1,0
202503,99524007,3S3,0,2,-2,0
202503,99624000,2,4,32,-28,0.12
202503,99624000,3,6,3,3,2
202503,99624000,3S2,4,0,4,NA
202503,99624000,3S3,6,2,4,3
202503,99624000,CA,0,2,-2,0
202503,99624000,V2,0,2,-2,0
202503,99773000,2,1,21,-20,0.05
202503,99773000,2S2,1,0,1,NA
202503,99773000,3,1,24,-23,0.04
202503,99773000,3S2,3,2,1,1.5
202503,99773000,3S3,159,112,47,1.42
202503,99773000,4,1,0,1,NA
202503,99773000,CA,0,4,-4,0
202503,99773000,V3,1,0,1,NA
202503,99773002,2,0,4,-4,0
202503,99773002,3S2,0,1,-1,0
202503,99773002,3S3,94,50,44,1.88
202503,99773002,CA,0,2,-2,0
202503,99773002,V3R2,1,0,1,NA
202503,99773004,3S2,0,2,-2,0
202503,99773004,3S3,0,4,-4,0
202503,99773013,2,0,4,-4,0
202503,99773013,3,0,4,-4,0
202503,99773013,3S3,0,1,-1,0
202503,99773015,3,0,4,-4,0
202504,5001000,2,25735,32364,-6629,0.8
202504,5001000,2B1,6,6,0,1
202504,5001000,2R2,7,26,-19,0.27
202504,5001000,2S1,0,3,-3,0
202504,5001000,2S2,1221,2726,-1505,0.45
202504,5001000,2S3,315,1635,-1320,0.19
202504,5001000,3,1971,869,1102,2.27
202504,5001000,3S1,2,2,0,1
202504,5001000,3S2,2306,2954,-648,0.78
202504,5001000,3S3,3919,7462,-3543,0.53
202504,5001000,3S4,9,5,4,1.8
202504,5001000,4,14,83,-69,0.17
202504,5001000,CA,9376,16064,-6688,0.58
202504,5001000,V2,37,3,34,12.33
202504,5001000,V3,57,371,-314,0.15
202504,5001000,V4,1,0,1,NA
202504,5001001,2,4,58,-54,0.07
202504,5001001,CA,0,32,-32,0
202504,5001002,2,6,39,-33,0.15
202504,5001002,3,0,6,-6,0
202504,5001002,3S2,0,1,-1,0
202504,5001002,3S3,1,3,-2,0.33
202504,5001002,CA,1,12,-11,0.08
202504,5001003,2,12,19,-7,0.63
202504,5001003,2S2,0,1,-1,0
202504,5001003,3,1,2,-1,0.5
202504,5001003,3S2,0,2,-2,0
202504,5001003,3S3,9,2,7,4.5
202504,5001003,CA,0,3,-3,0
202504,5001004,2,3,39,-36,0.08
202504,5001004,3S2,1,0,1,NA
202504,5001004,CA,1,3,-2,0.33
202504,5001009,3S3,22,0,22,NA
202504,5001010,2,0,17,-17,0
202504,5002000,2,113,48,65,2.35
202504,5002000,2S2,0,13,-13,0
202504,5002000,3,2,16,-14,0.12
202504,5002000,3S3,0,1,-1,0
202504,5002000,CA,0,12,-12,0
202504,5002000,V2,196,1,195,196
202504,5002000,V3,0,3,-3,0
202504,5002010,2,0,31,-31,0
202504,5002010,3,0,10,-10,0
202504,5004000,2,0,10,-10,0
202504,5004000,3,0,2,-2,0
202504,5004000,3S3,21,1,20,21
202504,5021000,2,2,19,-17,0.11
202504,5021000,2S2,2,2,0,1
202504,5021000,3,0,10,-10,0
202504,5021000,3S2,0,1,-1,0
202504,5021000,3S3,25,0,25,NA
202504,5021000,CA,0,19,-19,0
202504,5021000,V3,0,1,-1,0
202504,5030000,2,204,427,-223,0.48
202504,5030000,2S2,2,2,0,1
202504,5030000,2S3,0,9,-9,0
202504,5030000,3,16,86,-70,0.19
202504,5030000,3S2,21,15,6,1.4
202504,5030000,3S3,802,183,619,4.38
202504,5030000,CA,8,145,-137,0.06
202504,5030000,V2,1,0,1,NA
202504,5030000,V3,200,3,197,66.67
202504,5030011,3S3,5,0,5,NA
202504,5031000,2,14,71,-57,0.2
202504,5031000,2S2,0,14,-14,0
202504,5031000,3,27,23,4,1.17
202504,5031000,3S2,4,7,-3,0.57
202504,5031000,3S3,2,0,2,NA
202504,5031000,4,1,0,1,NA
202504,5031000,CA,0,38,-38,0
202504,5031000,V3,170,3,167,56.67
202504,5031000,V4,19,0,19,NA
202504,5034000,2,12,175,-163,0.07
202504,5034000,3,1,22,-21,0.05
202504,5034000,3S2,1,4,-3,0.25
202504,5034000,3S3,14,47,-33,0.3
202504,5034000,4,0,1,-1,0
202504,5034000,CA,2,62,-60,0.03
202504,5034000,V2,0,3,-3,0
202504,5034001,2,7,0,7,NA
202504,5034005,3S3,0,1,-1,0
202504,5034005,CA,0,1,-1,0
202504,5034006,2,4,1,3,4
202504,5034014,V2,0,1,-1,0
202504,5036000,2,15,14,1,1.07
202504,5036000,3,1,2,-1,0.5
202504,5036000,3S2,0,1,-1,0
202504,5036000,CA,0,4,-4,0
202504,5036000,V2,0,1,-1,0
202504,5036000,V3,48,0,48,NA
202504,5038000,2,6,26,-20,0.23
202504,5038000,3,2,26,-24,0.08
202504,5038000,3S3,0,4,-4,0
202504,5038000,CA,1,26,-25,0.04
202504,5038000,V3,0,1,-1,0
202504,5038008,2,2,10,-8,0.2
202504,5038008,3,0,1,-1,0
202504,5038008,3S3,2,9,-7,0.22
202504,5038008,V2,0,1,-1,0
202504,5040000,2,3,72,-69,0.04
202504,5040000,3,1,4,-3,0.25
202504,5040000,3S2,3,1,2,3
202504,5040000,3S3,1,1,0,1
202504,5040000,CA,2,30,-28,0.07
202504,5040004,2,1,12,-11,0.08
202504,5040004,3,0,1,-1,0
202504,5040004,3S3,0,2,-2,0
202504,5040004,CA,0,1,-1,0
202504,5042000,2,46,310,-264,0.15
202504,5042000,2S2,0,1,-1,0
202504,5042000,3,5,69,-64,0.07
202504,5042000,3S1,1,0,1,NA
202504,5042000,3S2,2,18,-16,0.11
202504,5042000,3S3,4,80,-76,0.05
202504,5042000,3S4,0,1,-1,0
202504,5042000,CA,9,103,-94,0.09
202504,5042000,V3,0,6,-6,0
202504,5042001,2,0,5,-5,0
202504,5044000,2,3,18,-15,0.17
202504,5044000,3,0,6,-6,0
202504,5044000,3S2,1,0,1,NA
202504,5044000,CA,2,9,-7,0.22
202504,5044000,V3,0,1,-1,0
202504,5044001,2,0,1,-1,0
202504,5045000,2,388,1562,-1174,0.25
202504,5045000,2R2,0,28,-28,0
202504,5045000,2S2,7,65,-58,0.11
202504,5045000,2S3,3,19,-16,0.16
202504,5045000,3,33,130,-97,0.25
202504,5045000,3S2,71,98,-27,0.72
202504,5045000,3S3,707,787,-80,0.9
202504,5045000,3S4,5,2,3,2.5
202504,5045000,4,0,1,-1,0
202504,5045000,CA,147,366,-219,0.4
202504,5045003,3S3,11,0,11,NA
202504,5045009,2,0,2,-2,0
202504,5045009,3S3,0,1,-1,0
202504,5051000,2,16,129,-113,0.12
202504,5051000,2R2,0,1,-1,0
202504,5051000,3,3,11,-8,0.27
202504,5051000,3S2,2,3,-1,0.67
202504,5051000,3S3,2,24,-22,0.08
202504,5051000,CA,2,48,-46,0.04
202504,5055000,2,3,12,-9,0.25
202504,5055000,3,0,5,-5,0
202504,5055000,CA,0,4,-4,0
202504,5055000,V2,0,4,-4,0
202504,5059000,2,10,104,-94,0.1
202504,5059000,2S2,5,11,-6,0.45
202504,5059000,2S3,2,2,0,1
202504,5059000,3,0,4,-4,0
202504,5059000,3S2,0,2,-2,0
202504,5059000,3S3,1,6,-5,0.17
202504,5059000,CA,2,16,-14,0.12
202504,5059000,V2,0,1,-1,0
202504,5059002,4,0,1,-1,0
202504,5079000,2,1932,1017,915,1.9
202504,5079000,2B1,4,0,4,NA
202504,5079000,2R2,7,0,7,NA
202504,5079000,2S2,440,68,372,6.47
202504,5079000,2S3,33,38,-5,0.87
202504,5079000,3,216,78,138,2.77
202504,5079000,3S1,4,0,4,NA
202504,5079000,3S2,136,151,-15,0.9
202504,5079000,3S3,1092,787,305,1.39
202504,5079000,4,6,6,0,1
202504,5079000,CA,120,450,-330,0.27
202504,5079001,2,24,7,17,3.43
202504,5079001,2S2,4,0,4,NA
202504,5079001,2S3,3,0,3,NA
202504,5079001,3S3,18,3,15,6
202504,5079001,CA,4,2,2,2
202504,5086000,2,2,50,-48,0.04
202504,5086000,2S2,0,4,-4,0
202504,5086000,3,0,28,-28,0
202504,5086000,CA,0,20,-20,0
202504,5086000,V3,0,9,-9,0
202504,5088000,2,2353,3420,-1067,0.69
202504,5088000,2R3,0,1,-1,0
202504,5088000,2S2,81,180,-99,0.45
202504,5088000,2S3,45,134,-89,0.34
202504,5088000,3,199,217,-18,0.92
202504,5088000,3S2,73,193,-120,0.38
202504,5088000,3S3,2148,2546,-398,0.84
202504,5088000,4,55,10,45,5.5
202504,5088000,CA,2359,1404,955,1.68
202504,5088000,V2,0,2,-2,0
202504,5088000,V3,412,72,340,5.72
202504,5088004,3S3,0,3,-3,0
202504,5088012,2,0,3,-3,0
202504,5088012,2S2,0,3,-3,0
202504,5088013,2,58,8,50,7.25
202504,5088013,3,17,2,15,8.5
202504,5088013,3S2,0,1,-1,0
202504,5088013,3S3,1,0,1,NA
202504,5088013,4,40,0,40,NA
202504,5088013,CA,0,1,-1,0
202504,5088018,V3,0,138,-138,0
202504,5091000,2,7,7,0,1
202504,5091000,3,0,1,-1,0
202504,5091000,3S3,0,9,-9,0
202504,5091000,CA,0,8,-8,0
202504,5093000,2,3,14,-11,0.21
202504,5093000,3,0,6,-6,0
202504,5093000,3S2,0,1,-1,0
202504,5093000,3S3,0,4,-4,0
202504,5093000,CA,0,9,-9,0
202504,5093000,V3,0,1,-1,0
202504,5093001,2,5,1,4,5
202504,5093001,3,0,3,-3,0
202504,5093001,CA,0,1,-1,0
202504,5101000,2,97,145,-48,0.67
202504,5101000,2S2,1,0,1,NA
202504,5101000,3,0,3,-3,0
202504,5101000,3S2,0,2,-2,0
202504,5101000,3S3,7,39,-32,0.18
202504,5101000,CA,69,49,20,1.41
202504,5107000,2,1,13,-12,0.08
202504,5107000,3,0,5,-5,0
202504,5107000,3S1,0,1,-1,0
202504,5107000,3S2,0,4,-4,0
202504,5107000,3S3,0,2,-2,0
202504,5107000,3S4,0,1,-1,0
202504,5107000,CA,0,11,-11,0
202504,5107000,V3,0,1,-1,0
202504,5113000,2,8,74,-66,0.11
202504,5113000,3,1,30,-29,0.03
202504,5113000,3S2,2,73,-71,0.03
202504,5113000,3S3,60,23,37,2.61
202504,5113000,3S4,0,1,-1,0
202504,5113000,CA,1,14,-13,0.07
202504,5113000,V3,0,1,-1,0
202504,5120000,2,11,8,3,1.38
202504,5120000,3S2,3,6,-3,0.5
202504,5120000,3S3,0,16,-16,0
202504,5120000,CA,0,6,-6,0
202504,5120002,2,0,1,-1,0
202504,5120002,3S2,0,2,-2,0
202504,5120003,3S2,1,0,1,NA
202504,5120004,2,2,79,-77,0.03
202504,5120004,2S2,1,0,1,NA
202504,5120004,2S3,1,0,1,NA
202504,5120004,3S3,0,1,-1,0
202504,5120004,CA,1,58,-57,0.02
202504,5125000,2,3,5,-2,0.6
202504,5125000,3,1,2,-1,0.5
202504,5125000,CA,0,22,-22,0
202504,5129000,2,2219,2026,193,1.1
202504,5129000,2R2,0,1,-1,0
202504,5129000,2S1,0,1,-1,0
202504,5129000,2S2,175,210,-35,0.83
202504,5129000,2S3,86,113,-27,0.76
202504,5129000,3,77,154,-77,0.5
202504,5129000,3S2,144,120,24,1.2
202504,5129000,3S3,575,379,196,1.52
202504,5129000,3S4,0,2,-2,0
202504,5129000,4,4,2,2,2
202504,5129000,CA,1551,437,1114,3.55
202504,5129000,V2,36,0,36,NA
202504,5129000,V3,27,22,5,1.23
202504,5129005,2,3,3,0,1
202504,5129005,2S2,0,1,-1,0
202504,5129005,3,1,0,1,NA
202504,5129005,3S2,4,12,-8,0.33
202504,5129005,3S3,0,1,-1,0
202504,5129005,CA,0,1,-1,0
202504,5134000,2,2,39,-37,0.05
202504,5134000,3,1,2,-1,0.5
202504,5134000,CA,0,13,-13,0
202504,5134000,V3,0,2,-2,0
202504,5138000,2,21,53,-32,0.4
202504,5138000,3,2,13,-11,0.15
202504,5138000,3S2,3,19,-16,0.16
202504,5138000,3S3,7,35,-28,0.2
202504,5138000,3S4,4,3,1,1.33
202504,5138000,CA,0,7,-7,0
202504,5138000,V3,0,1,-1,0
202504,5138003,2,0,1,-1,0
202504,5142000,2,0,16,-16,0
202504,5142000,3,2,1,1,2
202504,5142000,3S3,0,1,-1,0
202504,5142000,CA,0,13,-13,0
202504,5142003,2,0,1,-1,0
202504,5142003,3S3,0,1,-1,0
202504,5142003,CA,0,2,-2,0
202504,5142006,2,1,64,-63,0.02
202504,5142006,3,0,1,-1,0
202504,5142006,3S3,1,6,-5,0.17
202504,5145000,2,24,20,4,1.2
202504,5145000,3,0,5,-5,0
202504,5145000,CA,1,23,-22,0.04
202504,5147000,2,62,253,-191,0.25
202504,5147000,2R2,6,9,-3,0.67
202504,5147000,2S2,3,3,0,1
202504,5147000,2S3,8,86,-78,0.09
202504,5147000,3,6,22,-16,0.27
202504,5147000,3S2,14,10,4,1.4
202504,5147000,3S3,79,459,-380,0.17
202504,5147000,4,0,1,-1,0
202504,5147000,CA,79,76,3,1.04
202504,5147004,2,1,0,1,NA
202504,5147004,2S3,8,0,8,NA
202504,5147004,3S2,1,1,0,1
202504,5147004,3S3,49,0,49,NA
202504,5147004,CA,1,0,1,NA
202504,5148000,2,963,761,202,1.27
202504,5148000,2R2,0,4,-4,0
202504,5148000,2S2,83,47,36,1.77
202504,5148000,2S3,7,12,-5,0.58
202504,5148000,3,22,30,-8,0.73
202504,5148000,3S2,79,19,60,4.16
202504,5148000,3S3,44,121,-77,0.36
202504,5148000,CA,7,340,-333,0.02
202504,5148003,2,0,1,-1,0
202504,5148005,2,0,2,-2,0
202504,5148005,2S3,0,2,-2,0
202504,5148009,2,0,1,-1,0
202504,5150000,2,40,50,-10,0.8
202504,5150000,3,0,12,-12,0
202504,5150000,3S3,1,0,1,NA
202504,5150000,CA,0,5,-5,0
202504,5150000,V3,0,7,-7,0
202504,5154000,2,111,1004,-893,0.11
202504,5154000,2R2,0,20,-20,0
202504,5154000,2S2,5,16,-11,0.31
202504,5154000,2S3,0,20,-20,0
202504,5154000,3,10,98,-88,0.1
202504,5154000,3S2,19,43,-24,0.44
202504,5154000,3S3,123,641,-518,0.19
202504,5154000,3S4,0,2,-2,0
202504,5154000,4,0,2,-2,0
202504,5154000,CA,21,219,-198,0.1
202504,5154007,2,0,16,-16,0
202504,5154015,3,0,1,-1,0
202504,5154023,3,0,1,-1,0
202504,5154023,3S2,1,5,-4,0.2
202504,5154023,3S3,0,1,-1,0
202504,5172000,2,232,298,-66,0.78
202504,5172000,2R2,0,17,-17,0
202504,5172000,2S2,3,5,-2,0.6
202504,5172000,2S3,87,1,86,87
202504,5172000,3,2,46,-44,0.04
202504,5172000,3S2,5,4,1,1.25
202504,5172000,3S3,143,186,-43,0.77
202504,5172000,3S4,1,0,1,NA
202504,5172000,4,0,1,-1,0
202504,5172000,CA,5,85,-80,0.06
202504,5172003,2,0,2,-2,0
202504,5190000,2,4,44,-40,0.09
202504,5190000,3,0,8,-8,0
202504,5190000,3S2,1,0,1,NA
202504,5190000,3S3,3,15,-12,0.2
202504,5190000,3S4,1,0,1,NA
202504,5190000,4,0,1,-1,0
202504,5190000,CA,3,44,-41,0.07
202504,5197000,2,9,41,-32,0.22
202504,5197000,2S2,0,3,-3,0
202504,5197000,3,0,1,-1,0
202504,5197000,3S3,0,5,-5,0
202504,5197000,CA,1,23,-22,0.04
202504,5206000,2,9,38,-29,0.24
202504,5206000,3,1,10,-9,0.1
202504,5206000,CA,0,2,-2,0
202504,5209000,2,15,20,-5,0.75
202504,5209000,3,2,6,-4,0.33
202504,5209000,3S3,2,11,-9,0.18
202504,5209000,CA,0,20,-20,0
202504,5209000,V3,0,1,-1,0
202504,5209004,V3,0,2,-2,0
202504,5212000,2,1429,1238,191,1.15
202504,5212000,2S2,605,263,342,2.3
202504,5212000,2S3,77,44,33,1.75
202504,5212000,3,23,96,-73,0.24
202504,5212000,3S2,241,146,95,1.65
202504,5212000,3S3,432,376,56,1.15
202504,5212000,3S4,0,1,-1,0
202504,5212000,4,1,17,-16,0.06
202504,5212000,CA,696,566,130,1.23
202504,5212000,V2,0,5,-5,0
202504,5212000,V3,0,1,-1,0
202504,5212009,2,0,1,-1,0
202504,5234000,2,1,42,-41,0.02
202504,5234000,3,1,5,-4,0.2
202504,5234000,3S2,1,0,1,NA
202504,5234000,3S3,0,75,-75,0
202504,5234000,3S4,0,1,-1,0
202504,5234000,CA,1,20,-19,0.05
202504,5234000,V3,0,5,-5,0
202504,5234009,2,0,8,-8,0
202504,5234009,3S2,0,3,-3,0
202504,5234009,CA,0,2,-2,0
202504,5234010,3,0,1,-1,0
202504,5234010,V3,0,1,-1,0
202504,5237000,2,210,274,-64,0.77
202504,5237000,2S3,1,4,-3,0.25
202504,5237000,3,3,151,-148,0.02
202504,5237000,3S2,1,3,-2,0.33
202504,5237000,3S3,8,158,-150,0.05
202504,5237000,CA,1,48,-47,0.02
202504,5237000,V2,0,2,-2,0
202504,5237000,V3,0,65,-65,0
202504,5237001,2,0,1,-1,0
202504,5237001,V2,0,2,-2,0
202504,5240000,2,1,12,-11,0.08
202504,5240000,3,1,0,1,NA
202504,5240000,CA,0,9,-9,0
202504,5240003,2,0,9,-9,0
202504,5240003,3,0,4,-4,0
202504,5240003,V3,0,1,-1,0
202504,5240007,2,0,1,-1,0
202504,5240007,CA,1,1,0,1
202504,5250000,2,22,229,-207,0.1
202504,5250000,2S2,0,6,-6,0
202504,5250000,3,0,31,-31,0
202504,5250000,3S2,7,14,-7,0.5
202504,5250000,3S3,4,110,-106,0.04
202504,5250000,CA,2,47,-45,0.04
202504,5250000,V3,0,1,-1,0
202504,5250002,3S2,1,1,0,1
202504,5250002,3S3,1,0,1,NA
202504,5250004,3,0,1,-1,0
202504,5250004,3S3,1,3,-2,0.33
202504,5264000,2,150,368,-218,0.41
202504,5264000,2S2,3,19,-16,0.16
202504,5264000,2S3,1,6,-5,0.17
202504,5264000,3,15,21,-6,0.71
202504,5264000,3S2,27,16,11,1.69
202504,5264000,3S3,39,149,-110,0.26
202504,5264000,CA,3,84,-81,0.04
202504,5264000,V2,0,1,-1,0
202504,5264000,V3,0,6,-6,0
202504,5266000,2,7569,3322,4247,2.28
202504,5266000,2R2,16,0,16,NA
202504,5266000,2R3,1,0,1,NA
202504,5266000,2S2,1334,401,933,3.33
202504,5266000,2S3,401,156,245,2.57
202504,5266000,3,78,156,-78,0.5
202504,5266000,3S2,247,283,-36,0.87
202504,5266000,3S3,473,1152,-679,0.41
202504,5266000,4,1,0,1,NA
202504,5266000,CA,1359,1707,-348,0.8
202504,5266001,2,11,169,-158,0.07
202504,5266001,3,4,2,2,2
202504,5266001,3S2,1,0,1,NA
202504,5266001,3S3,1,1,0,1
202504,5266001,CA,0,8,-8,0
202504,5282000,2,39,143,-104,0.27
202504,5282000,2S2,0,14,-14,0
202504,5282000,2S3,0,1,-1,0
202504,5282000,3,3,9,-6,0.33
202504,5282000,3S3,0,3,-3,0
202504,5282000,4,1,0,1,NA
202504,5282000,CA,0,47,-47,0
202504,5282004,2,0,2,-2,0
202504,5282004,3S2,5,0,5,NA
202504,5282005,CA,0,1,-1,0
202504,5284000,2,14,103,-89,0.14
202504,5284000,3,0,16,-16,0
202504,5284000,3S2,1,0,1,NA
202504,5284000,3S3,4,21,-17,0.19
202504,5284000,CA,1,40,-39,0.03
202504,5284000,V2,0,1,-1,0
202504,5284000,V3,0,2,-2,0
202504,5284006,2,0,2,-2,0
202504,5306000,2,5,18,-13,0.28
202504,5306000,2S2,1,0,1,NA
202504,5306000,3,0,1,-1,0
202504,5306000,3S3,0,7,-7,0
202504,5306000,3S4,1,1,0,1
202504,5306000,CA,0,4,-4,0
202504,5308000,2,7341,2801,4540,2.62
202504,5308000,2B1,5,2,3,2.5
202504,5308000,2R2,19,4,15,4.75
202504,5308000,2S2,244,841,-597,0.29
202504,5308000,2S3,68,164,-96,0.41
202504,5308000,3,503,145,358,3.47
202504,5308000,3S2,267,526,-259,0.51
202504,5308000,3S3,2101,2843,-742,0.74
202504,5308000,3S4,3,1,2,3
202504,5308000,4,36,10,26,3.6
202504,5308000,CA,2831,639,2192,4.43
202504,5308000,V2,5,10,-5,0.5
202504,5308000,V3,229,223,6,1.03
202504,5308000,V4,1,74,-73,0.01
202504,5310000,2,55,18,37,3.06
202504,5310000,3,0,6,-6,0
202504,5310000,3S2,0,4,-4,0
202504,5310000,3S3,0,9,-9,0
202504,5310000,CA,42,26,16,1.62
202504,5310000,V3,0,1,-1,0
202504,5310003,2,1282,379,903,3.38
202504,5310003,2B1,5,0,5,NA
202504,5310003,2S2,10,80,-70,0.12
202504,5310003,2S3,29,128,-99,0.23
202504,5310003,3,1,3,-2,0.33
202504,5310003,3S2,5,4,1,1.25
202504,5310003,3S3,23,72,-49,0.32
202504,5310003,CA,309,37,272,8.35
202504,5313000,2,5,22,-17,0.23
202504,5313000,2S2,0,20,-20,0
202504,5313000,3,0,1,-1,0
202504,5313000,CA,0,45,-45,0
202504,5315000,2,5,12,-7,0.42
202504,5315000,3,3,6,-3,0.5
202504,5315000,4,1,0,1,NA
202504,5315000,CA,0,8,-8,0
202504,5315000,V2,0,2,-2,0
202504,5318000,2,5861,2495,3366,2.35
202504,5318000,2R2,0,1,-1,0
202504,5318000,2S2,195,316,-121,0.62
202504,5318000,2S3,75,136,-61,0.55
202504,5318000,3,264,127,137,2.08
202504,5318000,3S2,119,196,-77,0.61
202504,5318000,3S3,1117,875,242,1.28
202504,5318000,4,4,0,4,NA
202504,5318000,CA,795,645,150,1.23
202504,5318000,V2,0,208,-208,0
202504,5318000,V3,0,156,-156,0
202504,5318000,V4,1,10,-9,0.1
202504,5318003,2,601,1,600,601
202504,5318003,2S2,142,0,142,NA
202504,5318003,2S3,28,0,28,NA
202504,5318003,3S2,7,0,7,NA
202504,5318003,3S3,223,0,223,NA
202504,5321000,2,6,114,-108,0.05
202504,5321000,2S2,0,26,-26,0
202504,5321000,3,0,4,-4,0
202504,5321000,3S2,0,2,-2,0
202504,5321000,3S3,0,1,-1,0
202504,5321000,CA,1,52,-51,0.02
202504,5321000,V2,0,4,-4,0
202504,5321000,V3,0,1,-1,0
202504,5347000,2,0,15,-15,0
202504,5347000,3,0,6,-6,0
202504,5347000,CA,0,7,-7,0
202504,5347003,2,0,4,-4,0
202504,5353000,2,2,55,-53,0.04
202504,5353000,2S2,3,3,0,1
202504,5353000,3,0,1,-1,0
202504,5353000,3S2,0,2,-2,0
202504,5353000,3S3,0,14,-14,0
202504,5353000,CA,0,12,-12,0
202504,5360000,2,13868,6625,7243,2.09
202504,5360000,2B1,1,3,-2,0.33
202504,5360000,2R2,2,7,-5,0.29
202504,5360000,2S1,15,1,14,15
202504,5360000,2S2,259,518,-259,0.5
202504,5360000,2S3,132,383,-251,0.34
202504,5360000,3,426,458,-32,0.93
202504,5360000,3S1,1,4,-3,0.25
202504,5360000,3S2,300,873,-573,0.34
202504,5360000,3S3,1951,4171,-2220,0.47
202504,5360000,3S4,1,1,0,1
202504,5360000,4,3,23,-20,0.13
202504,5360000,CA,5113,1972,3141,2.59
202504,5360001,2,0,1,-1,0
202504,5360001,2S2,1,3,-2,0.33
202504,5360001,2S3,1,1,0,1
202504,5360003,2,0,11,-11,0
202504,5360006,2,0,41,-41,0
202504,5360006,CA,0,26,-26,0
202504,5360010,2,2,3,-1,0.67
202504,5361000,2,10,63,-53,0.16
202504,5361000,2S2,5,16,-11,0.31
202504,5361000,2S3,0,2,-2,0
202504,5361000,3,0,12,-12,0
202504,5361000,3S2,1,1,0,1
202504,5361000,3S3,3,27,-24,0.11
202504,5361000,3S4,1,10,-9,0.1
202504,5361000,CA,1,30,-29,0.03
202504,5361000,V3,0,3,-3,0
202504,5361007,2,0,1,-1,0
202504,5364000,2,20,242,-222,0.08
202504,5364000,2S3,0,1,-1,0
202504,5364000,3,0,29,-29,0
202504,5364000,3S2,10,0,10,NA
202504,5364000,3S3,75,26,49,2.88
202504,5364000,CA,2,82,-80,0.02
202504,5368000,2,138,47,91,2.94
202504,5368000,2S2,0,28,-28,0
202504,5368000,3,0,5,-5,0
202504,5368000,3S3,15,4,11,3.75
202504,5368000,CA,0,36,-36,0
202504,5368007,3S3,0,1,-1,0
202504,5376000,2,1273,1371,-98,0.93
202504,5376000,2S2,107,18,89,5.94
202504,5376000,2S3,5,7,-2,0.71
202504,5376000,3,29,56,-27,0.52
202504,5376000,3S2,63,12,51,5.25
202504,5376000,3S3,55,323,-268,0.17
202504,5376000,CA,72,423,-351,0.17
202504,5376000,V2,1,8,-7,0.12
202504,5376003,2,0,3,-3,0
202504,5380000,2,9893,2677,7216,3.7
202504,5380000,2R2,38,0,38,NA
202504,5380000,2S2,388,340,48,1.14
202504,5380000,2S3,56,114,-58,0.49
202504,5380000,3,24,88,-64,0.27
202504,5380000,3S2,291,424,-133,0.69
202504,5380000,3S3,435,1077,-642,0.4
202504,5380000,3S4,1,0,1,NA
202504,5380000,4,2,3,-1,0.67
202504,5380000,CA,5504,890,4614,6.18
202504,5380000,V2,1,0,1,NA
202504,5380000,V3,13,52,-39,0.25
202504,5380001,2,23,61,-38,0.38
202504,5380001,2S2,1,8,-7,0.12
202504,5380001,2S3,0,3,-3,0
202504,5380001,3,0,1,-1,0
202504,5380001,3S2,1,0,1,NA
202504,5380001,3S3,3,2,1,1.5
202504,5380001,CA,6,1,5,6
202504,5380005,2,115,43,72,2.67
202504,5380005,2S2,3,5,-2,0.6
202504,5380005,2S3,8,6,2,1.33
202504,5380005,3,6,1,5,6
202504,5380005,3S2,1,2,-1,0.5
202504,5380005,3S3,35,20,15,1.75
202504,5380005,CA,0,3,-3,0
202504,5380010,3S3,0,10,-10,0
202504,5390000,2,61,59,2,1.03
202504,5390000,2S2,3,0,3,NA
202504,5390000,2S3,2,0,2,NA
202504,5390000,3,4,10,-6,0.4
202504,5390000,3S2,3,2,1,1.5
202504,5390000,3S3,2,17,-15,0.12
202504,5390000,CA,3,31,-28,0.1
202504,5400000,2,181,307,-126,0.59
202504,5400000,2S2,1,0,1,NA
202504,5400000,2S3,0,4,-4,0
202504,5400000,3,69,19,50,3.63
202504,5400000,3S2,25,5,20,5
202504,5400000,3S3,133,98,35,1.36
202504,5400000,4,3,0,3,NA
202504,5400000,CA,5,249,-244,0.02
202504,5400000,V2,0,4,-4,0
202504,5400000,V3,225,21,204,10.71
202504,5400000,V4,22,0,22,NA
202504,5400001,2,0,2,-2,0
202504,5400001,3,0,1,-1,0
202504,5400002,2,0,17,-17,0
202504,5400002,V2,0,3,-3,0
202504,5411000,2,0,22,-22,0
202504,5411000,3,1,5,-4,0.2
202504,5411000,CA,0,16,-16,0
202504,5411001,2,5,6,-1,0.83
202504,5411007,2,1,0,1,NA
202504,5411007,2S2,1,0,1,NA
202504,5411007,3,2,0,2,NA
202504,5411007,3S2,1,0,1,NA
202504,5411007,3S3,0,1,-1,0
202504,5411007,CA,1,0,1,NA
202504,5411008,2,0,3,-3,0
202504,5411008,3S3,2,0,2,NA
202504,5425000,2,36,58,-22,0.62
202504,5425000,2S2,1,0,1,NA
202504,5425000,2S3,1,0,1,NA
202504,5425000,3,0,53,-53,0
202504,5425000,3S2,0,8,-8,0
202504,5425000,3S3,6,3,3,2
202504,5425000,3S4,3,0,3,NA
202504,5425000,4,0,30,-30,0
202504,5425000,CA,2,16,-14,0.12
202504,5425000,V3,0,16,-16,0
202504,5425001,2,0,2,-2,0
202504,5425003,2,1,0,1,NA
202504,5425005,2,4,5,-1,0.8
202504,5425005,3S2,3,0,3,NA
202504,5425005,3S3,81,1,80,81
202504,5440000,2,1741,1057,684,1.65
202504,5440000,2R2,0,18,-18,0
202504,5440000,2S2,3,15,-12,0.2
202504,5440000,2S3,5,16,-11,0.31
202504,5440000,3,65,51,14,1.27
202504,5440000,3S2,26,41,-15,0.63
202504,5440000,3S3,68,585,-517,0.12
202504,5440000,3S3S2,1,0,1,NA
202504,5440000,3S4,0,1,-1,0
202504,5440000,4,0,12,-12,0
202504,5440000,CA,110,407,-297,0.27
202504,5440000,V2,47,0,47,NA
202504,5440000,V3,1,36,-35,0.03
202504,5440001,CA,0,1,-1,0
202504,5467000,2,5,7,-2,0.71
202504,5467000,2S2,0,6,-6,0
202504,5467000,3,0,6,-6,0
202504,5467000,CA,0,14,-14,0
202504,5475000,2,0,1,-1,0
202504,5480000,2,16,61,-45,0.26
202504,5480000,3,4,9,-5,0.44
202504,5480000,3S2,3,4,-1,0.75
202504,5480000,3S3,1,48,-47,0.02
202504,5480000,3S4,0,1,-1,0
202504,5480000,CA,1,17,-16,0.06
202504,5480004,2,0,4,-4,0
202504,5480004,3,0,3,-3,0
202504,5480004,3S2,0,1,-1,0
202504,5480004,3S3,0,1,-1,0
202504,5480006,2,0,4,-4,0
202504,5480006,3,0,7,-7,0
202504,5480006,3S3,0,2,-2,0
202504,5483000,2,3,20,-17,0.15
202504,5483000,3,3,2,1,1.5
202504,5483000,3S3,0,1,-1,0
202504,5483000,CA,0,6,-6,0
202504,5483000,V2,0,6,-6,0
202504,5483001,3,0,1,-1,0
202504,5483012,2,0,1,-1,0
202504,5483012,3,0,4,-4,0
202504,5490000,2,56,213,-157,0.26
202504,5490000,2R2,0,1,-1,0
202504,5490000,2S3,0,2,-2,0
202504,5490000,3,3,11,-8,0.27
202504,5490000,3S2,2,0,2,NA
202504,5490000,3S3,1,16,-15,0.06
202504,5490000,4,0,1,-1,0
202504,5490000,CA,2,44,-42,0.05
202504,5490001,2,0,1,-1,0
202504,5490003,2,1,0,1,NA
202504,5490009,3S2,1,0,1,NA
202504,5495000,2,2,78,-76,0.03
202504,5495000,2S2,3,3,0,1
202504,5495000,2S3,1,0,1,NA
202504,5495000,3,0,13,-13,0
202504,5495000,3S2,3,7,-4,0.43
202504,5495000,3S3,3,19,-16,0.16
202504,5495000,CA,0,11,-11,0
202504,5501000,CA,0,1,-1,0
202504,5541000,2,17,55,-38,0.31
202504,5541000,2S2,0,26,-26,0
202504,5541000,3,0,4,-4,0
202504,5541000,CA,1,30,-29,0.03
202504,5541001,2,7,28,-21,0.25
202504,5541001,3,1,9,-8,0.11
202504,5541001,3S3,0,1,-1,0
202504,5541001,CA,1,7,-6,0.14
202504,5543000,2,0,5,-5,0
202504,5576000,2,3,7,-4,0.43
202504,5576000,3S2,1,0,1,NA
202504,5576000,CA,0,17,-17,0
202504,5576000,V3,0,1,-1,0
202504,5579000,2,90,310,-220,0.29
202504,5579000,2S2,1,0,1,NA
202504,5579000,2S3,0,1,-1,0
202504,5579000,3,16,114,-98,0.14
202504,5579000,3S2,14,16,-2,0.88
202504,5579000,3S3,132,121,11,1.09
202504,5579000,CA,131,102,29,1.28
202504,5579000,V3,0,6,-6,0
202504,5579002,2,1,0,1,NA
202504,5579005,2,0,1,-1,0
202504,5585000,2,8,88,-80,0.09
202504,5585000,3,2,1,1,2
202504,5585000,3S2,4,1,3,4
202504,5585000,3S3,125,9,116,13.89
202504,5585000,CA,3,20,-17,0.15
202504,5585000,V3,0,3,-3,0
202504,5585003,2,0,10,-10,0
202504,5585003,3S2,2,0,2,NA
202504,5585003,3S3,127,55,72,2.31
202504,5585003,CA,2,16,-14,0.12
202504,5585003,V3,0,2,-2,0
202504,5585004,2,110,27,83,4.07
202504,5585004,3,1,4,-3,0.25
202504,5585004,3S3,1,1,0,1
202504,5585004,CA,0,9,-9,0
202504,5591000,2,44,148,-104,0.3
202504,5591000,2S2,1,2,-1,0.5
202504,5591000,2S3,1,1,0,1
202504,5591000,3,24,22,2,1.09
202504,5591000,3S2,12,9,3,1.33
202504,5591000,3S3,399,98,301,4.07
202504,5591000,3S4,0,1,-1,0
202504,5591000,4,2,0,2,NA
202504,5591000,CA,6,52,-46,0.12
202504,5591000,V3,5,5,0,1
202504,5591000,V4,2,2,0,1
202504,5591002,2,0,12,-12,0
202504,5591002,3,0,4,-4,0
202504,5591002,CA,2,1,1,2
202504,5591002,V3,0,3,-3,0
202504,5591004,2,51,67,-16,0.76
202504,5591004,3,21,39,-18,0.54
202504,5591004,3S2,4,2,2,2
202504,5591004,3S3,184,93,91,1.98
202504,5591004,4,8,0,8,NA
202504,5591004,CA,16,54,-38,0.3
202504,5591004,V2,1,0,1,NA
202504,5591004,V3,0,4,-4,0
202504,5604000,2,6,75,-69,0.08
202504,5604000,2S2,0,9,-9,0
202504,5604000,3,0,87,-87,0
202504,5604000,3S2,1,7,-6,0.14
202504,5604000,3S3,1,21,-20,0.05
202504,5604000,CA,1,23,-22,0.04
202504,5604000,V2,1,1,0,1
202504,5604000,V3,0,8,-8,0
202504,5604001,3,0,1,-1,0
202504,5604001,3S2,0,2,-2,0
202504,5604005,3,0,8,-8,0
202504,5604005,3S2,0,14,-14,0
202504,5604005,V3,0,3,-3,0
202504,5604009,3,0,11,-11,0
202504,5604009,V3,0,4,-4,0
202504,5607000,2,118,475,-357,0.25
202504,5607000,2R2,0,13,-13,0
202504,5607000,2S2,6,2,4,3
202504,5607000,2S3,0,4,-4,0
202504,5607000,3,12,26,-14,0.46
202504,5607000,3S2,4,1,3,4
202504,5607000,3S3,2,55,-53,0.04
202504,5607000,CA,10,248,-238,0.04
202504,5607003,2,1,0,1,NA
202504,5607004,2,0,3,-3,0
202504,5607004,3,1,0,1,NA
202504,5607004,3S3,0,1,-1,0
202504,5607004,CA,0,1,-1,0
202504,5607007,2,0,1,-1,0
202504,5607008,2,1,1,0,1
202504,5607008,CA,0,6,-6,0
202504,5615000,2,6632,6401,231,1.04
202504,5615000,2B1,1,0,1,NA
202504,5615000,2R2,3,1,2,3
202504,5615000,2S2,663,592,71,1.12
202504,5615000,2S3,144,275,-131,0.52
202504,5615000,3,187,215,-28,0.87
202504,5615000,3S1,0,6,-6,0
202504,5615000,3S2,536,630,-94,0.85
202504,5615000,3S3,987,2568,-1581,0.38
202504,5615000,3S4,0,5,-5,0
202504,5615000,4,0,3,-3,0
202504,5615000,CA,2354,2515,-161,0.94
202504,5615000,V2,0,1,-1,0
202504,5615000,V3,0,8,-8,0
202504,5615001,3,1,1,0,1
202504,5615001,CA,0,1,-1,0
202504,5615003,2,1,0,1,NA
202504,5615003,3S3,0,27,-27,0
202504,5615010,2,10,45,-35,0.22
202504,5615010,3,1,4,-3,0.25
202504,5615010,3S3,0,3,-3,0
202504,5615010,CA,0,3,-3,0
202504,5615010,V2,0,4,-4,0
202504,5615011,2,0,2,-2,0
202504,5628000,2,1,20,-19,0.05
202504,5628000,3S3,0,3,-3,0
202504,5628000,CA,0,19,-19,0
202504,5628001,2,0,1,-1,0
202504,5631000,2,4304,2390,1914,1.8
202504,5631000,2B1,2,0,2,NA
202504,5631000,2R2,1,0,1,NA
202504,5631000,2S2,50,102,-52,0.49
202504,5631000,2S3,24,173,-149,0.14
202504,5631000,3,368,329,39,1.12
202504,5631000,3S1,0,1,-1,0
202504,5631000,3S2,205,379,-174,0.54
202504,5631000,3S3,528,842,-314,0.63
202504,5631000,3S4,2,1,1,2
202504,5631000,4,1,9,-8,0.11
202504,5631000,CA,2373,986,1387,2.41
202504,5631000,V2,0,26,-26,0
202504,5631000,V3,26,180,-154,0.14
202504,5631000,V4,0,9,-9,0
202504,5631002,2,0,2,-2,0
202504,5631008,2S2,0,2,-2,0
202504,5631008,3S3,1,17,-16,0.06
202504,5642000,2,7,33,-26,0.21
202504,5642000,2S2,0,1,-1,0
202504,5642000,3,0,5,-5,0
202504,5642000,3S2,2,0,2,NA
202504,5642000,3S3,29,10,19,2.9
202504,5642000,CA,0,15,-15,0
202504,5642000,V3,0,3,-3,0
202504,5647000,2,0,18,-18,0
202504,5647000,2S2,0,6,-6,0
202504,5647000,2S3,0,1,-1,0
202504,5647000,3,0,11,-11,0
202504,5647000,3S2,0,1,-1,0
202504,5647000,3S3,0,23,-23,0
202504,5647000,CA,0,2,-2,0
202504,5647000,V3,0,1,-1,0
202504,5649000,2,1,96,-95,0.01
202504,5649000,2S2,0,13,-13,0
202504,5649000,2S3,1,0,1,NA
202504,5649000,3,0,11,-11,0
202504,5649000,3S3,1,1,0,1
202504,5649000,CA,0,94,-94,0
202504,5649000,V3,0,6,-6,0
202504,5649001,2,0,12,-12,0
202504,5649001,CA,0,18,-18,0
202504,5649012,2,0,2,-2,0
202504,5652000,2,1,2,-1,0.5
202504,5652000,3,0,2,-2,0
202504,5652000,3S2,7,0,7,NA
202504,5652000,3S3,170,122,48,1.39
202504,5652000,CA,0,4,-4,0
202504,5652000,V3,0,5,-5,0
202504,5652010,2,4,2,2,2
202504,5652010,2S2,2,1,1,2
202504,5652010,2S3,32,31,1,1.03
202504,5652010,3,2,0,2,NA
202504,5652010,3S2,2,0,2,NA
202504,5652010,3S3,328,110,218,2.98
202504,5652010,CA,2,0,2,NA
202504,5652010,V3,4,0,4,NA
202504,5656000,2,13,118,-105,0.11
202504,5656000,3,0,11,-11,0
202504,5656000,3S3,0,5,-5,0
202504,5656000,CA,1,48,-47,0.02
202504,5658000,2,2,26,-24,0.08
202504,5658000,3,0,5,-5,0
202504,5658000,3S2,1,0,1,NA
202504,5658000,3S3,0,23,-23,0
202504,5658000,CA,0,3,-3,0
202504,5659000,2,25,55,-30,0.45
202504,5659000,2S2,2,2,0,1
202504,5659000,3,0,10,-10,0
202504,5659000,3S2,54,0,54,NA
202504,5659000,3S3,12,12,0,1
202504,5659000,CA,0,13,-13,0
202504,5660000,2,7,38,-31,0.18
202504,5660000,2S2,0,12,-12,0
202504,5660000,3,0,9,-9,0
202504,5660000,3S2,3,3,0,1
202504,5660000,3S3,0,1,-1,0
202504,5660000,CA,5,63,-58,0.08
202504,5660000,V3,0,3,-3,0
202504,5660012,2,1,26,-25,0.04
202504,5660012,2S2,5,5,0,1
202504,5660012,3S3,5,0,5,NA
202504,5660013,2,0,3,-3,0
202504,5660013,CA,0,6,-6,0
202504,5664000,2,130,660,-530,0.2
202504,5664000,2S2,1,6,-5,0.17
202504,5664000,2S3,0,4,-4,0
202504,5664000,3,47,53,-6,0.89
202504,5664000,3S2,170,71,99,2.39
202504,5664000,3S3,401,483,-82,0.83
202504,5664000,CA,0,93,-93,0
202504,5664003,2,0,1,-1,0
202504,5664005,2,11,8,3,1.38
202504,5664005,3S3,0,17,-17,0
202504,5664005,CA,0,1,-1,0
202504,5665000,2,9,153,-144,0.06
202504,5665000,2R2,0,1,-1,0
202504,5665000,2S2,0,1,-1,0
202504,5665000,3,1,23,-22,0.04
202504,5665000,3S2,1,1,0,1
202504,5665000,CA,2,42,-40,0.05
202504,5667000,2,1,70,-69,0.01
202504,5667000,2S2,0,13,-13,0
202504,5667000,3S2,1,0,1,NA
202504,5667000,CA,1,17,-16,0.06
202504,5667000,V2,0,6,-6,0
202504,5670000,2,7,40,-33,0.17
202504,5670000,2S2,0,1,-1,0
202504,5670000,3,0,1,-1,0
202504,5670000,3S3,45,13,32,3.46
202504,5670000,CA,0,29,-29,0
202504,5670000,V3,6,0,6,NA
202504,5670003,2,87,1,86,87
202504,5670003,3S3,5,2,3,2.5
202504,5674000,2,8,114,-106,0.07
202504,5674000,2S2,0,3,-3,0
202504,5674000,2S3,0,2,-2,0
202504,5674000,3,3,12,-9,0.25
202504,5674000,3S3,0,2,-2,0
202504,5674000,CA,1,45,-44,0.02
202504,5679000,2,9,31,-22,0.29
202504,5679000,2S2,1,0,1,NA
202504,5679000,2S3,2,0,2,NA
202504,5679000,3,1,5,-4,0.2
202504,5679000,3S2,7,0,7,NA
202504,5679000,3S3,2,1,1,2
202504,5679000,3S4,1,0,1,NA
202504,5679000,CA,1,40,-39,0.03
202504,5679000,V2,0,2,-2,0
202504,5679000,V3,0,1,-1,0
202504,5679004,2,1,1,0,1
202504,5686000,2,470,784,-314,0.6
202504,5686000,2S2,1,2,-1,0.5
202504,5686000,2S3,0,6,-6,0
202504,5686000,3,15,119,-104,0.13
202504,5686000,3S2,100,16,84,6.25
202504,5686000,3S3,369,537,-168,0.69
202504,5686000,CA,5,112,-107,0.04
202504,5686000,V2,0,2,-2,0
202504,5686000,V3,0,66,-66,0
202504,5686001,2,0,19,-19,0
202504,5686001,3,0,3,-3,0
202504,5686001,CA,0,1,-1,0
202504,5686004,3,0,3,-3,0
202504,5686006,2,1,1,0,1
202504,5686011,2,0,6,-6,0
202504,5686011,2R2,0,11,-11,0
202504,5686011,3,0,3,-3,0
202504,5686011,3S3,10,3,7,3.33
202504,5686011,CA,0,1,-1,0
202504,5690000,2,239,90,149,2.66
202504,5690000,2S2,0,3,-3,0
202504,5690000,3,6,16,-10,0.38
202504,5690000,3S2,1,0,1,NA
202504,5690000,3S3,33,8,25,4.12
202504,5690000,CA,2,14,-12,0.14
202504,5690000,V3,0,1,-1,0
202504,5690001,2,20,23,-3,0.87
202504,5690003,2,0,2,-2,0
202504,5690003,3,1,0,1,NA
202504,5690004,2,0,15,-15,0
202504,5690004,CA,0,2,-2,0
202504,5690005,2,0,1,-1,0
202504,5690010,2,2,11,-9,0.18
202504,5690010,3,0,2,-2,0
202504,5697000,2,45,457,-412,0.1
202504,5697000,2S2,0,1,-1,0
202504,5697000,2S3,0,1,-1,0
202504,5697000,3,10,33,-23,0.3
202504,5697000,3S2,7,1,6,7
202504,5697000,3S3,45,118,-73,0.38
202504,5697000,3S4,1,0,1,NA
202504,5697000,4,1,0,1,NA
202504,5697000,CA,5,298,-293,0.02
202504,5697000,V3,0,3,-3,0
202504,5736000,2,12,459,-447,0.03
202504,5736000,2S2,0,2,-2,0
202504,5736000,3,5,77,-72,0.06
202504,5736000,3S2,5,7,-2,0.71
202504,5736000,3S3,14,19,-5,0.74
202504,5736000,4,0,3,-3,0
202504,5736000,CA,1,126,-125,0.01
202504,5736000,V3,0,16,-16,0
202504,5736002,3,0,1,-1,0
202504,5736002,3S2,0,1,-1,0
202504,5756000,2,18,225,-207,0.08
202504,5756000,2S2,0,8,-8,0
202504,5756000,2S3,0,7,-7,0
202504,5756000,3,78,18,60,4.33
202504,5756000,3S2,59,3,56,19.67
202504,5756000,3S3,619,87,532,7.11
202504,5756000,CA,2,112,-110,0.02
202504,5756000,V2,0,3,-3,0
202504,5756000,V3,36,6,30,6
202504,5756005,2,0,1,-1,0
202504,5756005,CA,1,7,-6,0.14
202504,5756030,2,3,6,-3,0.5
202504,5756030,3,2,2,0,1
202504,5756030,3S2,1,1,0,1
202504,5756030,3S3,1,0,1,NA
202504,5756030,CA,0,1,-1,0
202504,5756030,V3,0,1,-1,0
202504,5756033,2,121,5,116,24.2
202504,5756033,2S2,2,2,0,1
202504,5756033,3,388,2,386,194
202504,5756033,3S2,894,36,858,24.83
202504,5756033,3S3,3815,1147,2668,3.33
202504,5756033,V3,125,9,116,13.89
202504,5761000,2,7,52,-45,0.13
202504,5761000,3,2,3,-1,0.67
202504,5761000,3S3,0,17,-17,0
202504,5761000,CA,1,34,-33,0.03
202504,5761002,2,6,0,6,NA
202504,5761002,2S2,5,0,5,NA
202504,5761002,2S3,7,4,3,1.75
202504,5789000,2,114,116,-2,0.98
202504,5789000,2S2,7,28,-21,0.25
202504,5789000,3,2,3,-1,0.67
202504,5789000,3S2,4,0,4,NA
202504,5789000,3S3,1,1,0,1
202504,5789000,CA,3,47,-44,0.06
202504,5789001,2,0,3,-3,0
202504,5789001,3,0,2,-2,0
202504,5789001,CA,0,3,-3,0
202504,5789001,V3,0,2,-2,0
202504,5789005,CA,0,1,-1,0
202504,5790000,2,11,68,-57,0.16
202504,5790000,2R2,0,11,-11,0
202504,5790000,2S2,0,1,-1,0
202504,5790000,3,5,9,-4,0.56
202504,5790000,3S2,2,7,-5,0.29
202504,5790000,3S3,8,9,-1,0.89
202504,5790000,3S4,9,0,9,NA
202504,5790000,4,0,1,-1,0
202504,5790000,CA,4,22,-18,0.18
202504,5790003,2,0,1,-1,0
202504,5790003,2S2,5,0,5,NA
202504,5790003,3S2,1,0,1,NA
202504,5790004,3,0,1,-1,0
202504,5790004,3S2,0,1,-1,0
202504,5792000,2,1,15,-14,0.07
202504,5792000,2S2,0,1,-1,0
202504,5792000,3S2,0,2,-2,0
202504,5792000,3S3,0,5,-5,0
202504,5792000,CA,0,20,-20,0
202504,5809000,2,89,24,65,3.71
202504,5809000,2S2,0,9,-9,0
202504,5809000,3,0,24,-24,0
202504,5809000,3S2,1,0,1,NA
202504,5809000,3S3,160,0,160,NA
202504,5809000,CA,0,17,-17,0
202504,5809001,3S3,3,0,3,NA
202504,5809002,3S3,12,0,12,NA
202504,5809016,2,0,1,-1,0
202504,5819000,2,6,23,-17,0.26
202504,5819000,2S3,0,3,-3,0
202504,5819000,3,0,17,-17,0
202504,5819000,3S2,1,49,-48,0.02
202504,5819000,3S3,0,32,-32,0
202504,5819000,CA,0,9,-9,0
202504,5819000,V3,0,2,-2,0
202504,5819002,3,0,1,-1,0
202504,5819002,3S2,0,7,-7,0
202504,5819002,3S3,0,2,-2,0
202504,5837000,2,61,646,-585,0.09
202504,5837000,2R2,0,3,-3,0
202504,5837000,2S2,14,23,-9,0.61
202504,5837000,2S3,1,2,-1,0.5
202504,5837000,3,6,56,-50,0.11
202504,5837000,3S2,57,17,40,3.35
202504,5837000,3S3,90,665,-575,0.14
202504,5837000,4,0,7,-7,0
202504,5837000,CA,2,167,-165,0.01
202504,5837001,2,3,10,-7,0.3
202504,5837001,3,0,1,-1,0
202504,5837001,3S2,11,0,11,NA
202504,5837001,3S3,1,0,1,NA
202504,5837001,CA,0,6,-6,0
202504,5837002,2,1,5,-4,0.2
202504,5837002,3,0,6,-6,0
202504,5837002,3S2,0,110,-110,0
202504,5837002,3S3,0,133,-133,0
202504,5837014,3S3,0,1,-1,0
202504,5842000,2,3,33,-30,0.09
202504,5842000,3,0,1,-1,0
202504,5842000,3S2,0,1,-1,0
202504,5842000,3S3,0,2,-2,0
202504,5842000,CA,1,26,-25,0.04
202504,5842000,V2,0,3,-3,0
202504,5847000,2,91,148,-57,0.61
202504,5847000,3,15,9,6,1.67
202504,5847000,3S2,0,2,-2,0
202504,5847000,3S3,1,29,-28,0.03
202504,5847000,CA,1,90,-89,0.01
202504,5847000,V3,0,3,-3,0
202504,5854000,2,1,21,-20,0.05
202504,5854000,3,0,1,-1,0
202504,5854000,3S2,2,1,1,2
202504,5854000,3S3,0,45,-45,0
202504,5854000,CA,0,6,-6,0
202504,5854002,2,0,18,-18,0
202504,5854002,3,0,1,-1,0
202504,5854002,3S2,1,1,0,1
202504,5854002,3S3,0,4,-4,0
202504,5854002,CA,0,22,-22,0
202504,5856000,2,7,28,-21,0.25
202504,5856000,2S2,0,2,-2,0
202504,5856000,3,14,9,5,1.56
202504,5856000,3S2,1,1,0,1
202504,5856000,CA,0,13,-13,0
202504,5856000,V2,0,2,-2,0
202504,5856000,V3,40,1,39,40
202504,5856000,V4,19,0,19,NA
202504,5858000,2,23,73,-50,0.32
202504,5858000,2S2,1,0,1,NA
202504,5858000,2S3,1,0,1,NA
202504,5858000,3,4,12,-8,0.33
202504,5858000,3S2,23,39,-16,0.59
202504,5858000,3S3,15,38,-23,0.39
202504,5858000,3S4,2,0,2,NA
202504,5858000,CA,1,28,-27,0.04
202504,5861000,2,0,32,-32,0
202504,5861000,2S2,0,8,-8,0
202504,5861000,3,1,8,-7,0.12
202504,5861000,3S3,0,4,-4,0
202504,5861000,CA,0,43,-43,0
202504,5861000,V3,0,1,-1,0
202504,5861002,2,5,6,-1,0.83
202504,5861002,3,3,2,1,1.5
202504,5861002,3S2,0,5,-5,0
202504,5861002,3S3,27,20,7,1.35
202504,5861002,3S4,1,1,0,1
202504,5861002,4,25,0,25,NA
202504,5861002,CA,2,13,-11,0.15
202504,5873006,3S3,0,2,-2,0
202504,5885000,2,47,12,35,3.92
202504,5885000,3,4,6,-2,0.67
202504,5885000,3S3,42,0,42,NA
202504,5885000,CA,0,1,-1,0
202504,5885000,V3,0,6,-6,0
202504,5887000,2,169,458,-289,0.37
202504,5887000,2S2,0,3,-3,0
202504,5887000,2S3,0,5,-5,0
202504,5887000,3,101,13,88,7.77
202504,5887000,3S2,72,39,33,1.85
202504,5887000,3S3,416,455,-39,0.91
202504,5887000,4,2,0,2,NA
202504,5887000,CA,4,104,-100,0.04
202504,5887000,V2,1,0,1,NA
202504,5887000,V3,0,3,-3,0
202504,5887007,2,32,31,1,1.03
202504,5887007,2R2,0,6,-6,0
202504,5887007,3,2,0,2,NA
202504,5887007,3S2,0,1,-1,0
202504,5887007,3S3,21,16,5,1.31
202504,5890000,2,154,95,59,1.62
202504,5890000,3,1,26,-25,0.04
202504,5890000,3S2,1,1,0,1
202504,5890000,3S3,2,63,-61,0.03
202504,5890000,CA,1,40,-39,0.03
202504,5890000,V2,0,4,-4,0
202504,5890000,V3,0,22,-22,0
202504,5893000,2,21,103,-82,0.2
202504,5893000,2S2,4,10,-6,0.4
202504,5893000,2S3,1,3,-2,0.33
202504,5893000,3,4,8,-4,0.5
202504,5893000,3S1,0,1,-1,0
202504,5893000,3S2,2,2,0,1
202504,5893000,3S3,20,155,-135,0.13
202504,5893000,3S3S2,2,1,1,2
202504,5893000,3S4,0,55,-55,0
202504,5893000,CA,27,68,-41,0.4
202504,5893001,2,0,1,-1,0
202504,5893001,3S3,0,2,-2,0
202504,5893001,V3,0,6,-6,0
202504,5893003,2,9,0,9,NA
202504,5893003,CA,0,4,-4,0
202504,5893005,V3,0,1,-1,0
202504,5895000,2,3,120,-117,0.03
202504,5895000,2R2,0,11,-11,0
202504,5895000,2S2,0,5,-5,0
202504,5895000,2S3,0,2,-2,0
202504,5895000,3,0,8,-8,0
202504,5895000,3S2,3,10,-7,0.3
202504,5895000,3S3,1,81,-80,0.01
202504,5895000,CA,0,41,-41,0
202504,8001000,2,21402,21423,-21,1
202504,8001000,2B1,15,15,0,1
202504,8001000,2R2,65,60,5,1.08
202504,8001000,2S1,0,3,-3,0
202504,8001000,2S2,1023,2201,-1178,0.46
202504,8001000,2S3,708,1388,-680,0.51
202504,8001000,3,675,848,-173,0.8
202504,8001000,3S1,0,2,-2,0
202504,8001000,3S2,2188,2716,-528,0.81
202504,8001000,3S3,14972,18039,-3067,0.83
202504,8001000,3S4,11,17,-6,0.65
202504,8001000,4,39,3,36,13
202504,8001000,CA,4861,5307,-446,0.92
202504,8001000,V2,50,97,-47,0.52
202504,8001000,V3,141,279,-138,0.51
202504,8001000,V4,20,22,-2,0.91
202504,8001001,2,235,29,206,8.1
202504,8001001,2R2,1,0,1,NA
202504,8001001,2S2,3,0,3,NA
202504,8001001,2S3,65,36,29,1.81
202504,8001001,3,5,0,5,NA
202504,8001001,3S2,15,50,-35,0.3
202504,8001001,3S3,94,350,-256,0.27
202504,8001001,CA,1,2,-1,0.5
202504,8001002,2,0,2,-2,0
202504,8001002,3S3,12,4,8,3
202504,8001004,2,0,17,-17,0
202504,8001004,3,0,4,-4,0
202504,8001004,3S3,2,26,-24,0.08
202504,8078000,2,1204,465,739,2.59
202504,8078000,2S2,531,1,530,531
202504,8078000,2S3,9,9,0,1
202504,8078000,3,484,19,465,25.47
202504,8078000,3S1,3,0,3,NA
202504,8078000,3S2,10,29,-19,0.34
202504,8078000,3S3,994,374,620,2.66
202504,8078000,CA,6,162,-156,0.04
202504,8078000,V2,12,16,-4,0.75
202504,8078000,V3,0,2,-2,0
202504,8078000,V4,0,3,-3,0
202504,8078001,2,64,109,-45,0.59
202504,8078001,3,0,5,-5,0
202504,8078001,3S2,1,0,1,NA
202504,8078001,CA,1,12,-11,0.08
202504,8078003,2,0,13,-13,0
202504,8137000,2,0,73,-73,0
202504,8137000,CA,1,46,-45,0.02
202504,8141000,2,17,50,-33,0.34
202504,8141000,2S2,12,87,-75,0.14
202504,8141000,3,11,0,11,NA
202504,8141000,3S2,1,2,-1,0.5
202504,8141000,3S3,14,12,2,1.17
202504,8141000,CA,2,13,-11,0.15
202504,8141001,CA,0,12,-12,0
202504,8141002,2,1,1,0,1
202504,8296000,2,9357,2148,7209,4.36
202504,8296000,2B1,0,19,-19,0
202504,8296000,2R2,240,8,232,30
202504,8296000,2S2,228,382,-154,0.6
202504,8296000,2S3,149,218,-69,0.68
202504,8296000,3,342,149,193,2.3
202504,8296000,3S1,4,0,4,NA
202504,8296000,3S2,365,386,-21,0.95
202504,8296000,3S3,2080,2494,-414,0.83
202504,8296000,3S4,7,4,3,1.75
202504,8296000,4,9,2,7,4.5
202504,8296000,CA,2357,414,1943,5.69
202504,8296000,V2,0,5,-5,0
202504,8296000,V3,0,39,-39,0
202504,8296000,V4,0,14,-14,0
202504,8296001,2,0,28,-28,0
202504,8372000,2,8,163,-155,0.05
202504,8372000,3,0,1,-1,0
202504,8372000,3S2,1,2,-1,0.5
202504,8372000,3S3,0,17,-17,0
202504,8372000,3S4,0,2,-2,0
202504,8372000,CA,1,74,-73,0.01
202504,8372002,3,1,0,1,NA
202504,8372003,2,0,1,-1,0
202504,8372004,2,6,13,-7,0.46
202504,8372004,3S2,1,0,1,NA
202504,8372004,3S3,0,1,-1,0
202504,8372004,CA,0,22,-22,0
202504,8421000,2,9,205,-196,0.04
202504,8421000,2S2,1,1,0,1
202504,8421000,2S3,1,0,1,NA
202504,8421000,3,1,3,-2,0.33
202504,8421000,3S2,9,36,-27,0.25
202504,8421000,3S3,108,20,88,5.4
202504,8421000,3S4,1,0,1,NA
202504,8421000,CA,1,102,-101,0.01
202504,8421000,V2,4,0,4,NA
202504,8421000,V3,5,0,5,NA
202504,8421000,V4,4,0,4,NA
202504,8421001,2,2,8,-6,0.25
202504,8421001,2S3,1,0,1,NA
202504,8421001,3S2,5,0,5,NA
202504,8421001,3S3,9,7,2,1.29
202504,8421001,3S4,0,6,-6,0
202504,8421001,V3,2,0,2,NA
202504,8433000,2,13606,2047,11559,6.65
202504,8433000,2R2,8,2,6,4
202504,8433000,2S2,135,272,-137,0.5
202504,8433000,2S3,115,180,-65,0.64
202504,8433000,3,182,111,71,1.64
202504,8433000,3S2,379,380,-1,1
202504,8433000,3S3,2860,2792,68,1.02
202504,8433000,3S4,6,2,4,3
202504,8433000,4,0,1,-1,0
202504,8433000,CA,2122,391,1731,5.43
202504,8433000,V2,1,1,0,1
202504,8433000,V3,21,2,19,10.5
202504,8433001,2,82,125,-43,0.66
202504,8433001,3,1,14,-13,0.07
202504,8433001,3S2,5,6,-1,0.83
202504,8433001,3S3,10,98,-88,0.1
202504,8433001,CA,0,2,-2,0
202504,8433004,3S3,0,3,-3,0
202504,8436000,2,5,74,-69,0.07
202504,8436000,CA,0,72,-72,0
202504,8520000,2,48,207,-159,0.23
202504,8520000,2S2,23,83,-60,0.28
202504,8520000,2S3,17,17,0,1
202504,8520000,3,8,1,7,8
202504,8520000,3S2,15,9,6,1.67
202504,8520000,3S3,1443,1573,-130,0.92
202504,8520000,3S4,1,0,1,NA
202504,8520000,CA,3,88,-85,0.03
202504,8520000,V2,19,0,19,NA
202504,8520000,V3,31,0,31,NA
202504,8549000,2,0,22,-22,0
202504,8549000,3,0,19,-19,0
202504,8549000,3S3,0,1,-1,0
202504,8549000,CA,11,56,-45,0.2
202504,8549002,2,1,3,-2,0.33
202504,8549002,3S3,0,4,-4,0
202504,8549003,2,1,0,1,NA
202504,8549003,2S3,8,0,8,NA
202504,8549003,3S2,1,0,1,NA
202504,8558000,2,55,247,-192,0.22
202504,8558000,2S2,0,1,-1,0
202504,8558000,2S3,0,5,-5,0
202504,8558000,3,0,65,-65,0
202504,8558000,3S2,3,3,0,1
202504,8558000,3S3,1,0,1,NA
202504,8558000,CA,1,31,-30,0.03
202504,8558001,2,0,4,-4,0
202504,8558001,2S3,0,1,-1,0
202504,8558001,3,0,16,-16,0
202504,8558001,3S2,0,2,-2,0
202504,8558001,3S3,0,8,-8,0
202504,8558001,CA,0,1,-1,0
202504,8560000,2,30,164,-134,0.18
202504,8560000,2S2,0,12,-12,0
202504,8560000,2S3,36,155,-119,0.23
202504,8560000,3,1,16,-15,0.06
202504,8560000,3S2,3,30,-27,0.1
202504,8560000,3S3,55,156,-101,0.35
202504,8560000,CA,3,58,-55,0.05
202504,8560001,2,0,1,-1,0
202504,8560001,2S3,0,1,-1,0
202504,8560002,3S4,1,0,1,NA
202504,8560003,2,1,16,-15,0.06
202504,8560003,3,0,1,-1,0
202504,8560003,3S3,0,1,-1,0
202504,8560004,2,4,2,2,2
202504,8560004,3S2,1,1,0,1
202504,8573000,2,96,1096,-1000,0.09
202504,8573000,2S2,11,114,-103,0.1
202504,8573000,2S3,3,6,-3,0.5
202504,8573000,3,5,57,-52,0.09
202504,8573000,3S2,1,95,-94,0.01
202504,8573000,3S3,1,386,-385,0
202504,8573000,CA,89,539,-450,0.17
202504,8573000,V2,1,1,0,1
202504,8573000,V3,6,0,6,NA
202504,8573002,2,0,8,-8,0
202504,8573002,3,0,1,-1,0
202504,8573002,3S3,0,1,-1,0
202504,8573003,2,1,1,0,1
202504,8573003,2S2,0,1,-1,0
202504,8573003,3,0,1,-1,0
202504,8573003,3S2,0,1,-1,0
202504,8573003,CA,0,1,-1,0
202504,8573007,2,0,2,-2,0
202504,8606000,2,9,61,-52,0.15
202504,8606000,2S2,1,0,1,NA
202504,8606000,3,0,1,-1,0
202504,8606000,3S2,5,0,5,NA
202504,8606000,3S3,36,7,29,5.14
202504,8606000,CA,0,49,-49,0
202504,8634000,2,553,408,145,1.36
202504,8634000,2S2,4,27,-23,0.15
202504,8634000,2S3,21,15,6,1.4
202504,8634000,3,145,11,134,13.18
202504,8634000,3S2,19,37,-18,0.51
202504,8634000,3S3,275,522,-247,0.53
202504,8634000,4,1,0,1,NA
202504,8634000,CA,0,91,-91,0
202504,8634000,V2,0,15,-15,0
202504,8634000,V3,1,44,-43,0.02
202504,8638000,2,107,820,-713,0.13
202504,8638000,2S2,2,19,-17,0.11
202504,8638000,2S3,41,45,-4,0.91
202504,8638000,3,0,36,-36,0
202504,8638000,3S2,23,58,-35,0.4
202504,8638000,3S3,270,350,-80,0.77
202504,8638000,3S4,0,1,-1,0
202504,8638000,CA,7,263,-256,0.03
202504,8638000,V2,14,4,10,3.5
202504,8638000,V3,1,0,1,NA
202504,8638001,2,0,3,-3,0
202504,8638001,CA,0,2,-2,0
202504,8638002,2,13,23,-10,0.57
202504,8638002,3,0,1,-1,0
202504,8638002,3S2,6,1,5,6
202504,8638002,CA,0,4,-4,0
202504,8638004,2,2,4,-2,0.5
202504,8638004,3S2,0,1,-1,0
202504,8638004,3S3,0,1,-1,0
202504,8638004,CA,1,9,-8,0.11
202504,8638006,2,1,11,-10,0.09
202504,8638006,2S2,0,1,-1,0
202504,8638006,2S3,0,3,-3,0
202504,8638006,3S3,0,4,-4,0
202504,8675000,2,3,33,-30,0.09
202504,8675000,CA,0,16,-16,0
202504,8685000,2,42,202,-160,0.21
202504,8685000,3,1,34,-33,0.03
202504,8685000,3S2,0,14,-14,0
202504,8685000,3S3,100,35,65,2.86
202504,8685000,CA,4,69,-65,0.06
202504,8685000,V2,4,0,4,NA
202504,8758000,2,4651,3392,1259,1.37
202504,8758000,2B1,3,2,1,1.5
202504,8758000,2R2,14,7,7,2
202504,8758000,2S2,49,136,-87,0.36
202504,8758000,2S3,91,217,-126,0.42
202504,8758000,3,127,69,58,1.84
202504,8758000,3S1,1,0,1,NA
202504,8758000,3S2,164,320,-156,0.51
202504,8758000,3S3,1087,1123,-36,0.97
202504,8758000,CA,2670,954,1716,2.8
202504,8758000,V2,0,59,-59,0
202504,8758000,V3,1,145,-144,0.01
202504,8758000,V4,0,38,-38,0
202504,8770000,2,2,78,-76,0.03
202504,8770000,3S3,0,1,-1,0
202504,8770000,CA,1,25,-24,0.04
202504,8832000,2,12,128,-116,0.09
202504,8832000,2S2,5,5,0,1
202504,8832000,2S3,16,14,2,1.14
202504,8832000,3,0,2,-2,0
202504,8832000,3S2,2,2,0,1
202504,8832000,3S3,43,61,-18,0.7
202504,8832000,3S4,3,0,3,NA
202504,8832000,CA,1,55,-54,0.02
202504,8849000,2,1,21,-20,0.05
202504,8849000,2S3,0,1,-1,0
202504,8849000,3S3,0,1,-1,0
202504,8849000,CA,1,28,-27,0.04
202504,11001000,2,64794,73514,-8720,0.88
202504,11001000,2B1,6,0,6,NA
202504,11001000,2R2,95,70,25,1.36
202504,11001000,2S1,8,12,-4,0.67
202504,11001000,2S2,6129,7979,-1850,0.77
202504,11001000,2S3,2977,2322,655,1.28
202504,11001000,3,1227,2951,-1724,0.42
202504,11001000,3S1,8,15,-7,0.53
202504,11001000,3S2,4431,8267,-3836,0.54
202504,11001000,3S2S3,2,1,1,2
202504,11001000,3S3,10011,20114,-10103,0.5
202504,11001000,3S4,47,57,-10,0.82
202504,11001000,4,37,114,-77,0.32
202504,11001000,CA,21846,49541,-27695,0.44
202504,11001000,V2,139,87,52,1.6
202504,11001000,V3,113,536,-423,0.21
202504,11001000,V4,499,13,486,38.38
202504,11001001,2,180,71,109,2.54
202504,11001001,2S2,0,5,-5,0
202504,11001001,2S3,0,1,-1,0
202504,11001001,3S2,0,2,-2,0
202504,11001001,3S3,14,114,-100,0.12
202504,11001002,2,0,5,-5,0
202504,11001005,2,1,1,0,1
202504,11001006,2,9,10,-1,0.9
202504,11001006,2S2,5,4,1,1.25
202504,11001006,2S3,1,2,-1,0.5
202504,11001006,3S2,0,1,-1,0
202504,11001006,3S3,0,10,-10,0
202504,11001006,CA,0,2,-2,0
202504,13001000,2,11673,12580,-907,0.93
202504,13001000,2B1,31,8,23,3.88
202504,13001000,2R2,61,49,12,1.24
202504,13001000,2S1,17,5,12,3.4
202504,13001000,2S2,7770,4091,3679,1.9
202504,13001000,2S3,2938,2159,779,1.36
202504,13001000,3,1141,244,897,4.68
202504,13001000,3S1,5,6,-1,0.83
202504,13001000,3S2,4759,3039,1720,1.57
202504,13001000,3S3,18368,15828,2540,1.16
202504,13001000,3S4,84,29,55,2.9
202504,13001000,4,24,18,6,1.33
202504,13001000,CA,2279,3218,-939,0.71
202504,13001000,V2,0,40,-40,0
202504,13001000,V3,2,2,0,1
202504,13001000,V4,0,1,-1,0
202504,13001001,2,0,7,-7,0
202504,13001001,2S2,1,1,0,1
202504,13001001,2S3,0,2,-2,0
202504,13001001,3S2,0,2,-2,0
202504,13001001,3S3,10,15,-5,0.67
202504,13001001,CA,0,4,-4,0
202504,13001002,2,1,3,-2,0.33
202504,13001002,3,1,1,0,1
202504,13001002,3S2,1,0,1,NA
202504,13001002,3S3,89,1,88,89
202504,13001002,V3,2,0,2,NA
202504,13001003,2,8,40,-32,0.2
202504,13001003,2S2,0,3,-3,0
202504,13001003,2S3,0,3,-3,0
202504,13001003,3,0,3,-3,0
202504,13001003,3S2,1,0,1,NA
202504,13001003,3S3,5,2,3,2.5
202504,13001003,CA,6,19,-13,0.32
202504,13001004,2,23,57,-34,0.4
202504,13001004,2S2,0,2,-2,0
202504,13001004,3,2,4,-2,0.5
202504,13001004,3S2,1,2,-1,0.5
202504,13001004,3S3,9,13,-4,0.69
202504,13001004,CA,1,12,-11,0.08
202504,13001005,2,0,4,-4,0
202504,13001007,2,0,1,-1,0
202504,13001008,2,0,3,-3,0
202504,13001008,2S2,0,1,-1,0
202504,13001008,2S3,0,1,-1,0
202504,13001008,3S3,0,1,-1,0
202504,13001008,3S4,0,3,-3,0
202504,13001009,2,124,34,90,3.65
202504,13001009,2R2,2,0,2,NA
202504,13001009,2S2,157,2,155,78.5
202504,13001009,2S3,16,2,14,8
202504,13001009,3,4,0,4,NA
202504,13001009,3S2,17,5,12,3.4
202504,13001009,3S3,116,72,44,1.61
202504,13001009,CA,0,35,-35,0
202504,13001010,2,18,28,-10,0.64
202504,13001010,3,1,0,1,NA
202504,13001010,3S2,2,2,0,1
202504,13001010,3S3,0,1,-1,0
202504,13001010,3S4,0,1,-1,0
202504,13001010,CA,2,17,-15,0.12
202504,13001012,2,0,4,-4,0
202504,13001015,2,0,9,-9,0
202504,13001015,3,0,1,-1,0
202504,13001015,3S3,2,4,-2,0.5
202504,13001019,2,5,14,-9,0.36
202504,13001019,3S3,2,2,0,1
202504,13001020,2,6,2,4,3
202504,13001020,CA,1,7,-6,0.14
202504,13001025,3S3,0,1,-1,0
202504,13001028,3S3,414,0,414,NA
202504,13001029,2,14,100,-86,0.14
202504,13001029,3S2,0,21,-21,0
202504,13001029,3S3,5,5,0,1
202504,13001029,3S4,1,6,-5,0.17
202504,13001029,CA,0,1,-1,0
202504,13006000,2,7,3,4,2.33
202504,13006000,3,0,5,-5,0
202504,13006000,3S3,0,5,-5,0
202504,13006000,CA,0,3,-3,0
202504,13006005,2,1,0,1,NA
202504,13006008,2,0,2,-2,0
202504,13006010,2,0,1,-1,0
202504,13006033,3,0,5,-5,0
202504,13006035,CA,0,2,-2,0
202504,13030000,4,0,1,-1,0
202504,13042000,2,0,33,-33,0
202504,13042000,3S2,1,0,1,NA
202504,13042000,3S3,3,9,-6,0.33
202504,13042000,CA,0,4,-4,0
202504,13042000,V3,0,1,-1,0
202504,13052000,2,298,608,-310,0.49
202504,13052000,2B1,0,1,-1,0
202504,13052000,2R2,0,1,-1,0
202504,13052000,2S2,0,2,-2,0
202504,13052000,2S3,1,92,-91,0.01
202504,13052000,3,339,84,255,4.04
202504,13052000,3S2,180,80,100,2.25
202504,13052000,3S3,33,298,-265,0.11
202504,13052000,3S4,3,1,2,3
202504,13052000,CA,637,176,461,3.62
202504,13052000,V2,8,0,8,NA
202504,13052002,2,39,37,2,1.05
202504,13052002,3,3,7,-4,0.43
202504,13052002,3S2,0,1,-1,0
202504,13052002,3S3,4,2,2,2
202504,13052002,CA,3,1,2,3
202504,13052003,2,5,3,2,1.67
202504,13052003,3,2,2,0,1
202504,13052003,CA,0,1,-1,0
202504,13052004,2,38,0,38,NA
202504,13052004,2S3,24,0,24,NA
202504,13052004,3,0,170,-170,0
202504,13062000,2,1,29,-28,0.03
202504,13062000,3S3,0,4,-4,0
202504,13062000,CA,0,35,-35,0
202504,13074000,2,2,9,-7,0.22
202504,13074000,3,1,17,-16,0.06
202504,13074000,3S3,0,1,-1,0
202504,13074000,CA,0,3,-3,0
202504,13140000,2,8,136,-128,0.06
202504,13140000,3,0,2,-2,0
202504,13140000,3S2,0,1,-1,0
202504,13140000,3S3,0,1,-1,0
202504,13140000,CA,0,119,-119,0
202504,13140002,2,0,2,-2,0
202504,13140004,2,0,1,-1,0
202504,13160000,2,4,47,-43,0.09
202504,13160000,2S2,0,1,-1,0
202504,13160000,2S3,0,1,-1,0
202504,13160000,3,0,1,-1,0
202504,13160000,3S1,1,0,1,NA
202504,13160000,3S2,0,1,-1,0
202504,13160000,3S3,18,28,-10,0.64
202504,13160000,3S4,1,0,1,NA
202504,13160000,CA,2,8,-6,0.25
202504,13160000,V3,0,2,-2,0
202504,13188000,2,4,11,-7,0.36
202504,13188000,2S1,2,4,-2,0.5
202504,13188000,2S2,0,1,-1,0
202504,13188000,2S3,2,1,1,2
202504,13188000,3,0,3,-3,0
202504,13188000,3S1,0,2,-2,0
202504,13188000,3S2,2,2,0,1
202504,13188000,3S3,10,11,-1,0.91
202504,13188000,3S4,1,1,0,1
202504,13188000,CA,0,5,-5,0
202504,13212000,2,10,11,-1,0.91
202504,13212000,3S3,3,5,-2,0.6
202504,13212003,3,0,3,-3,0
202504,13212005,2,0,3,-3,0
202504,13212006,2,0,1,-1,0
202504,13212009,2,0,1,-1,0
202504,13212009,3S3,0,1,-1,0
202504,13222000,2,11,27,-16,0.41
202504,13222000,2S2,1,1,0,1
202504,13222000,2S3,3,2,1,1.5
202504,13222000,3,0,1,-1,0
202504,13222000,3S3,74,71,3,1.04
202504,13222000,CA,0,36,-36,0
202504,13222000,V2,3,0,3,NA
202504,13244000,2,45,279,-234,0.16
202504,13244000,3,0,16,-16,0
202504,13244000,3S2,1,2,-1,0.5
202504,13244000,3S3,3,18,-15,0.17
202504,13244000,CA,5,111,-106,0.05
202504,13244001,2,0,3,-3,0
202504,13244005,2,1,3,-2,0.33
202504,13248000,2,0,4,-4,0
202504,13248000,3S2,1,1,0,1
202504,13248001,2,0,5,-5,0
202504,13248003,2,0,3,-3,0
202504,13268019,3S3,1,0,1,NA
202504,13300000,2,7,5,2,1.4
202504,13300000,3,0,9,-9,0
202504,13300000,3S2,1,0,1,NA
202504,13300000,3S3,0,19,-19,0
202504,13300000,3S3S2,0,1,-1,0
202504,13300004,2,0,5,-5,0
202504,13300004,3,0,7,-7,0
202504,13430000,2,192,783,-591,0.25
202504,13430000,2R2,0,18,-18,0
202504,13430000,2S2,0,5,-5,0
202504,13430000,2S3,3,10,-7,0.3
202504,13430000,3,65,82,-17,0.79
202504,13430000,3S2,3,14,-11,0.21
202504,13430000,3S3,72,287,-215,0.25
202504,13430000,3S4,0,1,-1,0
202504,13430000,4,1,0,1,NA
202504,13430000,CA,6,139,-133,0.04
202504,13430006,3S3,4,0,4,NA
202504,13430017,2,0,3,-3,0
202504,13430017,3S3,0,7,-7,0
202504,13430023,2,0,1,-1,0
202504,13430032,2,0,2,-2,0
202504,13430032,3S3,1,0,1,NA
202504,13430032,CA,0,1,-1,0
202504,13433000,2,80,57,23,1.4
202504,13433000,3,0,12,-12,0
202504,13433000,3S3,0,21,-21,0
202504,13433000,CA,0,13,-13,0
202504,13433000,V2,4,0,4,NA
202504,13433003,2,4,7,-3,0.57
202504,13433003,3S3,389,0,389,NA
202504,13433003,CA,3,0,3,NA
202504,13433004,2,1,6,-5,0.17
202504,13433009,3S2,1,1,0,1
202504,13440000,2,11,4,7,2.75
202504,13440000,3,0,1,-1,0
202504,13440007,3,0,6,-6,0
202504,13440021,3S3,0,2,-2,0
202504,13442000,2,10,178,-168,0.06
202504,13442000,2R2,0,1,-1,0
202504,13442000,2S2,0,1,-1,0
202504,13442000,2S3,3,0,3,NA
202504,13442000,3,0,5,-5,0
202504,13442000,3S2,2,1,1,2
202504,13442000,3S3,99,50,49,1.98
202504,13442000,4,0,1,-1,0
202504,13442000,CA,3,87,-84,0.03
202504,13442008,3S3,3,0,3,NA
202504,13442017,3S3,1,0,1,NA
202504,13458000,3,0,16,-16,0
202504,13458000,3S2,0,1,-1,0
202504,13458000,3S3,0,4,-4,0
202504,13468000,2,41,288,-247,0.14
202504,13468000,2R2,0,17,-17,0
202504,13468000,2S2,7,5,2,1.4
202504,13468000,3,6,28,-22,0.21
202504,13468000,3S2,0,4,-4,0
202504,13468000,3S3,1,25,-24,0.04
202504,13468000,CA,3,62,-59,0.05
202504,13468002,CA,0,3,-3,0
202504,13468014,2,0,1,-1,0
202504,13468014,3S3,0,1,-1,0
202504,13468023,CA,0,4,-4,0
202504,13468024,4,0,1,-1,0
202504,13468028,2,0,22,-22,0
202504,13468028,CA,0,3,-3,0
202504,13473000,2,4,17,-13,0.24
202504,13473000,3,0,2,-2,0
202504,13473000,3S3,1,1,0,1
202504,13490000,2,1,7,-6,0.14
202504,13490000,3,0,1,-1,0
202504,13490000,3S2,0,2,-2,0
202504,13490000,3S3,0,2,-2,0
202504,13549000,2,3,0,3,NA
202504,13549001,3,0,1,-1,0
202504,13549001,3S3,1,0,1,NA
202504,13549015,3S3,2,0,2,NA
202504,13580000,2,2,5,-3,0.4
202504,13580000,3,0,2,-2,0
202504,13580000,3S2,2,1,1,2
202504,13580000,3S3,53,67,-14,0.79
202504,13580000,CA,0,1,-1,0
202504,13580000,V3,0,1,-1,0
202504,13580000,V3R3,2,0,2,NA
202504,13580005,2,1,0,1,NA
202504,13600000,2,2,12,-10,0.17
202504,13600000,3,0,1,-1,0
202504,13600000,3S3,0,4,-4,0
202504,13600000,CA,0,3,-3,0
202504,13600001,2,0,2,-2,0
202504,13600001,2S3,1,0,1,NA
202504,13600001,3S3,2,0,2,NA
202504,13620000,2,1,2,-1,0.5
202504,13620000,CA,0,6,-6,0
202504,13647000,2,9,23,-14,0.39
202504,13647000,3,0,1,-1,0
202504,13647000,CA,0,15,-15,0
202504,13647002,2,1,3,-2,0.33
202504,13647002,3S2,1,1,0,1
202504,13650000,2,6,2,4,3
202504,13650000,3,0,4,-4,0
202504,13650000,CA,0,2,-2,0
202504,13650001,3,0,11,-11,0
202504,13650005,3,0,4,-4,0
202504,13650005,CA,0,3,-3,0
202504,13654000,2,5,40,-35,0.12
202504,13654000,3S2,2,1,1,2
202504,13654000,3S3,0,12,-12,0
202504,13654000,3S4,0,2,-2,0
202504,13654000,CA,3,7,-4,0.43
202504,13654005,CA,0,1,-1,0
202504,13655000,2,1,9,-8,0.11
202504,13655000,3,0,11,-11,0
202504,13657000,2,13,116,-103,0.11
202504,13657000,2R2,0,1,-1,0
202504,13657000,2S2,1,4,-3,0.25
202504,13657000,2S3,0,2,-2,0
202504,13657000,3,0,15,-15,0
202504,13657000,3S2,1,2,-1,0.5
202504,13657000,3S3,4,45,-41,0.09
202504,13657000,4,0,1,-1,0
202504,13657000,CA,1,16,-15,0.06
202504,13657000,V3,1,0,1,NA
202504,13657000,V3R3,1,0,1,NA
202504,13657005,2,1,1,0,1
202504,13667000,2,5,23,-18,0.22
202504,13667000,3,0,25,-25,0
202504,13667000,3S3,0,1,-1,0
202504,13667000,CA,0,2,-2,0
202504,13667002,3,0,1,-1,0
202504,13670000,2,10,137,-127,0.07
202504,13670000,3,2,28,-26,0.07
202504,13670000,3S2,1,1,0,1
202504,13670000,3S3,113,45,68,2.51
202504,13670000,CA,3,16,-13,0.19
202504,13670000,V3,0,12,-12,0
202504,13670004,2,0,4,-4,0
202504,13670004,CA,1,0,1,NA
202504,13673000,2,48,83,-35,0.58
202504,13673000,2S2,2,2,0,1
202504,13673000,2S3,9,7,2,1.29
202504,13673000,3,0,1,-1,0
202504,13673000,3S2,2,1,1,2
202504,13673000,3S3,1,2,-1,0.5
202504,13673000,3S4,1,0,1,NA
202504,13673000,CA,0,22,-22,0
202504,13673003,2,1,0,1,NA
202504,13673003,CA,2,2,0,1
202504,13673005,2,4,2,2,2
202504,13673005,2S2,1,0,1,NA
202504,13673005,3S2,2,0,2,NA
202504,13673005,3S3,0,1,-1,0
202504,13673005,CA,1,1,0,1
202504,13683000,2,32,219,-187,0.15
202504,13683000,2S2,0,1,-1,0
202504,13683000,3,1,2,-1,0.5
202504,13683000,3S2,1,2,-1,0.5
202504,13683000,3S3,0,14,-14,0
202504,13683000,CA,0,17,-17,0
202504,13683000,V2,7,0,7,NA
202504,13688000,2,12,248,-236,0.05
202504,13688000,2S3,0,1,-1,0
202504,13688000,3,0,44,-44,0
202504,13688000,3S2,0,2,-2,0
202504,13688000,3S3,1,96,-95,0.01
202504,13688000,CA,24,51,-27,0.47
202504,13688000,V2,0,1,-1,0
202504,13688000,V3,0,9,-9,0
202504,13688007,3,0,5,-5,0
202504,13744000,2,1,9,-8,0.11
202504,13744000,3,0,5,-5,0
202504,13744000,3S3,0,14,-14,0
202504,13744000,CA,0,1,-1,0
202504,13744007,3,0,1,-1,0
202504,13744011,2,0,1,-1,0
202504,13744012,2,0,1,-1,0
202504,13744012,CA,0,1,-1,0
202504,13760000,2,0,13,-13,0
202504,13760000,CA,2,30,-28,0.07
202504,13760000,V2,1,0,1,NA
202504,13780000,2,1,6,-5,0.17
202504,13780000,3S3,0,4,-4,0
202504,13780023,2,0,1,-1,0
202504,13810000,2,0,1,-1,0
202504,13810000,3,0,7,-7,0
202504,13810011,3,0,3,-3,0
202504,13836000,2,240,1179,-939,0.2
202504,13836000,2S2,90,43,47,2.09
202504,13836000,2S3,28,77,-49,0.36
202504,13836000,3,19,73,-54,0.26
202504,13836000,3S2,209,166,43,1.26
202504,13836000,3S3,850,788,62,1.08
202504,13836000,3S4,1,0,1,NA
202504,13836000,4,0,5,-5,0
202504,13836000,CA,81,359,-278,0.23
202504,13836000,V2,13,0,13,NA
202504,13836001,2,1,1,0,1
202504,13836003,2,1,3,-2,0.33
202504,13836003,3S3,1,6,-5,0.17
202504,13838000,2,106,95,11,1.12
202504,13838000,2R2,5,0,5,NA
202504,13838000,2S2,62,3,59,20.67
202504,13838000,2S3,35,13,22,2.69
202504,13838000,3S2,246,155,91,1.59
202504,13838000,3S3,185,69,116,2.68
202504,13838000,3S4,5,2,3,2.5
202504,13838000,CA,7,22,-15,0.32
202504,13838001,2,8,15,-7,0.53
202504,13873000,2,1,38,-37,0.03
202504,13873000,3S2,0,1,-1,0
202504,13873000,3S3,0,7,-7,0
202504,13873000,CA,1,29,-28,0.03
202504,13873000,V2,4,0,4,NA
202504,13894000,2,33,40,-7,0.82
202504,13894000,2S2,0,1,-1,0
202504,13894000,2S3,1,0,1,NA
202504,13894000,3,0,1,-1,0
202504,13894000,3S3,41,15,26,2.73
202504,13894000,CA,0,8,-8,0
202504,15001000,2,1468,3139,-1671,0.47
202504,15001000,2B1,0,1,-1,0
202504,15001000,2R2,0,9,-9,0
202504,15001000,2S2,13,169,-156,0.08
202504,15001000,2S3,2,36,-34,0.06
202504,15001000,3,11,126,-115,0.09
202504,15001000,3S2,99,224,-125,0.44
202504,15001000,3S3,393,835,-442,0.47
202504,15001000,4,0,5,-5,0
202504,15001000,CA,1150,1247,-97,0.92
202504,15001000,V2,7,0,7,NA
202504,15001000,V3,0,108,-108,0
202504,15001007,2,0,4,-4,0
202504,15001007,2S2,0,13,-13,0
202504,15001007,3S3,0,1,-1,0
202504,15022000,2,0,4,-4,0
202504,15047000,2,2,39,-37,0.05
202504,15047000,3S3,0,6,-6,0
202504,15047000,CA,20,44,-24,0.45
202504,15047007,2,1,0,1,NA
202504,15047010,2,0,17,-17,0
202504,15051000,2,1,25,-24,0.04
202504,15051000,3,1,2,-1,0.5
202504,15051000,3S3,0,6,-6,0
202504,15051000,4,18,0,18,NA
202504,15051000,CA,0,17,-17,0
202504,15051000,V3,81,0,81,NA
202504,15051000,V4,150,0,150,NA
202504,15087000,2,2,60,-58,0.03
202504,15087000,3S2,10,0,10,NA
202504,15087000,3S3,0,17,-17,0
202504,15087000,CA,0,16,-16,0
202504,15092000,CA,0,1,-1,0
202504,15097000,2,0,17,-17,0
202504,15097000,2S2,0,1,-1,0
202504,15097000,CA,0,6,-6,0
202504,15104000,2,2,20,-18,0.1
202504,15104000,3,0,1,-1,0
202504,15104000,3S3,41,11,30,3.73
202504,15104000,CA,1,16,-15,0.06
202504,15106000,2,2,4,-2,0.5
202504,15106000,3,0,1,-1,0
202504,15106000,3S3,11,0,11,NA
202504,15106000,CA,0,4,-4,0
202504,15109000,2,0,10,-10,0
202504,15109000,3S3,2,0,2,NA
202504,15109000,CA,0,5,-5,0
202504,15109001,2,0,4,-4,0
202504,15109002,2,1,1,0,1
202504,15131000,3S3,1,0,1,NA
202504,15131000,CA,0,1,-1,0
202504,15131001,2,1,0,1,NA
202504,15131001,3,1,0,1,NA
202504,15135000,2,0,4,-4,0
202504,15135002,2,0,1,-1,0
202504,15162000,2,0,3,-3,0
202504,15172000,2,0,18,-18,0
202504,15172000,CA,0,2,-2,0
202504,15176000,2,57,744,-687,0.08
202504,15176000,2S3,0,1,-1,0
202504,15176000,3,0,23,-23,0
202504,15176000,3S2,2,10,-8,0.2
202504,15176000,3S3,127,297,-170,0.43
202504,15176000,CA,11,252,-241,0.04
202504,15176000,V2,0,1,-1,0
202504,15176000,V3,0,2,-2,0
202504,15180000,2,1,15,-14,0.07
202504,15180000,CA,0,4,-4,0
202504,15183000,2,1,10,-9,0.1
202504,15183000,CA,0,27,-27,0
202504,15185000,2,0,10,-10,0
202504,15185000,3S2,2,0,2,NA
202504,15185000,3S3,0,1,-1,0
202504,15185000,CA,0,4,-4,0
202504,15187000,2,0,3,-3,0
202504,15187000,3S3,0,3,-3,0
202504,15187000,CA,0,1,-1,0
202504,15189000,2,2,1,1,2
202504,15189000,3S3,0,2,-2,0
202504,15189000,CA,0,5,-5,0
202504,15204000,2,2,38,-36,0.05
202504,15204000,2S2,0,1,-1,0
202504,15204000,3,0,1,-1,0
202504,15204000,3S2,0,1,-1,0
202504,15204000,3S3,0,2,-2,0
202504,15204000,CA,0,15,-15,0
202504,15212000,2,1,2,-1,0.5
202504,15212000,CA,0,1,-1,0
202504,15215000,2,0,7,-7,0
202504,15215000,2S2,0,1,-1,0
202504,15215000,3,1,0,1,NA
202504,15215000,3S2,4,0,4,NA
202504,15215000,3S3,267,0,267,NA
202504,15215000,3S4,0,1,-1,0
202504,15215000,CA,0,2,-2,0
202504,15218000,2,0,1,-1,0
202504,15218000,CA,0,2,-2,0
202504,15223000,2,1,13,-12,0.08
202504,15223000,3,8,2,6,4
202504,15223000,3S2,0,1,-1,0
202504,15223000,3S4,0,1,-1,0
202504,15223000,CA,0,1,-1,0
202504,15224000,2,0,19,-19,0
202504,15224000,3,0,1,-1,0
202504,15224000,3S3,1,1,0,1
202504,15224000,CA,0,3,-3,0
202504,15226000,2,0,1,-1,0
202504,15232000,2,0,3,-3,0
202504,15232000,3S3,0,1,-1,0
202504,15232001,2,0,1,-1,0
202504,15236000,2,0,4,-4,0
202504,15236000,3S3,1,0,1,NA
202504,15236000,3S4,2,0,2,NA
202504,15236000,CA,0,1,-1,0
202504,15238000,2,1207,1758,-551,0.69
202504,15238000,2R2,0,4,-4,0
202504,15238000,2S2,13,65,-52,0.2
202504,15238000,2S3,6,41,-35,0.15
202504,15238000,3,75,80,-5,0.94
202504,15238000,3S2,22,114,-92,0.19
202504,15238000,3S3,484,603,-119,0.8
202504,15238000,3S4,1,4,-3,0.25
202504,15238000,4,0,1,-1,0
202504,15238000,CA,451,564,-113,0.8
202504,15238000,V2,7,0,7,NA
202504,15238000,V3,0,1,-1,0
202504,15238002,2,0,14,-14,0
202504,15238011,2,0,27,-27,0
202504,15238012,2,0,1,-1,0
202504,15238012,3,0,1,-1,0
202504,15238012,3S3,0,1,-1,0
202504,15244000,2,0,18,-18,0
202504,15244000,CA,1,3,-2,0.33
202504,15248000,2,0,5,-5,0
202504,15248000,CA,13,14,-1,0.93
202504,15248004,2,0,1,-1,0
202504,15272000,2,1,10,-9,0.1
202504,15272000,3S2,0,1,-1,0
202504,15272000,CA,0,2,-2,0
202504,15276000,2,0,1,-1,0
202504,15276000,CA,0,1,-1,0
202504,15293000,2,0,16,-16,0
202504,15293000,3S3,0,1,-1,0
202504,15293000,CA,0,2,-2,0
202504,15296000,2,0,6,-6,0
202504,15296000,CA,0,4,-4,0
202504,15299000,2,14,196,-182,0.07
202504,15299000,3,0,5,-5,0
202504,15299000,CA,52,80,-28,0.65
202504,15317000,2,0,2,-2,0
202504,15322000,2,7,189,-182,0.04
202504,15322000,3,3,24,-21,0.12
202504,15322000,CA,0,45,-45,0
202504,15322008,2,0,12,-12,0
202504,15322008,2S2,0,1,-1,0
202504,15322008,3,0,3,-3,0
202504,15322008,3S3,1,1,0,1
202504,15322008,CA,0,13,-13,0
202504,15325000,2,0,12,-12,0
202504,15325000,3,0,1,-1,0
202504,15325000,CA,0,1,-1,0
202504,15332000,2,1,5,-4,0.2
202504,15332000,CA,0,1,-1,0
202504,15332005,2,0,6,-6,0
202504,15332005,3S3,0,1,-1,0
202504,15362000,2,0,19,-19,0
202504,15362000,CA,0,4,-4,0
202504,15367000,2,0,19,-19,0
202504,15367000,3S3,0,3,-3,0
202504,15368000,2,2,2,0,1
202504,15368000,CA,1,2,-1,0.5
202504,15377000,2,0,9,-9,0
202504,15377000,3S2,1,5,-4,0.2
202504,15377000,3S3,0,7,-7,0
202504,15377000,CA,0,1,-1,0
202504,15380000,2,1,33,-32,0.03
202504,15380000,CA,0,14,-14,0
202504,15401000,2,0,4,-4,0
202504,15401000,CA,0,2,-2,0
202504,15403000,2,0,5,-5,0
202504,15403000,CA,0,2,-2,0
202504,15407000,2,10,248,-238,0.04
202504,15407000,2S3,0,1,-1,0
202504,15407000,3,2,13,-11,0.15
202504,15407000,3S2,0,1,-1,0
202504,15407000,3S3,1,21,-20,0.05
202504,15407000,CA,3,118,-115,0.03
202504,15407000,V3,0,3,-3,0
202504,15425000,2,4,6,-2,0.67
202504,15425000,CA,0,1,-1,0
202504,15442000,3S2,0,2,-2,0
202504,15442000,CA,1,2,-1,0.5
202504,15442001,2,0,1,-1,0
202504,15455000,2,8,31,-23,0.26
202504,15455000,3S3,2,2,0,1
202504,15455000,CA,15,51,-36,0.29
202504,15464000,2,0,7,-7,0
202504,15464000,CA,0,2,-2,0
202504,15464003,2,0,1,-1,0
202504,15466000,2,0,8,-8,0
202504,15466000,CA,0,9,-9,0
202504,15469000,2,5,202,-197,0.02
202504,15469000,2S3,0,1,-1,0
202504,15469000,3,0,7,-7,0
202504,15469000,3S2,0,1,-1,0
202504,15469000,3S3,0,7,-7,0
202504,15469000,CA,2,40,-38,0.05
202504,15469000,V3,0,3,-3,0
202504,15476000,2,0,12,-12,0
202504,15476000,CA,0,2,-2,0
202504,15480000,2,1,24,-23,0.04
202504,15480000,CA,0,6,-6,0
202504,15491000,2,564,225,339,2.51
202504,15491000,2S2,0,1,-1,0
202504,15491000,3,201,1,200,201
202504,15491000,3S2,184,77,107,2.39
202504,15491000,3S3,4382,1549,2833,2.83
202504,15491000,CA,4,33,-29,0.12
202504,15491000,V2,0,2,-2,0
202504,15491000,V3,18,14,4,1.29
202504,15491000,V4,70,0,70,NA
202504,15491001,2,170,35,135,4.86
202504,15491001,2S2,0,1,-1,0
202504,15491001,2S3,0,1,-1,0
202504,15491001,3,2,2,0,1
202504,15491001,3S2,1,11,-10,0.09
202504,15491001,3S3,293,586,-293,0.5
202504,15491001,3S4,1,0,1,NA
202504,15491001,CA,1,8,-7,0.12
202504,15491001,V4,0,32,-32,0
202504,15491002,2,0,1,-1,0
202504,15491004,2,1,0,1,NA
202504,15491004,3S3,0,2,-2,0
202504,15491006,2,0,14,-14,0
202504,15491006,2R2,0,2,-2,0
202504,15494000,2,0,20,-20,0
202504,15494000,3S3,0,2,-2,0
202504,15494000,CA,0,4,-4,0
202504,15500000,2,27,9,18,3
202504,15500000,3,15,0,15,NA
202504,15500000,3S2,0,18,-18,0
202504,15500000,3S3,0,133,-133,0
202504,15500000,CA,0,3,-3,0
202504,15507000,2,0,19,-19,0
202504,15507000,3S2,0,1,-1,0
202504,15507000,CA,0,9,-9,0
202504,15507000,V3,6,0,6,NA
202504,15507002,CA,0,1,-1,0
202504,15511000,2,0,1,-1,0
202504,15511000,CA,0,1,-1,0
202504,15514000,2,3,15,-12,0.2
202504,15514000,CA,7,10,-3,0.7
202504,15516000,2,50,330,-280,0.15
202504,15516000,2S1,1,0,1,NA
202504,15516000,2S2,0,2,-2,0
202504,15516000,3,3,10,-7,0.3
202504,15516000,3S2,1,7,-6,0.14
202504,15516000,3S3,23,31,-8,0.74
202504,15516000,CA,33,185,-152,0.18
202504,15516000,V2,2,0,2,NA
202504,15516000,V3,2,0,2,NA
202504,15516000,V4,1,0,1,NA
202504,15518000,2,1,7,-6,0.14
202504,15518000,3S2,3,4,-1,0.75
202504,15518000,3S3,0,5,-5,0
202504,15518000,CA,1,3,-2,0.33
202504,15518000,V3,0,8,-8,0
202504,15518001,2,0,6,-6,0
202504,15522000,2,0,7,-7,0
202504,15522000,CA,0,1,-1,0
202504,15531000,2,0,9,-9,0
202504,15531000,CA,3,3,0,1
202504,15533000,2,0,2,-2,0
202504,15537000,2,2,50,-48,0.04
202504,15537000,2S2,0,1,-1,0
202504,15537000,2S3,0,2,-2,0
202504,15537000,3,0,39,-39,0
202504,15537000,3S2,6,1,5,6
202504,15537000,3S3,370,11,359,33.64
202504,15537000,CA,0,12,-12,0
202504,15537000,V2,4,0,4,NA
202504,15537000,V3,15,68,-53,0.22
202504,15537000,V4,61,0,61,NA
202504,15542000,2,3,22,-19,0.14
202504,15542000,3S2,0,1,-1,0
202504,15542000,3S3,26,16,10,1.62
202504,15542000,CA,0,10,-10,0
202504,15550000,2,0,5,-5,0
202504,15550000,3S3,0,1,-1,0
202504,15572000,2,110,807,-697,0.14
202504,15572000,2R2,0,19,-19,0
202504,15572000,2S2,4,4,0,1
202504,15572000,2S3,2,5,-3,0.4
202504,15572000,3,6,35,-29,0.17
202504,15572000,3S2,14,264,-250,0.05
202504,15572000,3S2S3,1,0,1,NA
202504,15572000,3S3,41,562,-521,0.07
202504,15572000,3S4,2,1,1,2
202504,15572000,CA,14,195,-181,0.07
202504,15572000,V2,0,5,-5,0
202504,15572000,V3,36,32,4,1.12
202504,15572006,3S2,0,5,-5,0
202504,15572007,2,0,2,-2,0
202504,15572007,3S3,0,6,-6,0
202504,15572007,CA,1,0,1,NA
202504,15572013,3,0,2,-2,0
202504,15572014,2,1,1,0,1
202504,15572014,3S2,0,53,-53,0
202504,15572014,3S3,0,125,-125,0
202504,15580000,2,0,7,-7,0
202504,15580000,CA,0,3,-3,0
202504,15599000,2,1,31,-30,0.03
202504,15599000,3,0,1,-1,0
202504,15599000,3S3,0,3,-3,0
202504,15599000,3S4,1,0,1,NA
202504,15599000,CA,0,6,-6,0
202504,15600000,2,1,17,-16,0.06
202504,15600000,2S2,1,0,1,NA
202504,15600000,3S3,0,2,-2,0
202504,15600000,CA,24,50,-26,0.48
202504,15600000,V3,27,1,26,27
202504,15600000,V4,101,0,101,NA
202504,15621000,2,0,3,-3,0
202504,15621000,CA,0,1,-1,0
202504,15632000,2,2,9,-7,0.22
202504,15632000,3S3,1,0,1,NA
202504,15632000,CA,1,10,-9,0.1
202504,15638000,2,3,21,-18,0.14
202504,15638000,3,0,1,-1,0
202504,15638000,3S3,1,1,0,1
202504,15638000,CA,1,10,-9,0.1
202504,15646000,2,2,134,-132,0.01
202504,15646000,3,3,1,2,3
202504,15646000,3S1,1,0,1,NA
202504,15646000,3S2,11,7,4,1.57
202504,15646000,3S3,2882,275,2607,10.48
202504,15646000,3S4,0,1,-1,0
202504,15646000,4,8,22,-14,0.36
202504,15646000,CA,1,21,-20,0.05
202504,15646000,V2,1,24,-23,0.04
202504,15646000,V3,42,201,-159,0.21
202504,15646000,V3R2,0,28,-28,0
202504,15646000,V4,48,214,-166,0.22
202504,15646000,V4R2,0,52,-52,0
202504,15646001,3S3,16,0,16,NA
202504,15660000,CA,0,20,-20,0
202504,15664000,2,2,21,-19,0.1
202504,15664000,3S3,0,1,-1,0
202504,15664000,CA,0,1,-1,0
202504,15667000,2,2,12,-10,0.17
202504,15667000,2S2,0,1,-1,0
202504,15667000,3,11,3,8,3.67
202504,15667000,3S2,1,0,1,NA
202504,15667000,CA,24,28,-4,0.86
202504,15673000,2,0,3,-3,0
202504,15673000,CA,0,1,-1,0
202504,15673000,V3R2,27,0,27,NA
202504,15673000,V4R2,9,0,9,NA
202504,15676000,2,0,24,-24,0
202504,15676000,3S3,0,1,-1,0
202504,15676000,CA,0,5,-5,0
202504,15681000,2,0,1,-1,0
202504,15681000,CA,0,2,-2,0
202504,15681004,CA,0,1,-1,0
202504,15686000,2,26,99,-73,0.26
202504,15686000,3,0,10,-10,0
202504,15686000,3S3,0,14,-14,0
202504,15686000,CA,2,7,-5,0.29
202504,15690000,2,4,11,-7,0.36
202504,15690000,3,0,1,-1,0
202504,15690000,3S3,0,1,-1,0
202504,15690000,CA,0,5,-5,0
202504,15693000,2,3,84,-81,0.04
202504,15693000,3,1,3,-2,0.33
202504,15693000,3S3,0,3,-3,0
202504,15693000,CA,0,14,-14,0
202504,15696000,2,0,9,-9,0
202504,15696000,CA,0,10,-10,0
202504,15720000,2,0,1,-1,0
202504,15720000,CA,0,4,-4,0
202504,15723000,CA,0,1,-1,0
202504,15740000,2,0,11,-11,0
202504,15740000,3S3,0,9,-9,0
202504,15740000,CA,0,19,-19,0
202504,15753000,2,3,75,-72,0.04
202504,15753000,3,0,3,-3,0
202504,15753000,3S2,0,2,-2,0
202504,15753000,3S3,0,13,-13,0
202504,15753000,CA,37,67,-30,0.55
202504,15755000,2,0,7,-7,0
202504,15755000,V3R2,32,0,32,NA
202504,15757000,2,27,64,-37,0.42
202504,15757000,3,23,0,23,NA
202504,15757000,3S2,5,1,4,5
202504,15757000,3S3,1483,9,1474,164.78
202504,15757000,3S4,3,0,3,NA
202504,15757000,4,14,0,14,NA
202504,15757000,CA,0,16,-16,0
202504,15757000,V2,5,0,5,NA
202504,15757000,V3,152,72,80,2.11
202504,15757000,V3R2,0,32,-32,0
202504,15757000,V4,119,0,119,NA
202504,15757000,V4R2,43,0,43,NA
202504,15757002,3S3,39,0,39,NA
202504,15757003,3,0,2,-2,0
202504,15757003,3S3,11,0,11,NA
202504,15757003,V4,12,0,12,NA
202504,15759000,2,464,2553,-2089,0.18
202504,15759000,2R2,0,13,-13,0
202504,15759000,2S2,20,22,-2,0.91
202504,15759000,2S3,3,5,-2,0.6
202504,15759000,3,122,120,2,1.02
202504,15759000,3S2,355,95,260,3.74
202504,15759000,3S3,2071,992,1079,2.09
202504,15759000,3S4,1,1,0,1
202504,15759000,CA,49,818,-769,0.06
202504,15759000,V2,27,5,22,5.4
202504,15759000,V3,31,89,-58,0.35
202504,15759000,V4,14,47,-33,0.3
202504,15759001,2,0,1,-1,0
202504,15761000,2,0,28,-28,0
202504,15761000,3,0,3,-3,0
202504,15761000,CA,1,2,-1,0.5
202504,15762000,2,0,2,-2,0
202504,15762000,CA,0,4,-4,0
202504,15763000,2,13,29,-16,0.45
202504,15763000,2S3,0,1,-1,0
202504,15763000,3,0,2,-2,0
202504,15763000,3S2,0,30,-30,0
202504,15763000,3S3,0,58,-58,0
202504,15763000,CA,7,16,-9,0.44
202504,15764000,2,7,79,-72,0.09
202504,15764000,2S2,0,1,-1,0
202504,15764000,2S3,0,1,-1,0
202504,15764000,3,0,2,-2,0
202504,15764000,3S2,1,6,-5,0.17
202504,15764000,3S3,3,32,-29,0.09
202504,15764000,CA,1,21,-20,0.05
202504,15774000,2,0,2,-2,0
202504,15774000,CA,0,1,-1,0
202504,15776000,2,0,46,-46,0
202504,15776000,3S3,0,5,-5,0
202504,15776000,CA,0,14,-14,0
202504,15778000,2,0,6,-6,0
202504,15790000,2,0,1,-1,0
202504,15790000,3S3,111,0,111,NA
202504,15790000,CA,0,16,-16,0
202504,15790000,V3,130,32,98,4.06
202504,15790000,V4,6,0,6,NA
202504,15798000,2,0,7,-7,0
202504,15798000,3,0,1,-1,0
202504,15798000,CA,0,1,-1,0
202504,15804000,2,0,41,-41,0
202504,15804000,3S2,1,2,-1,0.5
202504,15804000,3S3,0,4,-4,0
202504,15804000,CA,1,12,-11,0.08
202504,15806000,2,15,198,-183,0.08
202504,15806000,2S2,47,396,-349,0.12
202504,15806000,2S3,5,29,-24,0.17
202504,15806000,3S2,0,6,-6,0
202504,15806000,3S3,1479,1029,450,1.44
202504,15806000,CA,11,72,-61,0.15
202504,15808000,2,0,19,-19,0
202504,15808000,CA,3,23,-20,0.13
202504,15810000,2,0,3,-3,0
202504,15810000,CA,0,2,-2,0
202504,15814000,2,10,52,-42,0.19
202504,15814000,3S3,0,13,-13,0
202504,15814000,CA,16,20,-4,0.8
202504,15816000,2,0,8,-8,0
202504,15816000,CA,0,3,-3,0
202504,15820000,2,0,3,-3,0
202504,15820000,3,3,0,3,NA
202504,15820000,3S2,3,0,3,NA
202504,15820000,3S3,165,0,165,NA
202504,15820000,CA,0,3,-3,0
202504,15820000,V3,80,0,80,NA
202504,15822000,2,0,1,-1,0
202504,15822000,CA,0,4,-4,0
202504,15832000,2,0,1,-1,0
202504,15832000,CA,0,1,-1,0
202504,15835000,2,0,10,-10,0
202504,15835000,3S3,0,7,-7,0
202504,15835000,CA,0,4,-4,0
202504,15837000,2,322,389,-67,0.83
202504,15837000,3,24,63,-39,0.38
202504,15837000,3S2,15,63,-48,0.24
202504,15837000,3S3,769,920,-151,0.84
202504,15837000,3S4,0,1,-1,0
202504,15837000,CA,0,21,-21,0
202504,15837000,V2,0,22,-22,0
202504,15837000,V3,105,1,104,105
202504,15839000,2,0,2,-2,0
202504,15842000,2,0,7,-7,0
202504,15842000,3S3,0,2,-2,0
202504,15842000,CA,0,16,-16,0
202504,15861000,2,16,81,-65,0.2
202504,15861000,2S2,0,1,-1,0
202504,15861000,3,1,0,1,NA
202504,15861000,3S2,0,1,-1,0
202504,15861000,3S3,0,13,-13,0
202504,15861000,CA,1,25,-24,0.04
202504,15861000,V2,0,1,-1,0
202504,15861002,3S3,0,2,-2,0
202504,15861008,2,0,1,-1,0
202504,15861008,CA,0,1,-1,0
202504,15879000,2,0,1,-1,0
202504,15879000,CA,0,1,-1,0
202504,15897000,2,0,11,-11,0
202504,15897000,2S3,0,1,-1,0
202504,15897000,3,1,0,1,NA
202504,15897000,3S2,0,1,-1,0
202504,15897000,3S3,1,2,-1,0.5
202504,15897000,CA,1,3,-2,0.33
202504,17001000,2,4362,6295,-1933,0.69
202504,17001000,2S2,352,597,-245,0.59
202504,17001000,2S3,154,197,-43,0.78
202504,17001000,3,149,160,-11,0.93
202504,17001000,3S1,1,1,0,1
202504,17001000,3S2,403,400,3,1.01
202504,17001000,3S3,1922,2013,-91,0.95
202504,17001000,3S4,0,1,-1,0
202504,17001000,4,11,8,3,1.38
202504,17001000,CA,723,2025,-1302,0.36
202504,17001000,V2,1,0,1,NA
202504,17001002,2,0,3,-3,0
202504,17001004,2,0,1,-1,0
202504,17001022,2,1,0,1,NA
202504,17001027,2,1,1,0,1
202504,17001027,3S2,0,1,-1,0
202504,17001027,3S3,0,65,-65,0
202504,17001029,2,1,2,-1,0.5
202504,17013000,2,28,307,-279,0.09
202504,17013000,3,1,7,-6,0.14
202504,17013000,3S2,1,0,1,NA
202504,17013000,CA,2,59,-57,0.03
202504,17013000,V3,0,6,-6,0
202504,17042000,2,32,197,-165,0.16
202504,17042000,3,0,4,-4,0
202504,17042000,3S2,12,11,1,1.09
202504,17042000,3S3,36,33,3,1.09
202504,17042000,CA,1,100,-99,0.01
202504,17042007,2,0,1,-1,0
202504,17050000,2,17,62,-45,0.27
202504,17050000,3,0,1,-1,0
202504,17050000,3S3,0,1,-1,0
202504,17050000,CA,0,24,-24,0
202504,17088000,2,7,67,-60,0.1
202504,17088000,3,0,1,-1,0
202504,17088000,3S3,0,2,-2,0
202504,17088000,CA,0,17,-17,0
202504,17174000,2,442,661,-219,0.67
202504,17174000,2R2,0,18,-18,0
202504,17174000,2S2,22,51,-29,0.43
202504,17174000,2S3,36,59,-23,0.61
202504,17174000,3,41,16,25,2.56
202504,17174000,3S2,74,31,43,2.39
202504,17174000,3S3,376,438,-62,0.86
202504,17174000,3S4,2,2,0,1
202504,17174000,4,32,1,31,32
202504,17174000,CA,6,193,-187,0.03
202504,17174011,2,0,2,-2,0
202504,17272000,2,18,36,-18,0.5
202504,17272000,3S3,0,15,-15,0
202504,17272000,CA,0,19,-19,0
202504,17272005,2,0,2,-2,0
202504,17380000,2,691,930,-239,0.74
202504,17380000,2R2,0,5,-5,0
202504,17380000,2S2,7,14,-7,0.5
202504,17380000,2S3,2,3,-1,0.67
202504,17380000,3,13,28,-15,0.46
202504,17380000,3S2,24,14,10,1.71
202504,17380000,3S3,171,195,-24,0.88
202504,17380000,3S4,3,1,2,3
202504,17380000,CA,205,260,-55,0.79
202504,17380000,V3,0,5,-5,0
202504,17380002,2,2,1,1,2
202504,17380002,3S2,0,1,-1,0
202504,17380002,3S3,11,0,11,NA
202504,17380003,2,1,1,0,1
202504,17388000,2,0,23,-23,0
202504,17388000,CA,0,8,-8,0
202504,17388002,2,0,1,-1,0
202504,17388002,3,0,1,-1,0
202504,17388002,3S2,1,0,1,NA
202504,17388002,3S3,0,2,-2,0
202504,17388008,2,0,2,-2,0
202504,17433000,2,41,87,-46,0.47
202504,17433000,3,4,5,-1,0.8
202504,17433000,3S3,14,2,12,7
202504,17433000,CA,0,54,-54,0
202504,17433000,V2,1,0,1,NA
202504,17433000,V3,0,3,-3,0
202504,17442000,2,13,123,-110,0.11
202504,17442000,2S2,0,1,-1,0
202504,17442000,3,1,19,-18,0.05
202504,17442000,3S2,0,4,-4,0
202504,17442000,3S3,0,1,-1,0
202504,17442000,3S4,0,2,-2,0
202504,17442000,CA,2,29,-27,0.07
202504,17442000,V3,0,1,-1,0
202504,17442002,2,0,2,-2,0
202504,17442004,2,0,1,-1,0
202504,17444000,2,27,74,-47,0.36
202504,17444000,3,0,6,-6,0
202504,17444000,3S3,0,4,-4,0
202504,17444000,CA,1,5,-4,0.2
202504,17444000,V3,0,1,-1,0
202504,17446000,2,4,1,3,4
202504,17446000,CA,0,5,-5,0
202504,17486000,2,30,154,-124,0.19
202504,17486000,3,0,9,-9,0
202504,17486000,3S3,0,32,-32,0
202504,17486000,CA,0,74,-74,0
202504,17486004,2,0,1,-1,0
202504,17486009,2,1,0,1,NA
202504,17486009,CA,1,0,1,NA
202504,17486012,CA,0,7,-7,0
202504,17495000,2,4,28,-24,0.14
202504,17495000,3,0,3,-3,0
202504,17495000,CA,0,7,-7,0
202504,17495000,V3,0,1,-1,0
202504,17513000,2,94,62,32,1.52
202504,17513000,3,0,14,-14,0
202504,17513000,CA,1,11,-10,0.09
202504,17513000,V2,0,1,-1,0
202504,17513014,2,0,1,-1,0
202504,17524000,2,0,106,-106,0
202504,17524000,3S3,0,6,-6,0
202504,17524000,CA,2,56,-54,0.04
202504,17524001,2,12,50,-38,0.24
202504,17524001,3S2,0,2,-2,0
202504,17524001,3S3,1,157,-156,0.01
202504,17524001,CA,0,22,-22,0
202504,17524003,2,0,18,-18,0
202504,17524005,2,0,1,-1,0
202504,17524005,3S3,1,0,1,NA
202504,17524006,2,0,4,-4,0
202504,17541000,2,18,103,-85,0.17
202504,17541000,3,0,4,-4,0
202504,17541000,3S3,1,5,-4,0.2
202504,17541000,CA,2,96,-94,0.02
202504,17541000,V3,0,3,-3,0
202504,17541002,2,0,9,-9,0
202504,17541002,CA,1,0,1,NA
202504,17541009,2,0,1,-1,0
202504,17614000,2,7,326,-319,0.02
202504,17614000,2R2,0,11,-11,0
202504,17614000,2S2,0,1,-1,0
202504,17614000,3,2,8,-6,0.25
202504,17614000,3S3,13,35,-22,0.37
202504,17614000,CA,4,127,-123,0.03
202504,17614004,2,0,18,-18,0
202504,17616000,2,30,65,-35,0.46
202504,17616000,2S2,0,1,-1,0
202504,17616000,3,0,3,-3,0
202504,17616000,3S3,1,4,-3,0.25
202504,17616000,4,0,4,-4,0
202504,17616000,CA,0,34,-34,0
202504,17653000,2,7,121,-114,0.06
202504,17653000,CA,0,23,-23,0
202504,17653007,2,0,1,-1,0
202504,17662000,2,21,54,-33,0.39
202504,17662000,3,0,13,-13,0
202504,17662000,CA,0,2,-2,0
202504,17662000,V3,0,5,-5,0
202504,17662003,2,4,8,-4,0.5
202504,17662003,3,0,9,-9,0
202504,17662003,CA,0,1,-1,0
202504,17662003,V2,0,1,-1,0
202504,17662003,V3,0,6,-6,0
202504,17662007,2,0,3,-3,0
202504,17665000,2,4,19,-15,0.21
202504,17665000,CA,0,43,-43,0
202504,17777000,2,28,324,-296,0.09
202504,17777000,2R2,0,9,-9,0
202504,17777000,2S3,0,1,-1,0
202504,17777000,3,0,3,-3,0
202504,17777000,3S2,1,0,1,NA
202504,17777000,3S3,0,7,-7,0
202504,17777000,CA,1,139,-138,0.01
202504,17777000,V2,0,1,-1,0
202504,17777003,2,0,1,-1,0
202504,17777008,3S3,0,1,-1,0
202504,17867000,2,7,42,-35,0.17
202504,17867000,2S2,0,1,-1,0
202504,17867000,2S3,1,1,0,1
202504,17867000,3,0,2,-2,0
202504,17867000,3S2,0,1,-1,0
202504,17867000,3S3,5,0,5,NA
202504,17867000,CA,0,8,-8,0
202504,17873000,2,36,417,-381,0.09
202504,17873000,2S2,4,8,-4,0.5
202504,17873000,2S3,1,1,0,1
202504,17873000,3,0,6,-6,0
202504,17873000,3S2,0,6,-6,0
202504,17873000,3S3,1,48,-47,0.02
202504,17873000,CA,18,142,-124,0.13
202504,17873004,2,1,3,-2,0.33
202504,17873004,2S3,0,1,-1,0
202504,17873004,3S3,3,3,0,1
202504,17877000,2,75,182,-107,0.41
202504,17877000,2S2,0,1,-1,0
202504,17877000,3,2,30,-28,0.07
202504,17877000,3S3,3,35,-32,0.09
202504,17877000,CA,2,68,-66,0.03
202504,18001000,2,524,1777,-1253,0.29
202504,18001000,2R2,0,6,-6,0
202504,18001000,2S2,4,92,-88,0.04
202504,18001000,2S3,0,4,-4,0
202504,18001000,3,36,113,-77,0.32
202504,18001000,3S2,18,34,-16,0.53
202504,18001000,3S3,27,565,-538,0.05
202504,18001000,4,0,1,-1,0
202504,18001000,CA,63,264,-201,0.24
202504,18001000,V2,1,0,1,NA
202504,18001002,2,0,2,-2,0
202504,18001008,2,0,1,-1,0
202504,18001013,2,1,2,-1,0.5
202504,18001013,3S3,2,5,-3,0.4
202504,18029000,2,1,6,-5,0.17
202504,18029000,3,0,1,-1,0
202504,18029000,3S3,0,7,-7,0
202504,18029000,CA,0,2,-2,0
202504,18029005,3S2,1,0,1,NA
202504,18094000,2,0,23,-23,0
202504,18094000,3S2,0,1,-1,0
202504,18094000,3S3,1,0,1,NA
202504,18094000,CA,1,1,0,1
202504,18150000,2,25,100,-75,0.25
202504,18150000,2S2,0,1,-1,0
202504,18150000,3,0,12,-12,0
202504,18150000,3S3,1,30,-29,0.03
202504,18150000,CA,0,19,-19,0
202504,18205000,2,3,20,-17,0.15
202504,18205000,3,0,6,-6,0
202504,18205000,3S3,0,6,-6,0
202504,18205000,CA,0,14,-14,0
202504,18247000,2,4,89,-85,0.04
202504,18247000,3S3,0,5,-5,0
202504,18247000,CA,0,18,-18,0
202504,18247000,V3,0,1,-1,0
202504,18256000,2,2,28,-26,0.07
202504,18256000,2S2,0,1,-1,0
202504,18256000,3,0,1,-1,0
202504,18256000,3S2,1,0,1,NA
202504,18256000,3S3,1,2,-1,0.5
202504,18256000,CA,0,2,-2,0
202504,18410000,2,1,32,-31,0.03
202504,18410000,3S2,2,1,1,2
202504,18410000,CA,0,1,-1,0
202504,18460000,2,5,3,2,1.67
202504,18460001,2,0,3,-3,0
202504,18460001,V2,0,1,-1,0
202504,18479000,2,2,8,-6,0.25
202504,18479000,3S2,1,1,0,1
202504,18479000,3S3,0,8,-8,0
202504,18592000,2,16,52,-36,0.31
202504,18592000,3,1,3,-2,0.33
202504,18592000,3S3,0,8,-8,0
202504,18592000,CA,0,9,-9,0
202504,18610000,2,0,30,-30,0
202504,18610000,3S2,0,1,-1,0
202504,18610000,CA,1,1,0,1
202504,18610001,2,2,1,1,2
202504,18610002,2,0,2,-2,0
202504,18610002,3S2,5,0,5,NA
202504,18610002,3S3,14,0,14,NA
202504,18753000,2,113,472,-359,0.24
202504,18753000,2S2,0,1,-1,0
202504,18753000,3,0,23,-23,0
202504,18753000,3S2,0,2,-2,0
202504,18753000,3S3,8,38,-30,0.21
202504,18753000,4,0,1,-1,0
202504,18753000,CA,0,35,-35,0
202504,18753003,2,0,3,-3,0
202504,18753006,2,0,4,-4,0
202504,18756000,CA,0,2,-2,0
202504,18756008,2,0,4,-4,0
202504,18785000,2,11,23,-12,0.48
202504,18785000,3,1,24,-23,0.04
202504,18785000,3S3,0,4,-4,0
202504,18785000,CA,0,2,-2,0
202504,18860000,2,4,5,-1,0.8
202504,18860000,3S2,1,0,1,NA
202504,18860000,CA,2,0,2,NA
202504,19001000,2,919,3539,-2620,0.26
202504,19001000,2R2,0,46,-46,0
202504,19001000,2S2,7,91,-84,0.08
202504,19001000,2S3,2,22,-20,0.09
202504,19001000,3,21,130,-109,0.16
202504,19001000,3S2,37,109,-72,0.34
202504,19001000,3S3,159,788,-629,0.2
202504,19001000,3S4,2,2,0,1
202504,19001000,CA,397,858,-461,0.46
202504,19001000,V2,0,3,-3,0
202504,19001000,V3,3,0,3,NA
202504,19001002,2,0,1,-1,0
202504,19022000,2,0,30,-30,0
202504,19022000,3S2,0,1,-1,0
202504,19022000,CA,0,1,-1,0
202504,19050000,2,5,103,-98,0.05
202504,19050000,3,0,3,-3,0
202504,19050000,3S2,0,2,-2,0
202504,19050000,CA,0,8,-8,0
202504,19050000,V3,0,4,-4,0
202504,19050001,2,0,16,-16,0
202504,19050001,3,0,2,-2,0
202504,19050006,2,0,39,-39,0
202504,19050006,3,1,0,1,NA
202504,19050006,CA,0,1,-1,0
202504,19050007,2,0,3,-3,0
202504,19050016,2,0,1,-1,0
202504,19075000,2,0,68,-68,0
202504,19075000,3,0,1,-1,0
202504,19075000,CA,0,16,-16,0
202504,19075002,2,0,6,-6,0
202504,19100000,2,0,62,-62,0
202504,19100000,3,0,8,-8,0
202504,19100000,3S3,1,12,-11,0.08
202504,19100000,CA,0,8,-8,0
202504,19110000,2,0,16,-16,0
202504,19110000,3,0,3,-3,0
202504,19110000,3S2,0,2,-2,0
202504,19110012,2,0,5,-5,0
202504,19110012,3S3,0,42,-42,0
202504,19110029,2,0,1,-1,0
202504,19130000,2,4,27,-23,0.15
202504,19130000,3S2,0,2,-2,0
202504,19130000,CA,0,32,-32,0
202504,19130003,2,0,1,-1,0
202504,19130010,2,0,1,-1,0
202504,19137000,2,1,16,-15,0.06
202504,19137000,3,0,2,-2,0
202504,19137000,CA,0,50,-50,0
202504,19137004,2,0,5,-5,0
202504,19137004,3,0,2,-2,0
202504,19137004,CA,0,1,-1,0
202504,19137008,2,0,1,-1,0
202504,19137008,CA,0,1,-1,0
202504,19142000,2,1529,859,670,1.78
202504,19142000,2B1,2,1,1,2
202504,19142000,2R2,2,0,2,NA
202504,19142000,2S1,0,2,-2,0
202504,19142000,2S2,232,199,33,1.17
202504,19142000,2S3,27,26,1,1.04
202504,19142000,3,74,18,56,4.11
202504,19142000,3S1,1,1,0,1
202504,19142000,3S2,204,172,32,1.19
202504,19142000,3S3,698,898,-200,0.78
202504,19142000,3S4,0,2,-2,0
202504,19142000,4,4,4,0,1
202504,19142000,CA,205,137,68,1.5
202504,19142000,V2,49,0,49,NA
202504,19142000,V3,24,0,24,NA
202504,19142004,2,0,1,-1,0
202504,19142004,2S2,0,4,-4,0
202504,19142004,2S3,0,1,-1,0
202504,19142004,3S2,0,1,-1,0
202504,19142006,2,234,124,110,1.89
202504,19142006,2S2,17,3,14,5.67
202504,19142006,2S3,10,0,10,NA
202504,19142006,3,1,0,1,NA
202504,19142006,3S2,96,167,-71,0.57
202504,19142006,3S3,334,239,95,1.4
202504,19142006,CA,0,1,-1,0
202504,19142006,V2,0,47,-47,0
202504,19142006,V3,0,21,-21,0
202504,19142020,CA,0,1,-1,0
202504,19212000,2,1,102,-101,0.01
202504,19212000,3,0,6,-6,0
202504,19212000,3S2,0,2,-2,0
202504,19212000,CA,1,96,-95,0.01
202504,19256000,2,3,79,-76,0.04
202504,19256000,3,0,8,-8,0
202504,19256000,3S3,0,5,-5,0
202504,19256000,CA,0,17,-17,0
202504,19256012,3,0,2,-2,0
202504,19256014,2,0,1,-1,0
202504,19256018,2,0,2,-2,0
202504,19256018,3S3,1,10,-9,0.1
202504,19256018,CA,0,1,-1,0
202504,19256019,2,0,1,-1,0
202504,19290000,2,1,83,-82,0.01
202504,19290000,3S3,1,8,-7,0.12
202504,19290000,CA,0,9,-9,0
202504,19300000,2,287,63,224,4.56
202504,19300000,2S2,127,28,99,4.54
202504,19300000,2S3,27,22,5,1.23
202504,19300000,3,1,1,0,1
202504,19300000,3S2,43,27,16,1.59
202504,19300000,3S3,219,218,1,1
202504,19300000,CA,43,24,19,1.79
202504,19300000,V2,0,6,-6,0
202504,19300000,V4,1,0,1,NA
202504,19318000,2,0,3,-3,0
202504,19318000,CA,0,1,-1,0
202504,19355000,2,0,15,-15,0
202504,19355000,3,0,5,-5,0
202504,19355000,3S3,1,0,1,NA
202504,19355000,CA,0,2,-2,0
202504,19355012,2,1,13,-12,0.08
202504,19355012,CA,0,5,-5,0
202504,19364000,2,0,3,-3,0
202504,19364000,3S2,0,1,-1,0
202504,19364002,2,0,1,-1,0
202504,19392000,2,1,18,-17,0.06
202504,19392000,3,0,1,-1,0
202504,19392000,CA,0,5,-5,0
202504,19397000,2,0,25,-25,0
202504,19397000,3S2,0,3,-3,0
202504,19397000,3S3,0,5,-5,0
202504,19418020,2,2,1,1,2
202504,19418020,3S3,0,55,-55,0
202504,19418020,CA,0,2,-2,0
202504,19450000,2,2,51,-49,0.04
202504,19450000,3,0,2,-2,0
202504,19450000,3S2,3,3,0,1
202504,19450000,3S3,0,2,-2,0
202504,19450000,CA,0,7,-7,0
202504,19450019,2,1,4,-3,0.25
202504,19450019,3S3,0,1,-1,0
202504,19455000,2,47,149,-102,0.32
202504,19455000,2S2,7,9,-2,0.78
202504,19455000,2S3,2,0,2,NA
202504,19455000,3,3,6,-3,0.5
202504,19455000,3S2,13,4,9,3.25
202504,19455000,3S3,422,78,344,5.41
202504,19455000,CA,8,77,-69,0.1
202504,19455005,2,93,7,86,13.29
202504,19455005,3S2,1,0,1,NA
202504,19455005,3S3,98,41,57,2.39
202504,19455005,CA,20,11,9,1.82
202504,19455005,V2,0,15,-15,0
202504,19455005,V3,0,8,-8,0
202504,19473000,2,1,49,-48,0.02
202504,19473000,3,0,1,-1,0
202504,19473000,3S3,1,11,-10,0.09
202504,19473000,CA,0,62,-62,0
202504,19513000,2,0,4,-4,0
202504,19513000,CA,1,22,-21,0.05
202504,19513003,3S3,19,0,19,NA
202504,19513003,CA,0,7,-7,0
202504,19517000,2,0,9,-9,0
202504,19517006,2,0,1,-1,0
202504,19517006,CA,0,1,-1,0
202504,19532000,2,7,229,-222,0.03
202504,19532000,2S2,0,3,-3,0
202504,19532000,3,0,3,-3,0
202504,19532000,3S2,3,2,1,1.5
202504,19532000,3S3,0,23,-23,0
202504,19532000,CA,22,65,-43,0.34
202504,19532005,2,4,6,-2,0.67
202504,19532008,2,0,38,-38,0
202504,19532008,3S2,0,1,-1,0
202504,19532008,CA,0,6,-6,0
202504,19532009,2,0,2,-2,0
202504,19532013,2,0,2,-2,0
202504,19532013,3S3,0,15,-15,0
202504,19532013,CA,0,1,-1,0
202504,19533000,2,0,8,-8,0
202504,19533000,2S2,0,1,-1,0
202504,19533000,3,8,1,7,8
202504,19533000,4,0,1,-1,0
202504,19533000,CA,0,2,-2,0
202504,19548000,2,22,138,-116,0.16
202504,19548000,2R2,0,1,-1,0
202504,19548000,2S2,0,1,-1,0
202504,19548000,3,0,4,-4,0
202504,19548000,3S2,0,2,-2,0
202504,19548000,3S3,1,21,-20,0.05
202504,19548000,CA,0,54,-54,0
202504,19548001,2,2,2,0,1
202504,19573000,2,1323,551,772,2.4
202504,19573000,2B1,19,1,18,19
202504,19573000,2R2,5,4,1,1.25
202504,19573000,2S2,220,68,152,3.24
202504,19573000,2S3,37,31,6,1.19
202504,19573000,3,37,17,20,2.18
202504,19573000,3S2,64,116,-52,0.55
202504,19573000,3S3,1925,507,1418,3.8
202504,19573000,3S4,3,3,0,1
202504,19573000,4,0,2,-2,0
202504,19573000,CA,111,149,-38,0.74
202504,19573000,V2,2,0,2,NA
202504,19585000,2,1,5,-4,0.2
202504,19585000,CA,0,5,-5,0
202504,19585001,2,0,9,-9,0
202504,19585001,CA,0,4,-4,0
202504,19585004,2,0,3,-3,0
202504,19585004,CA,0,3,-3,0
202504,19622000,2,2,23,-21,0.09
202504,19622000,3S2,1,1,0,1
202504,19622000,CA,0,26,-26,0
202504,19693000,2,0,4,-4,0
202504,19693001,2,0,3,-3,0
202504,19693005,2,0,1,-1,0
202504,19698000,2,619,1401,-782,0.44
202504,19698000,2B1,5,0,5,NA
202504,19698000,2R2,0,4,-4,0
202504,19698000,2S1,0,4,-4,0
202504,19698000,2S2,184,95,89,1.94
202504,19698000,2S3,25,12,13,2.08
202504,19698000,3,22,80,-58,0.28
202504,19698000,3S1,0,3,-3,0
202504,19698000,3S2,96,96,0,1
202504,19698000,3S3,217,499,-282,0.43
202504,19698000,4,0,1,-1,0
202504,19698000,CA,32,563,-531,0.06
202504,19698000,V2,3,0,3,NA
202504,19698000,V3,2,0,2,NA
202504,19698007,2,8,39,-31,0.21
202504,19698007,3,0,1,-1,0
202504,19698007,3S3,0,1,-1,0
202504,19698007,CA,0,15,-15,0
202504,19698014,3,0,1,-1,0
202504,19698036,2,2,0,2,NA
202504,19701000,2,0,5,-5,0
202504,19701000,3S3,0,7,-7,0
202504,19701000,CA,0,1,-1,0
202504,19701006,2,1,1,0,1
202504,19701006,V2,1,4,-3,0.25
202504,19743000,2,0,34,-34,0
202504,19743000,CA,0,25,-25,0
202504,19760000,2,0,2,-2,0
202504,19760000,CA,0,1,-1,0
202504,19780000,2,6,85,-79,0.07
202504,19780000,3,0,16,-16,0
202504,19780000,3S2,0,1,-1,0
202504,19780000,3S3,1,2,-1,0.5
202504,19780000,CA,1,18,-17,0.06
202504,19780001,2,0,1,-1,0
202504,19785000,2,0,13,-13,0
202504,19785000,CA,0,3,-3,0
202504,19807000,2,10,188,-178,0.05
202504,19807000,2S2,0,2,-2,0
202504,19807000,3S2,0,2,-2,0
202504,19807000,3S3,1,7,-6,0.14
202504,19807000,CA,0,85,-85,0
202504,19807009,2,0,1,-1,0
202504,19809000,2,0,2,-2,0
202504,19821000,2,0,8,-8,0
202504,19821000,CA,1,22,-21,0.05
202504,19821007,2,0,4,-4,0
202504,19824000,2,0,15,-15,0
202504,19824000,CA,0,3,-3,0
202504,19845000,2,1795,511,1284,3.51
202504,19845000,2R2,3,0,3,NA
202504,19845000,2S2,561,178,383,3.15
202504,19845000,2S3,48,32,16,1.5
202504,19845000,3,18,10,8,1.8
202504,19845000,3S1,6,1,5,6
202504,19845000,3S2,86,327,-241,0.26
202504,19845000,3S3,171,880,-709,0.19
202504,19845000,3S4,2,0,2,NA
202504,19845000,4,1,1,0,1
202504,19845000,CA,156,161,-5,0.97
202504,19845000,V2,1,0,1,NA
202504,20001000,2,2954,5153,-2199,0.57
202504,20001000,2B1,0,7,-7,0
202504,20001000,2R2,95,9,86,10.56
202504,20001000,2S1,2,0,2,NA
202504,20001000,2S2,50,264,-214,0.19
202504,20001000,2S3,25,124,-99,0.2
202504,20001000,3,52,155,-103,0.34
202504,20001000,3S1,0,1,-1,0
202504,20001000,3S2,166,447,-281,0.37
202504,20001000,3S3,413,1899,-1486,0.22
202504,20001000,3S4,7,4,3,1.75
202504,20001000,4,1,8,-7,0.12
202504,20001000,CA,418,741,-323,0.56
202504,20001000,V2,2,0,2,NA
202504,20001000,V3,1,1,0,1
202504,20001001,2,0,6,-6,0
202504,20001001,3S3,2,4,-2,0.5
202504,20001001,CA,2,0,2,NA
202504,20001002,2,0,6,-6,0
202504,20001003,2,1,5,-4,0.2
202504,20001003,3S2,1,0,1,NA
202504,20001003,3S3,0,1,-1,0
202504,20001005,2,0,7,-7,0
202504,20001005,2S2,0,1,-1,0
202504,20001005,3S3,0,1,-1,0
202504,20001005,CA,0,1,-1,0
202504,20001009,2,0,1,-1,0
202504,20001012,2,3,0,3,NA
202504,20001012,3S3,0,2,-2,0
202504,20001013,2,4,13,-9,0.31
202504,20001013,2S3,2,0,2,NA
202504,20001013,3S3,1,4,-3,0.25
202504,20001013,4,1,0,1,NA
202504,20001013,V3R3,5,0,5,NA
202504,20001014,2,1,0,1,NA
202504,20001018,2,10,11,-1,0.91
202504,20001018,3,1,0,1,NA
202504,20001018,3S2,0,1,-1,0
202504,20001018,3S3,2,7,-5,0.29
202504,20001025,2,3,1,2,3
202504,20001025,3S2,1,0,1,NA
202504,20001031,2,8,4,4,2
202504,20001032,2,0,7,-7,0
202504,20001039,2,0,4,-4,0
202504,20001039,3S3,2,0,2,NA
202504,20011000,2,345,1517,-1172,0.23
202504,20011000,2S2,1,7,-6,0.14
202504,20011000,2S3,1,24,-23,0.04
202504,20011000,3,42,160,-118,0.26
202504,20011000,3S1,2,2,0,1
202504,20011000,3S2,337,260,77,1.3
202504,20011000,3S2S3,0,1,-1,0
202504,20011000,3S3,363,3402,-3039,0.11
202504,20011000,3S4,5,3,2,1.67
202504,20011000,4,0,1,-1,0
202504,20011000,CA,67,201,-134,0.33
202504,20011000,V2,0,4,-4,0
202504,20011000,V3,0,2,-2,0
202504,20011000,V4,0,197,-197,0
202504,20011010,3S3,0,51,-51,0
202504,20011010,CA,0,1,-1,0
202504,20011014,3S3,0,5,-5,0
202504,20011021,2,0,11,-11,0
202504,20013000,2,42,325,-283,0.13
202504,20013000,2S2,4,2,2,2
202504,20013000,2S3,2,5,-3,0.4
202504,20013000,3,1,1,0,1
202504,20013000,3S2,35,6,29,5.83
202504,20013000,3S3,390,660,-270,0.59
202504,20013000,3S4,1,0,1,NA
202504,20013000,CA,21,74,-53,0.28
202504,20013000,V3,0,1,-1,0
202504,20013002,2,1,8,-7,0.12
202504,20013002,CA,0,1,-1,0
202504,20013003,2,0,1,-1,0
202504,20032000,2,2,67,-65,0.03
202504,20032000,3S2,0,3,-3,0
202504,20032000,3S3,0,5,-5,0
202504,20032000,CA,1,3,-2,0.33
202504,20032001,2,3,4,-1,0.75
202504,20032001,3S3,7,0,7,NA
202504,20045000,2,44,133,-89,0.33
202504,20045000,3,1,0,1,NA
202504,20045000,3S2,1,0,1,NA
202504,20045000,3S3,0,51,-51,0
202504,20045000,CA,0,12,-12,0
202504,20060000,2,272,376,-104,0.72
202504,20060000,2S2,1,11,-10,0.09
202504,20060000,2S3,0,8,-8,0
202504,20060000,3,65,18,47,3.61
202504,20060000,3S2,23,233,-210,0.1
202504,20060000,3S3,84,279,-195,0.3
202504,20060000,3S4,0,1,-1,0
202504,20060000,CA,43,47,-4,0.91
202504,20060000,V2,0,1,-1,0
202504,20060000,V3,3,1,2,3
202504,20060004,3S3,1,0,1,NA
202504,20175000,2,5,60,-55,0.08
202504,20175000,3S3,0,3,-3,0
202504,20175000,CA,1,13,-12,0.08
202504,20175008,3S3,1,0,1,NA
202504,20175010,2,0,1,-1,0
202504,20175010,3S3,0,2,-2,0
202504,20175011,CA,0,3,-3,0
202504,20175016,2,1,4,-3,0.25
202504,20175016,3S2,1,0,1,NA
202504,20175016,3S3,6,0,6,NA
202504,20178000,2,10,90,-80,0.11
202504,20178000,2S2,1,3,-2,0.33
202504,20178000,2S3,0,3,-3,0
202504,20178000,3,0,6,-6,0
202504,20178000,3S2,1,19,-18,0.05
202504,20178000,3S3,7,45,-38,0.16
202504,20178000,CA,1,10,-9,0.1
202504,20178006,3S3,0,2,-2,0
202504,20178008,2,7,4,3,1.75
202504,20178008,2S3,4,0,4,NA
202504,20178008,3S3,0,2,-2,0
202504,20178008,CA,2,0,2,NA
202504,20178014,3S3,0,1,-1,0
202504,20178018,2,1,3,-2,0.33
202504,20228000,2,46,290,-244,0.16
202504,20228000,2S2,0,1,-1,0
202504,20228000,2S3,3,0,3,NA
202504,20228000,3,1,6,-5,0.17
202504,20228000,3S2,1,1,0,1
202504,20228000,3S3,42,134,-92,0.31
202504,20228000,CA,4,27,-23,0.15
202504,20228002,2,2,3,-1,0.67
202504,20228002,3S3,1,0,1,NA
202504,20228006,2,0,1,-1,0
202504,20228010,2,0,3,-3,0
202504,20228011,3S3,0,2,-2,0
202504,20238000,2,28,147,-119,0.19
202504,20238000,2S2,6,3,3,2
202504,20238000,2S3,0,1,-1,0
202504,20238000,3,1,2,-1,0.5
202504,20238000,3S2,1,0,1,NA
202504,20238000,3S3,117,54,63,2.17
202504,20238000,3S4,0,2,-2,0
202504,20238000,CA,1,9,-8,0.11
202504,20238003,3,0,1,-1,0
202504,20250000,2,14,100,-86,0.14
202504,20250000,2S2,0,1,-1,0
202504,20250000,2S3,0,1,-1,0
202504,20250000,3,0,1,-1,0
202504,20250000,3S2,1,9,-8,0.11
202504,20250000,3S3,80,124,-44,0.65
202504,20250000,3S4,16,4,12,4
202504,20250000,CA,3,16,-13,0.19
202504,20250001,2,0,2,-2,0
202504,20250001,3S3,2,0,2,NA
202504,20250002,2,64,153,-89,0.42
202504,20250002,2S2,1,12,-11,0.08
202504,20250002,2S3,7,20,-13,0.35
202504,20250002,3,1,6,-5,0.17
202504,20250002,3S2,2,5,-3,0.4
202504,20250002,3S3,94,292,-198,0.32
202504,20250002,3S4,1,5,-4,0.2
202504,20250002,4,1,1,0,1
202504,20250002,CA,5,28,-23,0.18
202504,20250002,V3,1,7,-6,0.14
202504,20250003,2,0,2,-2,0
202504,20250003,3S3,1,1,0,1
202504,20250004,2,0,3,-3,0
202504,20250004,3S2,29,0,29,NA
202504,20250004,3S3,1,54,-53,0.02
202504,20250004,CA,1,0,1,NA
202504,20295000,2,6,102,-96,0.06
202504,20295000,3,0,2,-2,0
202504,20295000,3S2,1,0,1,NA
202504,20295000,3S3,75,131,-56,0.57
202504,20295000,CA,0,11,-11,0
202504,20295000,V3,0,3,-3,0
202504,20295000,V4,0,4,-4,0
202504,20310000,2,0,2,-2,0
202504,20383000,2,3,49,-46,0.06
202504,20383000,2S1,1,0,1,NA
202504,20383000,2S3,1,0,1,NA
202504,20383000,3,14,3,11,4.67
202504,20383000,3S2,9,32,-23,0.28
202504,20383000,3S3,183,1509,-1326,0.12
202504,20383000,CA,0,9,-9,0
202504,20383001,2,0,1,-1,0
202504,20383001,2S2,0,2,-2,0
202504,20383001,2S3,0,1,-1,0
202504,20383001,3,0,1,-1,0
202504,20383001,3S2,0,27,-27,0
202504,20383001,3S3,14,800,-786,0.02
202504,20383006,2,12,1,11,12
202504,20383006,3,0,8,-8,0
202504,20383006,3S3,0,8,-8,0
202504,20383010,2,0,9,-9,0
202504,20383010,2S2,0,5,-5,0
202504,20383010,3S2,1,0,1,NA
202504,20383010,3S3,14,119,-105,0.12
202504,20383010,CA,2,2,0,1
202504,20400000,2,52,287,-235,0.18
202504,20400000,2S2,28,28,0,1
202504,20400000,2S3,9,8,1,1.12
202504,20400000,3,2,5,-3,0.4
202504,20400000,3S2,38,160,-122,0.24
202504,20400000,3S3,441,385,56,1.15
202504,20400000,3S4,1,0,1,NA
202504,20400000,CA,8,61,-53,0.13
202504,20400000,V3,0,2,-2,0
202504,20400001,2,0,1,-1,0
202504,20400001,3S3,0,10,-10,0
202504,20400002,2,0,10,-10,0
202504,20400002,3S3,0,2,-2,0
202504,20443000,2,3,45,-42,0.07
202504,20443000,3,0,3,-3,0
202504,20443000,3S3,3,8,-5,0.38
202504,20443000,CA,0,1,-1,0
202504,20517000,2,14,92,-78,0.15
202504,20517000,2S2,1,0,1,NA
202504,20517000,3,0,3,-3,0
202504,20517000,3S2,1,1,0,1
202504,20517000,3S3,4,20,-16,0.2
202504,20517000,CA,1,7,-6,0.14
202504,20517000,V2,0,2,-2,0
202504,20517006,2,1,0,1,NA
202504,20517006,2S2,0,1,-1,0
202504,20517006,2S3,0,2,-2,0
202504,20517006,3S3,1,1,0,1
202504,20550000,2,38,124,-86,0.31
202504,20550000,2S2,1,6,-5,0.17
202504,20550000,3,2,11,-9,0.18
202504,20550000,3S2,2,6,-4,0.33
202504,20550000,3S3,1,93,-92,0.01
202504,20550000,CA,2,11,-9,0.18
202504,20570000,2,3,87,-84,0.03
202504,20570000,3S3,6,5,1,1.2
202504,20570000,CA,0,3,-3,0
202504,20570002,2,0,4,-4,0
202504,20614000,2,50,31,19,1.61
202504,20614000,2S3,0,1,-1,0
202504,20614000,3,1,7,-6,0.14
202504,20614000,3S3,33,10,23,3.3
202504,20614000,3S4,0,4,-4,0
202504,20614000,CA,2,1,1,2
202504,20614006,3S3,21,0,21,NA
202504,20614012,2,2,3,-1,0.67
202504,20614012,3S2,5,5,0,1
202504,20614012,3S3,22,5,17,4.4
202504,20614012,3S4,3,3,0,1
202504,20621000,2,134,174,-40,0.77
202504,20621000,2S2,2,0,2,NA
202504,20621000,2S3,19,0,19,NA
202504,20621000,3,6,2,4,3
202504,20621000,3S2,5,5,0,1
202504,20621000,3S3,123,283,-160,0.43
202504,20621000,CA,1,32,-31,0.03
202504,20621000,V3,0,1,-1,0
202504,20621006,2,1,3,-2,0.33
202504,20621006,3S3,0,1,-1,0
202504,20621011,2,0,3,-3,0
202504,20621011,3S3,0,3,-3,0
202504,20710000,2,30,155,-125,0.19
202504,20710000,2S2,107,0,107,NA
202504,20710000,2S3,0,1,-1,0
202504,20710000,3,2,22,-20,0.09
202504,20710000,3S2,18,3,15,6
202504,20710000,3S3,292,115,177,2.54
202504,20710000,4,0,1,-1,0
202504,20710000,CA,3,50,-47,0.06
202504,20710000,V2,2,0,2,NA
202504,20710000,V3,12,0,12,NA
202504,20710001,2S3,17,0,17,NA
202504,20710001,3S3,6,0,6,NA
202504,20710005,2,0,2,-2,0
202504,20750000,2,4,77,-73,0.05
202504,20750000,2S2,1,1,0,1
202504,20750000,3S2,0,2,-2,0
202504,20750000,3S3,0,4,-4,0
202504,20750000,CA,0,15,-15,0
202504,20750002,2,3,12,-9,0.25
202504,20750009,2,0,2,-2,0
202504,20770000,2,21,152,-131,0.14
202504,20770000,2R2,0,25,-25,0
202504,20770000,2S2,1,9,-8,0.11
202504,20770000,2S3,0,8,-8,0
202504,20770000,3,2,6,-4,0.33
202504,20770000,3S2,46,4,42,11.5
202504,20770000,3S3,1896,105,1791,18.06
202504,20770000,3S4,4,1,3,4
202504,20770000,CA,2,53,-51,0.04
202504,20770000,V3,0,2,-2,0
202504,20770001,2,0,1,-1,0
202504,20770003,2,0,1,-1,0
202504,20770003,3,0,1,-1,0
202504,20770003,3S3,2,0,2,NA
202504,20770006,3S3,6,0,6,NA
202504,20770010,3,0,2,-2,0
202504,20770014,2,20,6,14,3.33
202504,20770014,2S3,0,1,-1,0
202504,20770014,3,3,1,2,3
202504,20770014,3S2,5,6,-1,0.83
202504,20770014,3S3,966,8,958,120.75
202504,20770014,3S4,0,4,-4,0
202504,20770014,CA,1,10,-9,0.1
202504,20787000,2,0,12,-12,0
202504,20787000,3S3,2,3,-1,0.67
202504,20787000,4,0,2,-2,0
202504,20787000,CA,0,5,-5,0
202504,20787005,2,1,0,1,NA
202504,20787005,CA,2,0,2,NA
202504,23001000,2,2498,4520,-2022,0.55
202504,23001000,2B1,0,5,-5,0
202504,23001000,2R2,0,116,-116,0
202504,23001000,2S2,37,249,-212,0.15
202504,23001000,2S3,2,67,-65,0.03
202504,23001000,3,29,198,-169,0.15
202504,23001000,3S1,1,1,0,1
202504,23001000,3S2,133,757,-624,0.18
202504,23001000,3S3,583,1873,-1290,0.31
202504,23001000,3S4,2,6,-4,0.33
202504,23001000,4,1,4,-3,0.25
202504,23001000,CA,910,684,226,1.33
202504,23001001,2,2,14,-12,0.14
202504,23001001,2R2,1,0,1,NA
202504,23001008,2,0,2,-2,0
202504,23001008,2S3,0,2,-2,0
202504,23001009,2,0,1,-1,0
202504,23001010,3,0,3,-3,0
202504,23001011,3S3,0,1,-1,0
202504,23001014,2,0,1,-1,0
202504,23001017,2,0,7,-7,0
202504,23001020,2,0,4,-4,0
202504,23001020,3S2,1,1,0,1
202504,23001043,2,0,4,-4,0
202504,23068000,2,34,95,-61,0.36
202504,23068000,2R2,0,4,-4,0
202504,23068000,3,0,16,-16,0
202504,23068000,3S2,3,3,0,1
202504,23068000,3S3,3,31,-28,0.1
202504,23068000,CA,0,13,-13,0
202504,23068012,3S3,0,1,-1,0
202504,23068014,2,4,6,-2,0.67
202504,23079000,2,40,39,1,1.03
202504,23079000,2R2,0,2,-2,0
202504,23079000,2S2,0,1,-1,0
202504,23079000,3S2,3,1,2,3
202504,23079000,3S3,9,49,-40,0.18
202504,23079000,CA,0,2,-2,0
202504,23079007,2,1,1,0,1
202504,23079012,2S2,0,1,-1,0
202504,23090000,2,4,22,-18,0.18
202504,23090000,2S2,1,0,1,NA
202504,23090000,3,2,1,1,2
202504,23090000,3S2,2,1,1,2
202504,23090000,CA,0,4,-4,0
202504,23090002,2S3,0,1,-1,0
202504,23090002,CA,0,1,-1,0
202504,23090020,3R3,4,0,4,NA
202504,23090020,3S2,5,0,5,NA
202504,23090020,3S3,276,0,276,NA
202504,23090022,3S2,1,0,1,NA
202504,23090022,3S3,108,0,108,NA
202504,23162000,2,1209,1208,1,1
202504,23162000,2R2,356,0,356,NA
202504,23162000,2S2,2,48,-46,0.04
202504,23162000,2S3,14,14,0,1
202504,23162000,3,48,83,-35,0.58
202504,23162000,3S2,9,137,-128,0.07
202504,23162000,3S3,331,1012,-681,0.33
202504,23162000,3S4,0,3,-3,0
202504,23162000,CA,85,169,-84,0.5
202504,23162000,V2,1,0,1,NA
202504,23162002,3,0,7,-7,0
202504,23162003,2,0,4,-4,0
202504,23162004,2,0,1,-1,0
202504,23168000,2,2,3,-1,0.67
202504,23168000,3,0,2,-2,0
202504,23168000,3S2,0,1,-1,0
202504,23168000,CA,0,4,-4,0
202504,23168001,3,0,1,-1,0
202504,23168016,2,1,0,1,NA
202504,23182000,2,26,145,-119,0.18
202504,23182000,2R2,0,1,-1,0
202504,23182000,3,0,17,-17,0
202504,23182000,3S1,1,0,1,NA
202504,23182000,3S3,10,7,3,1.43
202504,23182000,3S4,1,1,0,1
202504,23182000,CA,1,16,-15,0.06
202504,23182000,V3,1,0,1,NA
202504,23182020,2S2,0,2,-2,0
202504,23182026,3,0,1,-1,0
202504,23189000,2,1278,627,651,2.04
202504,23189000,2R2,0,6,-6,0
202504,23189000,2S2,1,3,-2,0.33
202504,23189000,2S3,0,3,-3,0
202504,23189000,3,45,36,9,1.25
202504,23189000,3S2,131,112,19,1.17
202504,23189000,3S3,218,651,-433,0.33
202504,23189000,3S4,6,0,6,NA
202504,23189000,CA,3,31,-28,0.1
202504,23189000,V3,1,3,-2,0.33
202504,23189001,2,1,0,1,NA
202504,23300000,2,1,37,-36,0.03
202504,23300000,2R2,0,5,-5,0
202504,23300000,3,0,2,-2,0
202504,23300000,3S3,1,6,-5,0.17
202504,23300000,CA,1,4,-3,0.25
202504,23350000,2,11,27,-16,0.41
202504,23350000,2S2,2,1,1,2
202504,23350000,3S2,10,2,8,5
202504,23350000,3S3,0,38,-38,0
202504,23350000,CA,0,6,-6,0
202504,23350004,3S2,1,0,1,NA
202504,23350004,3S3,1,0,1,NA
202504,23417000,2,18,500,-482,0.04
202504,23417000,2R2,0,7,-7,0
202504,23417000,2S2,0,1,-1,0
202504,23417000,2S3,0,1,-1,0
202504,23417000,3,0,32,-32,0
202504,23417000,3S2,3,13,-10,0.23
202504,23417000,3S3,19,98,-79,0.19
202504,23417000,3S4,0,4,-4,0
202504,23417000,CA,4,91,-87,0.04
202504,23417002,2,1,0,1,NA
202504,23417003,2,1,0,1,NA
202504,23417004,2,0,4,-4,0
202504,23417006,2,0,3,-3,0
202504,23417006,3,0,2,-2,0
202504,23417007,2,0,1,-1,0
202504,23417008,2,0,3,-3,0
202504,23417010,2,1,10,-9,0.1
202504,23417010,CA,0,1,-1,0
202504,23417016,2,9,2,7,4.5
202504,23417016,3,0,14,-14,0
202504,23417016,3S3,12,1,11,12
202504,23417024,2,0,3,-3,0
202504,23417034,3,0,1,-1,0
202504,23417036,2,0,1,-1,0
202504,23417036,3S3,0,7,-7,0
202504,23419000,2,12,26,-14,0.46
202504,23419000,3,0,1,-1,0
202504,23419000,3S3,0,1,-1,0
202504,23419000,CA,0,1,-1,0
202504,23419011,2,0,1,-1,0
202504,23464000,2,6,27,-21,0.22
202504,23464000,2R2,0,1,-1,0
202504,23464000,2S2,0,3,-3,0
202504,23464000,3S2,1,1,0,1
202504,23464000,3S3,0,8,-8,0
202504,23464000,CA,0,5,-5,0
202504,23464001,2,0,7,-7,0
202504,23464001,2S3,0,7,-7,0
202504,23466000,2,51,338,-287,0.15
202504,23466000,2R2,0,8,-8,0
202504,23466000,2S2,1,0,1,NA
202504,23466000,2S3,0,2,-2,0
202504,23466000,3,1,19,-18,0.05
202504,23466000,3S2,5,13,-8,0.38
202504,23466000,3S3,535,2275,-1740,0.24
202504,23466000,3S4,0,2,-2,0
202504,23466000,CA,5,72,-67,0.07
202504,23466000,V4,32,0,32,NA
202504,23466001,2,0,1,-1,0
202504,23466001,3,0,4,-4,0
202504,23466006,2,0,1,-1,0
202504,23466006,3S3,16,0,16,NA
202504,23466007,3,0,1,-1,0
202504,23466007,CA,0,1,-1,0
202504,23466026,2,0,1,-1,0
202504,23500000,2,6,62,-56,0.1
202504,23500000,2R2,0,1,-1,0
202504,23500000,3,0,21,-21,0
202504,23500000,3S3,2,6,-4,0.33
202504,23500000,CA,0,9,-9,0
202504,23555000,2,90,394,-304,0.23
202504,23555000,2R2,0,3,-3,0
202504,23555000,2S2,4,2,2,2
202504,23555000,2S3,1,0,1,NA
202504,23555000,3,31,24,7,1.29
202504,23555000,3S2,8,30,-22,0.27
202504,23555000,3S3,1701,242,1459,7.03
202504,23555000,CA,11,35,-24,0.31
202504,23555000,V3,0,1,-1,0
202504,23555011,2,0,5,-5,0
202504,23555011,CA,0,1,-1,0
202504,23555022,2,0,7,-7,0
202504,23570000,2,42,112,-70,0.38
202504,23570000,2R2,0,1,-1,0
202504,23570000,2S2,1,1,0,1
202504,23570000,2S3,3,1,2,3
202504,23570000,3,8,14,-6,0.57
202504,23570000,3S1,5,1,4,5
202504,23570000,3S2,17,5,12,3.4
202504,23570000,3S3,17,10,7,1.7
202504,23570000,CA,1,12,-11,0.08
202504,23570011,2,1,66,-65,0.02
202504,23570011,2S2,0,70,-70,0
202504,23570011,2S3,0,5,-5,0
202504,23570011,3,0,1,-1,0
202504,23570011,3S3,0,2,-2,0
202504,23570011,CA,0,3,-3,0
202504,23570013,2,105,10,95,10.5
202504,23570013,3,41,1,40,41
202504,23570013,3S2,0,1,-1,0
202504,23570013,3S3,0,8,-8,0
202504,23570013,CA,3,0,3,NA
202504,23574000,2,8,14,-6,0.57
202504,23574000,3,1,1,0,1
202504,23574000,3S2,0,2,-2,0
202504,23574000,3S3,0,6,-6,0
202504,23574000,CA,0,11,-11,0
202504,23580000,2,26,110,-84,0.24
202504,23580000,2R2,0,7,-7,0
202504,23580000,3,1,33,-32,0.03
202504,23580000,3R3,0,2,-2,0
202504,23580000,3S2,122,8,114,15.25
202504,23580000,3S3,2153,488,1665,4.41
202504,23580000,3S4,1,1,0,1
202504,23580000,CA,0,12,-12,0
202504,23580000,V3,1,0,1,NA
202504,23580004,3,0,1,-1,0
202504,23580006,3S3,29,0,29,NA
202504,23580015,3,0,1,-1,0
202504,23586000,2,0,8,-8,0
202504,23586000,3,0,2,-2,0
202504,23660000,2,131,309,-178,0.42
202504,23660000,2R2,0,5,-5,0
202504,23660000,2S3,0,2,-2,0
202504,23660000,3,55,25,30,2.2
202504,23660000,3S1,0,6,-6,0
202504,23660000,3S2,2,6,-4,0.33
202504,23660000,3S3,526,161,365,3.27
202504,23660000,3S4,4,4,0,1
202504,23660000,CA,8,65,-57,0.12
202504,23660004,2,0,3,-3,0
202504,23660005,2,0,2,-2,0
202504,23660005,3,0,2,-2,0
202504,23660005,3S2,0,2,-2,0
202504,23660005,3S3,0,3,-3,0
202504,23660005,4,0,3,-3,0
202504,23660005,CA,1,0,1,NA
202504,23660006,2,2,0,2,NA
202504,23660006,3,0,1,-1,0
202504,23660006,CA,0,1,-1,0
202504,23660008,2,1,4,-3,0.25
202504,23660008,3S3,1,22,-21,0.05
202504,23660008,3S4,1,0,1,NA
202504,23660015,2,1,0,1,NA
202504,23670000,2,2,80,-78,0.03
202504,23670000,2R2,0,2,-2,0
202504,23670000,3S2,0,1,-1,0
202504,23670000,3S3,2,1,1,2
202504,23670000,CA,0,4,-4,0
202504,23670011,2,0,12,-12,0
202504,23670011,CA,0,4,-4,0
202504,23670024,2,0,1,-1,0
202504,23670024,3S3,0,1,-1,0
202504,23672000,2,3,53,-50,0.06
202504,23672000,3,0,9,-9,0
202504,23672000,3S2,0,1,-1,0
202504,23672000,CA,1,15,-14,0.07
202504,23675000,2,11,77,-66,0.14
202504,23675000,2S2,1,0,1,NA
202504,23675000,3,0,26,-26,0
202504,23675000,3S3,0,11,-11,0
202504,23675000,CA,0,3,-3,0
202504,23675000,V2,1,1,0,1
202504,23675001,3,0,8,-8,0
202504,23675018,2,0,1,-1,0
202504,23675019,2,0,1,-1,0
202504,23675019,3,0,1,-1,0
202504,23678000,2,12,50,-38,0.24
202504,23678000,2S2,0,1,-1,0
202504,23678000,3,1,3,-2,0.33
202504,23678000,3S2,2,0,2,NA
202504,23678000,3S3,0,1,-1,0
202504,23678002,3,1,1,0,1
202504,23678004,2,0,1,-1,0
202504,23678008,2,0,1,-1,0
202504,23678014,2,0,2,-2,0
202504,23682000,2,5,7,-2,0.71
202504,23682000,2S2,0,1,-1,0
202504,23682000,2S3,2,0,2,NA
202504,23682000,3,0,5,-5,0
202504,23682000,3S3,0,1,-1,0
202504,23686000,2,28,45,-17,0.62
202504,23686000,2R2,0,4,-4,0
202504,23686000,2S2,2,3,-1,0.67
202504,23686000,3,1,3,-2,0.33
202504,23686000,3S2,2,0,2,NA
202504,23686000,3S3,0,4,-4,0
202504,23686000,3S4,1,1,0,1
202504,23686000,CA,0,5,-5,0
202504,23686002,2,1,0,1,NA
202504,23686003,2,0,1,-1,0
202504,23686003,3S2,1,1,0,1
202504,23686004,2,0,2,-2,0
202504,23686009,2,0,1,-1,0
202504,23686022,2,0,2,-2,0
202504,23686024,2S3,0,1,-1,0
202504,23686024,3S1,0,1,-1,0
202504,23807000,2,61,349,-288,0.17
202504,23807000,2R2,0,3,-3,0
202504,23807000,2S2,3,0,3,NA
202504,23807000,2S3,1,1,0,1
202504,23807000,3,1,25,-24,0.04
202504,23807000,3R3,3,0,3,NA
202504,23807000,3S2,11,5,6,2.2
202504,23807000,3S3,378,49,329,7.71
202504,23807000,3S4,1,0,1,NA
202504,23807000,CA,1,66,-65,0.02
202504,23807000,V3,1,0,1,NA
202504,23807012,2,0,1,-1,0
202504,23807012,3S3,2,0,2,NA
202504,23807027,2,0,21,-21,0
202504,23807027,3S2,1,0,1,NA
202504,23807027,3S3,1,35,-34,0.03
202504,23807027,CA,0,3,-3,0
202504,23807033,2,0,10,-10,0
202504,23807033,CA,0,1,-1,0
202504,23815000,2,0,14,-14,0
202504,23815000,2S2,0,1,-1,0
202504,23815000,3S2,0,1,-1,0
202504,23815000,CA,2,0,2,NA
202504,23855000,2,14,80,-66,0.17
202504,23855000,2R2,0,2,-2,0
202504,23855000,2S2,5,0,5,NA
202504,23855000,3,8,3,5,2.67
202504,23855000,3S2,5,0,5,NA
202504,23855000,3S3,1,19,-18,0.05
202504,23855000,CA,0,9,-9,0
202504,23855001,3,0,1,-1,0
202504,23855013,3,0,8,-8,0
202504,23855019,2,0,1,-1,0
202504,25001000,2,2,99,-97,0.02
202504,25001000,3S3,0,15,-15,0
202504,25001000,CA,0,75,-75,0
202504,25019000,2,29,121,-92,0.24
202504,25019000,3,6,14,-8,0.43
202504,25019000,3S2,7,16,-9,0.44
202504,25019000,3S3,1,11,-10,0.09
202504,25019000,CA,0,9,-9,0
202504,25035000,2,12,262,-250,0.05
202504,25035000,3,1,1,0,1
202504,25035000,3S2,0,1,-1,0
202504,25035000,3S3,0,43,-43,0
202504,25035000,CA,1,121,-120,0.01
202504,25035001,2,0,1,-1,0
202504,25040000,2,14,93,-79,0.15
202504,25040000,3,0,1,-1,0
202504,25040000,3S3,0,4,-4,0
202504,25040000,CA,2,66,-64,0.03
202504,25040000,V2,0,2,-2,0
202504,25040002,2,0,2,-2,0
202504,25053000,2,2,366,-364,0.01
202504,25053000,3,0,1,-1,0
202504,25053000,CA,0,47,-47,0
202504,25053000,V2,0,1,-1,0
202504,25086000,2,0,5,-5,0
202504,25086000,CA,0,11,-11,0
202504,25095000,2,0,19,-19,0
202504,25095000,3,0,1,-1,0
202504,25095000,3S3,1,0,1,NA
202504,25095000,CA,0,1,-1,0
202504,25099000,2,92,197,-105,0.47
202504,25099000,2S2,8,0,8,NA
202504,25099000,2S3,1,0,1,NA
202504,25099000,3,9,12,-3,0.75
202504,25099000,3S2,6,2,4,3
202504,25099000,3S3,6,13,-7,0.46
202504,25099000,4,1,0,1,NA
202504,25099000,CA,116,87,29,1.33
202504,25120000,2,2,28,-26,0.07
202504,25120000,3,0,1,-1,0
202504,25120000,CA,0,21,-21,0
202504,25120003,2,0,1,-1,0
202504,25123000,2,9,67,-58,0.13
202504,25123000,3,0,6,-6,0
202504,25123000,CA,0,52,-52,0
202504,25123000,V3,0,1,-1,0
202504,25126000,2,3086,1819,1267,1.7
202504,25126000,2B1,2,0,2,NA
202504,25126000,2R2,2,0,2,NA
202504,25126000,2S2,430,182,248,2.36
202504,25126000,2S3,119,52,67,2.29
202504,25126000,3,58,145,-87,0.4
202504,25126000,3S2,911,485,426,1.88
202504,25126000,3S3,1322,626,696,2.11
202504,25126000,3S4,0,1,-1,0
202504,25126000,4,6,6,0,1
202504,25126000,CA,1179,1138,41,1.04
202504,25126000,V2,2,0,2,NA
202504,25126000,V3,176,49,127,3.59
202504,25126008,CA,0,1,-1,0
202504,25126009,2,0,3,-3,0
202504,25126011,CA,0,1,-1,0
202504,25148000,2,0,40,-40,0
202504,25148000,3,0,1,-1,0
202504,25148000,CA,2,19,-17,0.11
202504,25148005,2,0,4,-4,0
202504,25148005,2S3,0,1,-1,0
202504,25151000,2,16,99,-83,0.16
202504,25151000,2S2,1,0,1,NA
202504,25151000,2S3,2,20,-18,0.1
202504,25151000,3,0,9,-9,0
202504,25151000,3S2,1,4,-3,0.25
202504,25151000,3S3,13,331,-318,0.04
202504,25151000,3S4,1,0,1,NA
202504,25151000,4,0,1,-1,0
202504,25151000,CA,4,104,-100,0.04
202504,25154000,2,1,25,-24,0.04
202504,25154000,CA,0,30,-30,0
202504,25168000,2,0,6,-6,0
202504,25168000,CA,0,1,-1,0
202504,25175000,2,785,2586,-1801,0.3
202504,25175000,2S2,71,201,-130,0.35
202504,25175000,2S3,30,83,-53,0.36
202504,25175000,3,19,123,-104,0.15
202504,25175000,3S2,198,132,66,1.5
202504,25175000,3S3,213,428,-215,0.5
202504,25175000,3S4,3,3,0,1
202504,25175000,4,1,2,-1,0.5
202504,25175000,CA,500,2231,-1731,0.22
202504,25175000,V2,1,6,-5,0.17
202504,25175002,2S3,0,1,-1,0
202504,25175004,2S3,0,2,-2,0
202504,25175004,3S3,0,1,-1,0
202504,25178000,2,9,67,-58,0.13
202504,25178000,3,0,3,-3,0
202504,25178000,3S3,0,16,-16,0
202504,25178000,CA,0,15,-15,0
202504,25181000,2,2,134,-132,0.01
202504,25181000,3,0,22,-22,0
202504,25181000,CA,0,64,-64,0
202504,25181000,V2,0,5,-5,0
202504,25181000,V3,0,8,-8,0
202504,25183000,2,17,134,-117,0.13
202504,25183000,2S2,0,2,-2,0
202504,25183000,2S3,0,8,-8,0
202504,25183000,3,1,13,-12,0.08
202504,25183000,3S2,0,2,-2,0
202504,25183000,3S3,19,16,3,1.19
202504,25183000,CA,4,82,-78,0.05
202504,25183000,V2,0,5,-5,0
202504,25183000,V3,0,8,-8,0
202504,25183001,2,0,29,-29,0
202504,25200000,2,302,339,-37,0.89
202504,25200000,2S1,13,2,11,6.5
202504,25200000,2S2,430,64,366,6.72
202504,25200000,2S3,686,26,660,26.38
202504,25200000,3,16,13,3,1.23
202504,25200000,3S2,209,36,173,5.81
202504,25200000,3S3,905,567,338,1.6
202504,25200000,CA,57,157,-100,0.36
202504,25200000,V2,0,11,-11,0
202504,25200000,V3,0,23,-23,0
202504,25200000,V4,0,14,-14,0
202504,25200010,2,0,1,-1,0
202504,25200010,3,1,0,1,NA
202504,25200010,3S2,1,0,1,NA
202504,25200010,3S3,10,0,10,NA
202504,25200010,V2,2,0,2,NA
202504,25200010,V3,15,0,15,NA
202504,25214000,2,20917,6893,14024,3.03
202504,25214000,2B1,11,3,8,3.67
202504,25214000,2R2,60,12,48,5
202504,25214000,2S1,3,0,3,NA
202504,25214000,2S2,941,1849,-908,0.51
202504,25214000,2S3,396,476,-80,0.83
202504,25214000,3,343,176,167,1.95
202504,25214000,3S1,2,1,1,2
202504,25214000,3S2,1285,1092,193,1.18
202504,25214000,3S3,1330,3241,-1911,0.41
202504,25214000,3S4,4,11,-7,0.36
202504,25214000,4,1,5,-4,0.2
202504,25214000,CA,12118,2312,9806,5.24
202504,25214000,V2,1,1,0,1
202504,25214000,V3,0,21,-21,0
202504,25214008,2,610,701,-91,0.87
202504,25214008,2S2,96,65,31,1.48
202504,25214008,2S3,60,19,41,3.16
202504,25214008,3,16,7,9,2.29
202504,25214008,3S2,48,21,27,2.29
202504,25214008,3S3,259,94,165,2.76
202504,25214008,3S4,71,2,69,35.5
202504,25214008,4,3,2,1,1.5
202504,25214008,CA,299,483,-184,0.62
202504,25224000,2,0,20,-20,0
202504,25224000,3,7,2,5,3.5
202504,25224000,3S3,1004,99,905,10.14
202504,25224000,4,6,3,3,2
202504,25224000,CA,0,17,-17,0
202504,25224000,V2,4,4,0,1
202504,25224000,V3,107,63,44,1.7
202504,25224000,V3R2,2,0,2,NA
202504,25224000,V4,79,65,14,1.22
202504,25224000,V4R2,1,1,0,1
202504,25245000,2,8,166,-158,0.05
202504,25245000,2S2,5,15,-10,0.33
202504,25245000,2S3,4,5,-1,0.8
202504,25245000,3,1,14,-13,0.07
202504,25245000,3S3,0,18,-18,0
202504,25245000,CA,1,110,-109,0.01
202504,25245000,V2,0,2,-2,0
202504,25245002,CA,0,2,-2,0
202504,25258000,2,0,2,-2,0
202504,25258000,CA,0,1,-1,0
202504,25260000,2,833,1733,-900,0.48
202504,25260000,2S2,82,29,53,2.83
202504,25260000,2S3,26,12,14,2.17
202504,25260000,3,14,42,-28,0.33
202504,25260000,3S2,17,153,-136,0.11
202504,25260000,3S3,10,381,-371,0.03
202504,25260000,3S4,1,0,1,NA
202504,25260000,4,6,0,6,NA
202504,25260000,CA,85,338,-253,0.25
202504,25260000,V2,0,22,-22,0
202504,25260000,V3,0,39,-39,0
202504,25269000,2,1154,2674,-1520,0.43
202504,25269000,2S2,182,26,156,7
202504,25269000,2S3,232,27,205,8.59
202504,25269000,3,597,41,556,14.56
202504,25269000,3S2,1230,265,965,4.64
202504,25269000,3S3,3824,2517,1307,1.52
202504,25269000,4,33,0,33,NA
202504,25269000,CA,127,2013,-1886,0.06
202504,25269000,V2,0,1,-1,0
202504,25269000,V3,0,8,-8,0
202504,25269001,CA,0,1,-1,0
202504,25269007,3S3,4,0,4,NA
202504,25269009,2,0,1,-1,0
202504,25269009,3S3,0,19,-19,0
202504,25279000,2,3,62,-59,0.05
202504,25279000,3,1,11,-10,0.09
202504,25279000,3S3,0,91,-91,0
202504,25279000,CA,1,55,-54,0.02
202504,25279000,V3,0,3,-3,0
202504,25281000,2,0,17,-17,0
202504,25281000,3S3,0,3,-3,0
202504,25281000,CA,0,11,-11,0
202504,25286000,2,33419,13078,20341,2.56
202504,25286000,2B1,0,3,-3,0
202504,25286000,2R2,57,7,50,8.14
202504,25286000,2R3,0,1,-1,0
202504,25286000,2S1,1,24,-23,0.04
202504,25286000,2S2,4578,3885,693,1.18
202504,25286000,2S3,754,992,-238,0.76
202504,25286000,3,350,204,146,1.72
202504,25286000,3S1,6,3,3,2
202504,25286000,3S2,1453,1974,-521,0.74
202504,25286000,3S3,2865,6629,-3764,0.43
202504,25286000,3S4,2,8,-6,0.25
202504,25286000,4,0,58,-58,0
202504,25286000,CA,29682,3257,26425,9.11
202504,25286000,V2,44,9,35,4.89
202504,25286000,V4,0,1,-1,0
202504,25288000,2,3,45,-42,0.07
202504,25288000,2S2,15,15,0,1
202504,25288000,2S3,5,0,5,NA
202504,25288000,3,3,0,3,NA
202504,25288000,3S2,120,22,98,5.45
202504,25288000,3S3,84,2,82,42
202504,25288000,CA,9,20,-11,0.45
202504,25288000,V2,0,1,-1,0
202504,25288001,2,0,4,-4,0
202504,25288001,CA,0,1,-1,0
202504,25290000,2,171,1647,-1476,0.1
202504,25290000,2R2,0,1,-1,0
202504,25290000,2S2,4,5,-1,0.8
202504,25290000,2S3,2,2,0,1
202504,25290000,3,7,73,-66,0.1
202504,25290000,3S2,5,54,-49,0.09
202504,25290000,3S2S3,1,1,0,1
202504,25290000,3S3,8,388,-380,0.02
202504,25290000,4,0,3,-3,0
202504,25290000,CA,120,571,-451,0.21
202504,25290000,V2,0,24,-24,0
202504,25290011,2,3,2,1,1.5
202504,25290011,CA,1,4,-3,0.25
202504,25290012,3S3,0,30,-30,0
202504,25293000,2,0,2,-2,0
202504,25293000,3,0,5,-5,0
202504,25293000,CA,0,55,-55,0
202504,25295000,2,2722,1152,1570,2.36
202504,25295000,2B1,3,2,1,1.5
202504,25295000,2S1,0,1,-1,0
202504,25295000,2S2,207,439,-232,0.47
202504,25295000,2S3,38,153,-115,0.25
202504,25295000,3,85,135,-50,0.63
202504,25295000,3S2,61,230,-169,0.27
202504,25295000,3S3,253,578,-325,0.44
202504,25295000,3S4,4,5,-1,0.8
202504,25295000,4,5,0,5,NA
202504,25295000,CA,34,321,-287,0.11
202504,25295000,V2,3,7,-4,0.43
202504,25295000,V3,18,7,11,2.57
202504,25295005,2,349,1,348,349
202504,25297000,2,1,37,-36,0.03
202504,25297000,3,0,9,-9,0
202504,25297000,3S3,2,3,-1,0.67
202504,25297000,CA,1,64,-63,0.02
202504,25297000,V3,0,2,-2,0
202504,25299000,2,0,5,-5,0
202504,25299000,3,0,1,-1,0
202504,25299000,CA,0,4,-4,0
202504,25307000,2,397,1806,-1409,0.22
202504,25307000,2R2,0,13,-13,0
202504,25307000,2S2,1,17,-16,0.06
202504,25307000,2S3,1,4,-3,0.25
202504,25307000,3,25,52,-27,0.48
202504,25307000,3S2,2,21,-19,0.1
202504,25307000,3S3,324,543,-219,0.6
202504,25307000,3S4,1,0,1,NA
202504,25307000,4,0,4,-4,0
202504,25307000,CA,358,593,-235,0.6
202504,25307000,V3,0,2,-2,0
202504,25312000,2,2,75,-73,0.03
202504,25312000,2S2,0,2,-2,0
202504,25312000,2S3,0,4,-4,0
202504,25312000,3S2,9,7,2,1.29
202504,25312000,3S3,2,6,-4,0.33
202504,25312000,3S4,3,0,3,NA
202504,25312000,CA,1,20,-19,0.05
202504,25312000,V2,0,1,-1,0
202504,25312013,2,1,1,0,1
202504,25317000,2,1,44,-43,0.02
202504,25317000,2S2,22,0,22,NA
202504,25317000,2S3,6,0,6,NA
202504,25317000,3,0,2,-2,0
202504,25317000,3S2,3,0,3,NA
202504,25317000,3S3,1777,79,1698,22.49
202504,25317000,4,7,0,7,NA
202504,25317000,CA,1,48,-47,0.02
202504,25317000,V2,39,27,12,1.44
202504,25317000,V3,225,227,-2,0.99
202504,25317000,V4,214,234,-20,0.91
202504,25317005,2,0,1,-1,0
202504,25320000,2,156,505,-349,0.31
202504,25320000,2S2,0,5,-5,0
202504,25320000,2S3,2,11,-9,0.18
202504,25320000,3,1,15,-14,0.07
202504,25320000,3S2,3,684,-681,0
202504,25320000,3S3,20,1070,-1050,0.02
202504,25320000,CA,2,173,-171,0.01
202504,25320000,V3,0,1,-1,0
202504,25320003,CA,0,1,-1,0
202504,25322000,2,11,248,-237,0.04
202504,25322000,2S2,0,1,-1,0
202504,25322000,3,56,2,54,28
202504,25322000,3S2,30,0,30,NA
202504,25322000,3S3,28,8,20,3.5
202504,25322000,CA,0,252,-252,0
202504,25322000,V2,0,5,-5,0
202504,25322000,V3,165,5,160,33
202504,25324000,2,1,9,-8,0.11
202504,25324000,3S2,1,8,-7,0.12
202504,25324000,3S3,2,0,2,NA
202504,25324000,CA,0,8,-8,0
202504,25326000,2,4,32,-28,0.12
202504,25326000,3S3,1,5,-4,0.2
202504,25326000,CA,1,15,-14,0.07
202504,25328000,2,1,34,-33,0.03
202504,25328000,3,0,10,-10,0
202504,25328000,3S2,1,0,1,NA
202504,25328000,3S3,2,14,-12,0.14
202504,25328000,CA,0,6,-6,0
202504,25328001,3S3,0,5,-5,0
202504,25335000,2,3,16,-13,0.19
202504,25335000,2S2,1,0,1,NA
202504,25335000,2S3,0,1,-1,0
202504,25335000,3,0,4,-4,0
202504,25335000,3S3,0,56,-56,0
202504,25335000,CA,6,27,-21,0.22
202504,25339000,CA,0,13,-13,0
202504,25368000,2,0,15,-15,0
202504,25368000,CA,0,6,-6,0
202504,25372000,2,1,2,-1,0.5
202504,25372000,CA,0,3,-3,0
202504,25377000,2,504,634,-130,0.79
202504,25377000,2S2,6,30,-24,0.2
202504,25377000,2S3,0,5,-5,0
202504,25377000,3,203,56,147,3.62
202504,25377000,3S2,20,11,9,1.82
202504,25377000,3S3,634,109,525,5.82
202504,25377000,CA,1,466,-465,0
202504,25377000,V2,2,1,1,2
202504,25377000,V3,128,1,127,128
202504,25377003,2,1,0,1,NA
202504,25377003,CA,0,1,-1,0
202504,25386000,2,10,513,-503,0.02
202504,25386000,3,1,8,-7,0.12
202504,25386000,3S2,2,4,-2,0.5
202504,25386000,3S3,0,126,-126,0
202504,25386000,CA,5,219,-214,0.02
202504,25386000,V2,0,1,-1,0
202504,25386001,2,0,6,-6,0
202504,25386002,2,0,1,-1,0
202504,25394000,2,0,8,-8,0
202504,25394000,3,0,1,-1,0
202504,25394000,3S2,1,0,1,NA
202504,25394000,3S3,1,0,1,NA
202504,25394000,CA,1,5,-4,0.2
202504,25398000,2,0,27,-27,0
202504,25398000,CA,0,15,-15,0
202504,25402000,2,11,261,-250,0.04
202504,25402000,2S3,0,6,-6,0
202504,25402000,3,0,25,-25,0
202504,25402000,3S3,1,14,-13,0.07
202504,25402000,4,0,1,-1,0
202504,25402000,CA,1,90,-89,0.01
202504,25407000,2,6,64,-58,0.09
202504,25407000,3,0,6,-6,0
202504,25407000,3S2,1,12,-11,0.08
202504,25407000,3S3,672,280,392,2.4
202504,25407000,4,8,10,-2,0.8
202504,25407000,CA,1,37,-36,0.03
202504,25407000,V2,27,39,-12,0.69
202504,25407000,V3,176,224,-48,0.79
202504,25407000,V4,132,97,35,1.36
202504,25426000,2,1,53,-52,0.02
202504,25426000,3S3,0,2,-2,0
202504,25426000,CA,0,11,-11,0
202504,25430000,2,5848,2973,2875,1.97
202504,25430000,2B1,5,10,-5,0.5
202504,25430000,2R2,2,7,-5,0.29
202504,25430000,2S1,1,0,1,NA
202504,25430000,2S2,1247,720,527,1.73
202504,25430000,2S3,272,147,125,1.85
202504,25430000,3,334,171,163,1.95
202504,25430000,3S1,2,1,1,2
202504,25430000,3S2,267,472,-205,0.57
202504,25430000,3S3,1379,2003,-624,0.69
202504,25430000,4,9,9,0,1
202504,25430000,CA,1475,1393,82,1.06
202504,25430000,V2,1,5,-4,0.2
202504,25430000,V3,15,503,-488,0.03
202504,25430000,V4,4,174,-170,0.02
202504,25430003,3S3,0,6,-6,0
202504,25430004,2,2,3,-1,0.67
202504,25430004,2S2,52,0,52,NA
202504,25430004,2S3,2,0,2,NA
202504,25430004,3S3,3,0,3,NA
202504,25430004,CA,6,0,6,NA
202504,25436000,2,0,15,-15,0
202504,25436000,3,1,13,-12,0.08
202504,25436000,CA,0,13,-13,0
202504,25436000,V3,0,1,-1,0
202504,25438000,2,10,23,-13,0.43
202504,25438000,2S3,0,1,-1,0
202504,25438000,3,0,4,-4,0
202504,25438000,3S2,0,1,-1,0
202504,25438000,3S3,2,2,0,1
202504,25438000,CA,1,8,-7,0.12
202504,25473000,2,18140,4656,13484,3.9
202504,25473000,2B1,2,1,1,2
202504,25473000,2R2,13,1,12,13
202504,25473000,2S2,1066,891,175,1.2
202504,25473000,2S3,266,155,111,1.72
202504,25473000,3,167,295,-128,0.57
202504,25473000,3S1,2,0,2,NA
202504,25473000,3S2,833,410,423,2.03
202504,25473000,3S3,1121,3739,-2618,0.3
202504,25473000,3S4,12,17,-5,0.71
202504,25473000,4,57,33,24,1.73
202504,25473000,CA,7876,1899,5977,4.15
202504,25473000,V2,21,50,-29,0.42
202504,25473000,V3,143,110,33,1.3
202504,25473000,V4,3,502,-499,0.01
202504,25473004,2,1,5,-4,0.2
202504,25473004,3S2,0,1,-1,0
202504,25483000,2,6,6,0,1
202504,25483000,3S2,0,1,-1,0
202504,25483000,3S3,1,0,1,NA
202504,25483000,CA,0,16,-16,0
202504,25486000,2,79,280,-201,0.28
202504,25486000,2S2,7,3,4,2.33
202504,25486000,2S3,5,0,5,NA
202504,25486000,3,84,2,82,42
202504,25486000,3S2,8,4,4,2
202504,25486000,3S3,600,15,585,40
202504,25486000,CA,2,193,-191,0.01
202504,25486000,V2,1,5,-4,0.2
202504,25486000,V3,1295,47,1248,27.55
202504,25486000,V4,272,1,271,272
202504,25486005,3S3,17,0,17,NA
202504,25488000,2,9,136,-127,0.07
202504,25488000,2S2,0,1,-1,0
202504,25488000,2S3,0,1,-1,0
202504,25488000,3,0,10,-10,0
202504,25488000,3S2,0,1,-1,0
202504,25488000,3S3,0,4,-4,0
202504,25488000,3S4,0,1,-1,0
202504,25488000,CA,1,44,-43,0.02
202504,25488000,V2,0,4,-4,0
202504,25488001,2,0,1,-1,0
202504,25488002,2,0,1,-1,0
202504,25489000,2,0,40,-40,0
202504,25489000,CA,2,6,-4,0.33
202504,25489001,2,1,11,-10,0.09
202504,25489001,CA,0,1,-1,0
202504,25491000,2,0,33,-33,0
202504,25491000,CA,1,14,-13,0.07
202504,25506000,2,0,12,-12,0
202504,25506000,CA,0,1,-1,0
202504,25513000,2,13,146,-133,0.09
202504,25513000,2S3,0,1,-1,0
202504,25513000,3,1,9,-8,0.11
202504,25513000,3S3,1,9,-8,0.11
202504,25513000,CA,1,137,-136,0.01
202504,25513000,V3,0,11,-11,0
202504,25518000,2,0,4,-4,0
202504,25518004,2,0,6,-6,0
202504,25518004,CA,0,3,-3,0
202504,25524000,2,2,20,-18,0.1
202504,25524000,CA,0,11,-11,0
202504,25530000,2,6,37,-31,0.16
202504,25530000,2S2,0,1,-1,0
202504,25530000,2S3,0,1,-1,0
202504,25530000,3,6,28,-22,0.21
202504,25530000,3S2,2,7,-5,0.29
202504,25530000,3S3,2,31,-29,0.06
202504,25530000,CA,0,5,-5,0
202504,25530001,2,0,9,-9,0
202504,25530002,2S3,0,1,-1,0
202504,25535000,2,0,40,-40,0
202504,25535000,3,1,0,1,NA
202504,25535000,3S3,0,7,-7,0
202504,25535000,4,1,0,1,NA
202504,25535000,CA,0,27,-27,0
202504,25535000,V2,0,2,-2,0
202504,25572000,2,56,124,-68,0.45
202504,25572000,2R2,0,2,-2,0
202504,25572000,2S2,4,5,-1,0.8
202504,25572000,2S3,5,1,4,5
202504,25572000,3,1,1,0,1
202504,25572000,3S2,30,11,19,2.73
202504,25572000,3S3,166,125,41,1.33
202504,25572000,3S4,1,2,-1,0.5
202504,25572000,CA,6,59,-53,0.1
202504,25572000,V3,0,1,-1,0
202504,25572003,2,2,0,2,NA
202504,25572003,2S3,0,1,-1,0
202504,25572003,3S1,1,0,1,NA
202504,25580000,2,0,8,-8,0
202504,25580000,CA,0,2,-2,0
202504,25592000,2,0,13,-13,0
202504,25592000,3,0,3,-3,0
202504,25592000,CA,0,10,-10,0
202504,25592000,V2,0,3,-3,0
202504,25594000,2,1,8,-7,0.12
202504,25594000,3S3,0,15,-15,0
202504,25594000,CA,0,23,-23,0
202504,25594002,2,1,11,-10,0.09
202504,25594002,3S2,1,0,1,NA
202504,25594002,3S3,0,23,-23,0
202504,25594002,CA,0,19,-19,0
202504,25596000,2,0,13,-13,0
202504,25596000,CA,0,8,-8,0
202504,25599000,2,1,88,-87,0.01
202504,25599000,3,1,1,0,1
202504,25599000,3S2,0,5,-5,0
202504,25599000,3S3,0,3,-3,0
202504,25599000,CA,1,78,-77,0.01
202504,25599002,2,0,6,-6,0
202504,25612000,2,14,338,-324,0.04
202504,25612000,2R2,0,1,-1,0
202504,25612000,2S2,0,1,-1,0
202504,25612000,3,50,15,35,3.33
202504,25612000,3S2,9,1,8,9
202504,25612000,3S3,9,135,-126,0.07
202504,25612000,4,0,1,-1,0
202504,25612000,CA,2,195,-193,0.01
202504,25612000,V2,2,0,2,NA
202504,25612000,V3,30,0,30,NA
202504,25645000,2,1,56,-55,0.02
202504,25645000,3S3,0,3,-3,0
202504,25645000,CA,0,36,-36,0
202504,25649000,2,0,52,-52,0
202504,25649000,CA,4,26,-22,0.15
202504,25653000,2,2,0,2,NA
202504,25653000,CA,0,4,-4,0
202504,25658000,2,2,128,-126,0.02
202504,25658000,3,0,2,-2,0
202504,25658000,3S2,0,8,-8,0
202504,25658000,3S3,0,6,-6,0
202504,25658000,CA,2,50,-48,0.04
202504,25658000,V2,0,1,-1,0
202504,25662000,2,2,37,-35,0.05
202504,25662000,2S2,1,0,1,NA
202504,25662000,3,0,3,-3,0
202504,25662000,3S3,2,1,1,2
202504,25662000,CA,0,18,-18,0
202504,25662001,2,2,13,-11,0.15
202504,25662001,2S2,0,2,-2,0
202504,25662001,2S3,0,2,-2,0
202504,25662001,3,1,3,-2,0.33
202504,25662001,3S2,0,5,-5,0
202504,25662001,3S3,1,29,-28,0.03
202504,25662001,CA,1,13,-12,0.08
202504,25718000,2,25,253,-228,0.1
202504,25718000,3,25,0,25,NA
202504,25718000,3S3,1,0,1,NA
202504,25718000,CA,33,41,-8,0.8
202504,25718000,V2,0,3,-3,0
202504,25736000,2,670,351,319,1.91
202504,25736000,2S2,23,57,-34,0.4
202504,25736000,2S3,1,40,-39,0.03
202504,25736000,3,3,6,-3,0.5
202504,25736000,3S2,83,111,-28,0.75
202504,25736000,3S3,1008,468,540,2.15
202504,25736000,3S4,0,3,-3,0
202504,25736000,4,0,1,-1,0
202504,25736000,CA,144,125,19,1.15
202504,25736000,V2,99,0,99,NA
202504,25736000,V3,101,0,101,NA
202504,25740000,2,1376,1400,-24,0.98
202504,25740000,2S2,199,125,74,1.59
202504,25740000,2S3,11,27,-16,0.41
202504,25740000,3,40,72,-32,0.56
202504,25740000,3S2,126,177,-51,0.71
202504,25740000,3S3,1282,1363,-81,0.94
202504,25740000,CA,748,595,153,1.26
202504,25740000,V2,0,55,-55,0
202504,25740000,V3,1,0,1,NA
202504,25743000,2,7,317,-310,0.02
202504,25743000,2S2,3,0,3,NA
202504,25743000,2S3,7,1,6,7
202504,25743000,3,0,16,-16,0
202504,25743000,3S2,1,17,-16,0.06
202504,25743000,3S3,8,10,-2,0.8
202504,25743000,CA,3,84,-81,0.04
202504,25743000,V2,0,14,-14,0
202504,25743005,2,3,3,0,1
202504,25743005,2S2,4,0,4,NA
202504,25743005,3S2,6,1,5,6
202504,25745000,2,24,152,-128,0.16
202504,25745000,2S1,2,0,2,NA
202504,25745000,2S2,1,25,-24,0.04
202504,25745000,2S3,5,10,-5,0.5
202504,25745000,3,1,7,-6,0.14
202504,25745000,3S2,131,0,131,NA
202504,25745000,3S3,41,12,29,3.42
202504,25745000,CA,2,134,-132,0.01
202504,25754000,2,7280,4051,3229,1.8
202504,25754000,2B1,0,2,-2,0
202504,25754000,2S2,172,142,30,1.21
202504,25754000,2S3,80,42,38,1.9
202504,25754000,3,923,151,772,6.11
202504,25754000,3S2,40,341,-301,0.12
202504,25754000,3S3,3443,1374,2069,2.51
202504,25754000,3S4,1,1,0,1
202504,25754000,4,55,2,53,27.5
202504,25754000,CA,4356,2518,1838,1.73
202504,25754000,V2,69,3,66,23
202504,25754000,V3,147,26,121,5.65
202504,25754001,2,286,2,284,143
202504,25754001,2S2,117,1,116,117
202504,25754001,2S3,4,0,4,NA
202504,25754001,3S2,5,0,5,NA
202504,25754001,3S3,3,7,-4,0.43
202504,25754001,CA,58,0,58,NA
202504,25758000,2,919,1380,-461,0.67
202504,25758000,2S2,30,83,-53,0.36
202504,25758000,2S3,9,11,-2,0.82
202504,25758000,3,465,179,286,2.6
202504,25758000,3S2,427,49,378,8.71
202504,25758000,3S3,1408,230,1178,6.12
202504,25758000,4,16,5,11,3.2
202504,25758000,CA,81,437,-356,0.19
202504,25758000,V2,0,12,-12,0
202504,25758000,V3,8,2859,-2851,0
202504,25758000,V4,0,225,-225,0
202504,25758006,2,48,25,23,1.92
202504,25758006,2S2,2,25,-23,0.08
202504,25758006,2S3,4,5,-1,0.8
202504,25758006,3,2,0,2,NA
202504,25758006,3S2,19,0,19,NA
202504,25758006,3S3,1085,14,1071,77.5
202504,25758006,3S4,2,0,2,NA
202504,25758006,CA,1,11,-10,0.09
202504,25758006,V3,11,0,11,NA
202504,25758006,V4,1,0,1,NA
202504,25769000,2,70,458,-388,0.15
202504,25769000,2S2,3,1,2,3
202504,25769000,2S3,0,1,-1,0
202504,25769000,3S2,2,1,1,2
202504,25769000,3S3,0,13,-13,0
202504,25769000,CA,1,232,-231,0
202504,25769000,V2,0,2,-2,0
202504,25769002,3S3,0,1,-1,0
202504,25769002,CA,0,1,-1,0
202504,25772000,2,130,248,-118,0.52
202504,25772000,2S2,2,1,1,2
202504,25772000,2S3,8,3,5,2.67
202504,25772000,3,28,28,0,1
202504,25772000,3S2,8,3,5,2.67
202504,25772000,3S3,358,638,-280,0.56
202504,25772000,CA,1,173,-172,0.01
202504,25772000,V2,0,8,-8,0
202504,25772004,2,8,0,8,NA
202504,25777000,2,0,40,-40,0
202504,25777000,3,0,5,-5,0
202504,25777000,CA,0,32,-32,0
202504,25779000,2,1,41,-40,0.02
202504,25779000,3,0,1,-1,0
202504,25779000,3S3,0,1,-1,0
202504,25779000,CA,0,33,-33,0
202504,25781000,2,1,21,-20,0.05
202504,25781000,3,1,9,-8,0.11
202504,25781000,3S3,605,21,584,28.81
202504,25781000,CA,0,11,-11,0
202504,25781000,V3,21,42,-21,0.5
202504,25781000,V4,13,90,-77,0.14
202504,25785000,2,39,183,-144,0.21
202504,25785000,2S1,1,0,1,NA
202504,25785000,2S2,0,5,-5,0
202504,25785000,3,7,2,5,3.5
202504,25785000,3S3,10,11,-1,0.91
202504,25785000,CA,3,265,-262,0.01
202504,25785000,V2,0,10,-10,0
202504,25785000,V3,0,9,-9,0
202504,25793000,2,2,30,-28,0.07
202504,25793000,3,2,1,1,2
202504,25793000,3S2,1,2,-1,0.5
202504,25793000,3S3,886,30,856,29.53
202504,25793000,CA,1,10,-9,0.1
202504,25793000,V2,0,6,-6,0
202504,25793000,V3,103,47,56,2.19
202504,25793000,V4,11,3,8,3.67
202504,25793003,3S3,0,8,-8,0
202504,25797000,2,3,67,-64,0.04
202504,25797000,3,0,13,-13,0
202504,25797000,CA,0,15,-15,0
202504,25797001,2,2,1,1,2
202504,25797001,CA,0,6,-6,0
202504,25799000,2,13856,4546,9310,3.05
202504,25799000,2B1,0,1,-1,0
202504,25799000,2R2,30,2,28,15
202504,25799000,2R3,4,4,0,1
202504,25799000,2S2,1893,2066,-173,0.92
202504,25799000,2S3,262,193,69,1.36
202504,25799000,3,39,77,-38,0.51
202504,25799000,3S2,606,877,-271,0.69
202504,25799000,3S3,552,558,-6,0.99
202504,25799000,3S4,7,1,6,7
202504,25799000,4,1,2,-1,0.5
202504,25799000,CA,10124,1089,9035,9.3
202504,25799000,V2,0,4,-4,0
202504,25799000,V3,0,8,-8,0
202504,25799001,2,1,20,-19,0.05
202504,25799001,2S2,0,8,-8,0
202504,25799001,3,0,3,-3,0
202504,25799001,CA,1,2,-1,0.5
202504,25805000,2,0,24,-24,0
202504,25805000,3,1,0,1,NA
202504,25805000,CA,0,8,-8,0
202504,25807000,2,0,3,-3,0
202504,25807000,3,0,3,-3,0
202504,25807000,CA,0,2,-2,0
202504,25815000,2,8,129,-121,0.06
202504,25815000,2S2,1,0,1,NA
202504,25815000,2S3,1,1,0,1
202504,25815000,3S2,0,4,-4,0
202504,25815000,3S3,0,16,-16,0
202504,25815000,CA,2,68,-66,0.03
202504,25815001,2,0,1,-1,0
202504,25817000,2,9593,5011,4582,1.91
202504,25817000,2B1,2,6,-4,0.33
202504,25817000,2R2,16,1,15,16
202504,25817000,2S1,1,7,-6,0.14
202504,25817000,2S2,2675,1185,1490,2.26
202504,25817000,2S3,1396,713,683,1.96
202504,25817000,3,906,99,807,9.15
202504,25817000,3S1,0,7,-7,0
202504,25817000,3S2,1171,747,424,1.57
202504,25817000,3S3,7287,7294,-7,1
202504,25817000,3S4,14,21,-7,0.67
202504,25817000,4,12,5,7,2.4
202504,25817000,CA,3211,1560,1651,2.06
202504,25817000,V2,8,13,-5,0.62
202504,25817000,V3,0,48,-48,0
202504,25817000,V4,0,21,-21,0
202504,25817001,2,0,3,-3,0
202504,25817001,2S2,0,11,-11,0
202504,25817001,2S3,6,9,-3,0.67
202504,25817001,3S2,1,25,-24,0.04
202504,25817001,3S3,6,0,6,NA
202504,25817001,CA,0,2,-2,0
202504,25817002,2,5,4,1,1.25
202504,25817002,2S2,5,2,3,2.5
202504,25817002,2S3,0,3,-3,0
202504,25817002,3,2,0,2,NA
202504,25817002,3S3,13,14,-1,0.93
202504,25817002,CA,1,0,1,NA
202504,25817005,2,0,3,-3,0
202504,25817005,3,0,1,-1,0
202504,25817005,CA,0,1,-1,0
202504,25817006,2,0,1,-1,0
202504,25817014,2,0,2,-2,0
202504,25817014,3S3,145,52,93,2.79
202504,25817014,CA,2,0,2,NA
202504,25823000,2,1,11,-10,0.09
202504,25823000,CA,0,1,-1,0
202504,25839000,2,1,51,-50,0.02
202504,25839000,3,39,5,34,7.8
202504,25839000,3S2,1,0,1,NA
202504,25839000,CA,0,13,-13,0
202504,25839000,V3,1718,0,1718,NA
202504,25839003,2,2,6,-4,0.33
202504,25839003,CA,0,1,-1,0
202504,25841000,2,4,52,-48,0.08
202504,25841000,3,0,9,-9,0
202504,25841000,3S2,0,3,-3,0
202504,25841000,3S3,1,85,-84,0.01
202504,25841000,CA,0,12,-12,0
202504,25843000,2,90,494,-404,0.18
202504,25843000,2S2,0,1,-1,0
202504,25843000,2S3,4,10,-6,0.4
202504,25843000,3,44,33,11,1.33
202504,25843000,3S2,28,5,23,5.6
202504,25843000,3S3,145,153,-8,0.95
202504,25843000,4,0,12,-12,0
202504,25843000,CA,6,232,-226,0.03
202504,25843000,V2,0,60,-60,0
202504,25843000,V3,0,175,-175,0
202504,25843000,V4,0,55,-55,0
202504,25845000,2,0,10,-10,0
202504,25845000,3,0,3,-3,0
202504,25845000,3S2,10,0,10,NA
202504,25845000,3S3,4,8,-4,0.5
202504,25845000,CA,0,14,-14,0
202504,25851000,2,0,45,-45,0
202504,25851000,3,0,1,-1,0
202504,25851000,3S3,0,1,-1,0
202504,25851000,CA,0,58,-58,0
202504,25862000,2,1,22,-21,0.05
202504,25862000,3,1,1,0,1
202504,25862000,CA,2,7,-5,0.29
202504,25867000,2,0,17,-17,0
202504,25867000,2S2,0,1,-1,0
202504,25867000,CA,0,4,-4,0
202504,25871000,2,0,1,-1,0
202504,25871000,CA,0,1,-1,0
202504,25873000,2,6,138,-132,0.04
202504,25873000,3,0,6,-6,0
202504,25873000,3S2,5,0,5,NA
202504,25873000,3S3,223,59,164,3.78
202504,25873000,CA,6,135,-129,0.04
202504,25873000,V2,0,2,-2,0
202504,25875000,2,39,568,-529,0.07
202504,25875000,2S2,1,2,-1,0.5
202504,25875000,2S3,2,4,-2,0.5
202504,25875000,3,5,8,-3,0.62
202504,25875000,3S2,2,3,-1,0.67
202504,25875000,3S2S3,1,0,1,NA
202504,25875000,3S3,1,60,-59,0.02
202504,25875000,CA,6,237,-231,0.03
202504,25875000,V3,0,2,-2,0
202504,25878000,2,9,76,-67,0.12
202504,25878000,3,0,1,-1,0
202504,25878000,3S3,0,5,-5,0
202504,25878000,CA,0,79,-79,0
202504,25885000,2,11,41,-30,0.27
202504,25885000,3,1,0,1,NA
202504,25885000,CA,0,11,-11,0
202504,25898000,2,0,22,-22,0
202504,25898000,2S2,0,1,-1,0
202504,25898000,CA,1,3,-2,0.33
202504,25898001,CA,1,0,1,NA
202504,25899000,2,838,2743,-1905,0.31
202504,25899000,2S2,199,90,109,2.21
202504,25899000,2S3,146,29,117,5.03
202504,25899000,3,42,62,-20,0.68
202504,25899000,3S1,0,3,-3,0
202504,25899000,3S2,171,41,130,4.17
202504,25899000,3S3,664,534,130,1.24
202504,25899000,3S4,1,1,0,1
202504,25899000,4,4,1,3,4
202504,25899000,CA,185,1774,-1589,0.1
202504,25899000,V2,0,5,-5,0
202504,25899000,V3,75,143,-68,0.52
202504,25899000,V4,20,0,20,NA
202504,25899023,CA,2,3,-1,0.67
202504,27001000,2,174,1787,-1613,0.1
202504,27001000,2S2,9,16,-7,0.56
202504,27001000,2S3,0,2,-2,0
202504,27001000,3,4,184,-180,0.02
202504,27001000,3S2,4,19,-15,0.21
202504,27001000,3S3,4,146,-142,0.03
202504,27001000,4,1,31,-30,0.03
202504,27001000,CA,24,122,-98,0.2
202504,27001032,2,0,3,-3,0
202504,27001060,2,0,8,-8,0
202504,27006000,2,0,1,-1,0
202504,27006000,3S3,0,2,-2,0
202504,27006000,CA,0,1,-1,0
202504,27073000,2,0,5,-5,0
202504,27075000,2,0,1,-1,0
202504,27077000,2,0,1,-1,0
202504,27086000,2,4,71,-67,0.06
202504,27086000,3,2,23,-21,0.09
202504,27086000,3S2,0,1,-1,0
202504,27086000,3S3,0,16,-16,0
202504,27086000,4,0,1,-1,0
202504,27086000,CA,0,10,-10,0
202504,27086001,2,0,1,-1,0
202504,27086003,3,0,2,-2,0
202504,27135000,2,0,1,-1,0
202504,27150000,2,0,1,-1,0
202504,27150000,3S3,1,0,1,NA
202504,27160000,2,0,4,-4,0
202504,27160000,3S2,0,2,-2,0
202504,27160000,CA,0,1,-1,0
202504,27205000,2,3,130,-127,0.02
202504,27205000,3,0,15,-15,0
202504,27205000,3S2,2,5,-3,0.4
202504,27205000,3S3,0,2,-2,0
202504,27205000,4,0,1,-1,0
202504,27205000,CA,0,17,-17,0
202504,27245000,2,9,68,-59,0.13
202504,27245000,2S2,0,1,-1,0
202504,27245000,2S3,0,1,-1,0
202504,27245000,3,0,25,-25,0
202504,27245000,3S2,2,58,-56,0.03
202504,27245000,3S3,58,12,46,4.83
202504,27245000,CA,0,7,-7,0
202504,27245000,V3,0,3,-3,0
202504,27245003,3,0,1,-1,0
202504,27361000,2,59,553,-494,0.11
202504,27361000,2S2,0,1,-1,0
202504,27361000,3,0,59,-59,0
202504,27361000,3S2,10,10,0,1
202504,27361000,3S3,0,23,-23,0
202504,27361000,4,0,14,-14,0
202504,27361000,CA,1,74,-73,0.01
202504,27361024,2,0,2,-2,0
202504,27413000,2,0,5,-5,0
202504,27413000,3,0,2,-2,0
202504,27430000,2,0,1,-1,0
202504,27430000,3,0,1,-1,0
202504,27430011,2,0,8,-8,0
202504,27450000,3,0,3,-3,0
202504,27450009,2,0,1,-1,0
202504,27450009,3,0,1,-1,0
202504,27491000,2,0,10,-10,0
202504,27491000,3,0,3,-3,0
202504,27491000,3S2,0,4,-4,0
202504,27491008,3S3,0,1,-1,0
202504,27580005,2,0,2,-2,0
202504,27615000,2,0,13,-13,0
202504,27615000,3,0,3,-3,0
202504,27615000,3S2,1,0,1,NA
202504,27615000,3S3,0,10,-10,0
202504,27615000,CA,0,3,-3,0
202504,27660000,2,0,10,-10,0
202504,27660000,3,0,2,-2,0
202504,27660000,3S2,0,1,-1,0
202504,27660000,3S3,0,1,-1,0
202504,27787000,2,7,50,-43,0.14
202504,27787000,3,0,7,-7,0
202504,27787000,3S2,0,2,-2,0
202504,27787000,3S3,0,1,-1,0
202504,27787000,CA,2,7,-5,0.29
202504,27787010,3S3,1,0,1,NA
202504,27787017,2,0,1,-1,0
202504,27810000,2,1,9,-8,0.11
202504,27810000,3,0,1,-1,0
202504,27810000,3S2,1,5,-4,0.2
202504,27810000,3S3,0,1,-1,0
202504,27810000,CA,1,0,1,NA
202504,27810002,2,0,33,-33,0
202504,27810002,3,0,7,-7,0
202504,27810002,3S2,0,3,-3,0
202504,41001000,2,2695,4017,-1322,0.67
202504,41001000,2B1,0,1,-1,0
202504,41001000,2R2,55,27,28,2.04
202504,41001000,2S1,2,1,1,2
202504,41001000,2S2,91,354,-263,0.26
202504,41001000,2S3,15,33,-18,0.45
202504,41001000,3,283,131,152,2.16
202504,41001000,3S1,0,2,-2,0
202504,41001000,3S2,176,375,-199,0.47
202504,41001000,3S3,1794,2287,-493,0.78
202504,41001000,3S4,1,5,-4,0.2
202504,41001000,4,12,10,2,1.2
202504,41001000,CA,573,900,-327,0.64
202504,41001000,V3,0,1,-1,0
202504,41001000,V4,1,0,1,NA
202504,41001001,2,1,1,0,1
202504,41001001,3,0,1,-1,0
202504,41001001,CA,0,15,-15,0
202504,41001003,2,118,1,117,118
202504,41001003,3,11,0,11,NA
202504,41001003,3S3,5,5,0,1
202504,41001009,3,0,2,-2,0
202504,41001012,2,0,2,-2,0
202504,41001012,CA,1,0,1,NA
202504,41001014,2,0,1,-1,0
202504,41001018,2,0,3,-3,0
202504,41006000,2,4,148,-144,0.03
202504,41006000,2S3,0,2,-2,0
202504,41006000,3,0,7,-7,0
202504,41006000,3S3,0,15,-15,0
202504,41006000,CA,2,34,-32,0.06
202504,41006001,2,1,0,1,NA
202504,41006005,3S3,4,4,0,1
202504,41013000,2,0,13,-13,0
202504,41013000,3,0,1,-1,0
202504,41013000,3S3,0,7,-7,0
202504,41013000,CA,1,0,1,NA
202504,41016000,2,78,94,-16,0.83
202504,41016000,2R2,0,1,-1,0
202504,41016000,2S1,2,1,1,2
202504,41016000,2S2,3,3,0,1
202504,41016000,2S3,0,1,-1,0
202504,41016000,3,24,260,-236,0.09
202504,41016000,3S1,2,1,1,2
202504,41016000,3S2,22,21,1,1.05
202504,41016000,3S3,86,281,-195,0.31
202504,41016000,4,4,6,-2,0.67
202504,41016000,CA,6,40,-34,0.15
202504,41016001,2,0,10,-10,0
202504,41016001,3,0,3,-3,0
202504,41016003,2,2,0,2,NA
202504,41016003,3S3,1,0,1,NA
202504,41020000,2,5,53,-48,0.09
202504,41020000,3S3,0,3,-3,0
202504,41020000,CA,0,11,-11,0
202504,41026000,2,4,2,2,2
202504,41026000,3S3,0,9,-9,0
202504,41026000,CA,0,1,-1,0
202504,41078000,2,0,4,-4,0
202504,41078000,3S3,0,3,-3,0
202504,41078000,CA,0,1,-1,0
202504,41132000,2,13,187,-174,0.07
202504,41132000,2S2,1,1,0,1
202504,41132000,3,1,1,0,1
202504,41132000,3S2,9,0,9,NA
202504,41132000,3S3,76,44,32,1.73
202504,41132000,CA,2,53,-51,0.04
202504,41132000,V3,3,0,3,NA
202504,41132001,3,0,2,-2,0
202504,41206000,2,0,2,-2,0
202504,41206000,3S3,0,2,-2,0
202504,41206000,CA,0,1,-1,0
202504,41244000,2,0,1,-1,0
202504,41298000,2,63,519,-456,0.12
202504,41298000,2S2,0,1,-1,0
202504,41298000,2S3,1,2,-1,0.5
202504,41298000,3,11,58,-47,0.19
202504,41298000,3S2,1,8,-7,0.12
202504,41298000,3S3,32,165,-133,0.19
202504,41298000,CA,10,71,-61,0.14
202504,41298002,3,0,3,-3,0
202504,41298004,2,1,5,-4,0.2
202504,41298004,3S3,0,1,-1,0
202504,41306000,2,12,66,-54,0.18
202504,41306000,2S3,0,2,-2,0
202504,41306000,3,2,5,-3,0.4
202504,41306000,3S2,9,1,8,9
202504,41306000,3S3,72,37,35,1.95
202504,41306000,CA,4,7,-3,0.57
202504,41319000,2,1,32,-31,0.03
202504,41319000,2S3,0,1,-1,0
202504,41319000,3,2,4,-2,0.5
202504,41319000,3S2,0,5,-5,0
202504,41319000,3S3,3,11,-8,0.27
202504,41319000,CA,2,5,-3,0.4
202504,41349000,2,6,22,-16,0.27
202504,41349000,2S2,0,1,-1,0
202504,41349000,3,32,1,31,32
202504,41349000,3S2,7,0,7,NA
202504,41349000,3S3,75,1,74,75
202504,41349000,CA,0,2,-2,0
202504,41357000,2,1,1,0,1
202504,41357000,CA,1,7,-6,0.14
202504,41359000,2,7,89,-82,0.08
202504,41359000,2S3,1,0,1,NA
202504,41359000,3,0,5,-5,0
202504,41359000,3S3,0,10,-10,0
202504,41359000,CA,0,31,-31,0
202504,41359002,2,0,1,-1,0
202504,41359002,3,0,1,-1,0
202504,41359002,3S3,0,10,-10,0
202504,41359004,2,0,1,-1,0
202504,41378000,2,7,26,-19,0.27
202504,41378000,3,0,17,-17,0
202504,41378000,CA,0,33,-33,0
202504,41396000,2,37,323,-286,0.11
202504,41396000,2S3,0,4,-4,0
202504,41396000,3,2,26,-24,0.08
202504,41396000,3S2,0,2,-2,0
202504,41396000,3S3,1,93,-92,0.01
202504,41396000,CA,3,67,-64,0.04
202504,41483000,2,0,1,-1,0
202504,41483000,3,0,4,-4,0
202504,41503000,2,1,9,-8,0.11
202504,41503000,3S3,0,1,-1,0
202504,41503000,CA,0,23,-23,0
202504,41518000,2,57,14,43,4.07
202504,41518000,3,213,18,195,11.83
202504,41518000,3S2,0,1,-1,0
202504,41518000,3S3,2,2,0,1
202504,41518000,CA,0,1,-1,0
202504,41524000,2,110,213,-103,0.52
202504,41524000,2S1,1,1,0,1
202504,41524000,2S2,6,16,-10,0.38
202504,41524000,2S3,6,0,6,NA
202504,41524000,3,18,13,5,1.38
202504,41524000,3S1,1,1,0,1
202504,41524000,3S2,6,41,-35,0.15
202504,41524000,3S3,263,382,-119,0.69
202504,41524000,4,3,2,1,1.5
202504,41524000,CA,44,70,-26,0.63
202504,41524000,V3,1,0,1,NA
202504,41524006,2,1,0,1,NA
202504,41524006,3S3,0,1,-1,0
202504,41524006,CA,0,1,-1,0
202504,41524009,3S3,0,1,-1,0
202504,41530000,2,8,17,-9,0.47
202504,41530000,3,1,3,-2,0.33
202504,41530000,3S3,0,5,-5,0
202504,41530000,CA,0,26,-26,0
202504,41548000,2,4,19,-15,0.21
202504,41548000,3S2,0,1,-1,0
202504,41548000,3S3,0,4,-4,0
202504,41548000,CA,1,1,0,1
202504,41551000,2,477,1800,-1323,0.26
202504,41551000,2R2,0,1,-1,0
202504,41551000,2S2,11,35,-24,0.31
202504,41551000,2S3,8,60,-52,0.13
202504,41551000,3,12,56,-44,0.21
202504,41551000,3S2,28,64,-36,0.44
202504,41551000,3S3,52,415,-363,0.13
202504,41551000,CA,165,225,-60,0.73
202504,41551000,V2,0,1,-1,0
202504,41551000,V3,0,4,-4,0
202504,41551001,2,9,19,-10,0.47
202504,41551001,3,2,8,-6,0.25
202504,41551001,3S3,1,4,-3,0.25
202504,41551001,CA,0,25,-25,0
202504,41551008,2,1,0,1,NA
202504,41551008,3S3,19,0,19,NA
202504,41615000,2,106,94,12,1.13
202504,41615000,2S3,53,0,53,NA
202504,41615000,3,21,7,14,3
202504,41615000,3S2,3,0,3,NA
202504,41615000,3S3,130,232,-102,0.56
202504,41615000,CA,26,53,-27,0.49
202504,41615000,V3,0,3,-3,0
202504,41615001,2,0,1,-1,0
202504,41615002,2,0,1,-1,0
202504,41615005,2,0,1,-1,0
202504,41660000,2,1,23,-22,0.04
202504,41660000,3,0,6,-6,0
202504,41660000,3S3,0,2,-2,0
202504,41660000,CA,0,4,-4,0
202504,41668000,2,10,201,-191,0.05
202504,41668000,2S3,1,0,1,NA
202504,41668000,3,1,13,-12,0.08
202504,41668000,3S3,1,20,-19,0.05
202504,41668000,CA,2,14,-12,0.14
202504,41668006,2,0,1,-1,0
202504,41668007,2,0,2,-2,0
202504,41668007,2S2,0,1,-1,0
202504,41676000,2,2,10,-8,0.2
202504,41676000,CA,0,5,-5,0
202504,41770000,2,0,66,-66,0
202504,41770000,2S3,0,1,-1,0
202504,41770000,3,0,1,-1,0
202504,41770000,3S2,1,5,-4,0.2
202504,41770000,3S3,2,10,-8,0.2
202504,41770000,CA,0,3,-3,0
202504,41770001,2,0,6,-6,0
202504,41770001,3,0,1,-1,0
202504,41791000,2,2,13,-11,0.15
202504,41791000,2S3,0,2,-2,0
202504,41791000,3S2,0,1,-1,0
202504,41791000,3S3,0,11,-11,0
202504,41791000,CA,0,3,-3,0
202504,41791002,2,0,1,-1,0
202504,41797000,2,3,108,-105,0.03
202504,41797000,2S2,0,9,-9,0
202504,41797000,3,2,215,-213,0.01
202504,41797000,3S2,1,2,-1,0.5
202504,41797000,3S3,185,70,115,2.64
202504,41797000,3S4,3,1,2,3
202504,41797000,CA,0,15,-15,0
202504,41799000,2,0,15,-15,0
202504,41799000,3S2,0,55,-55,0
202504,41799000,CA,0,3,-3,0
202504,41801000,2,0,16,-16,0
202504,41801000,3,0,1,-1,0
202504,41801000,CA,0,33,-33,0
202504,41807000,2,5,62,-57,0.08
202504,41807000,3,0,5,-5,0
202504,41807000,3S2,0,3,-3,0
202504,41807000,3S3,0,106,-106,0
202504,41807000,CA,0,3,-3,0
202504,41872000,2,0,11,-11,0
202504,41872000,3S2,50,1,49,50
202504,41872000,3S3,1,3,-2,0.33
202504,41872000,4,1,2,-1,0.5
202504,41872000,CA,0,16,-16,0
202504,41872003,3S3,0,1,-1,0
202504,41885000,2,3,25,-22,0.12
202504,41885000,3,2,14,-12,0.14
202504,41885000,3S2,3,9,-6,0.33
202504,41885000,3S3,4,37,-33,0.11
202504,41885000,4,0,2,-2,0
202504,41885000,CA,0,9,-9,0
202504,44001000,2,295,1598,-1303,0.18
202504,44001000,2B1,0,1,-1,0
202504,44001000,2R2,0,19,-19,0
202504,44001000,2S2,6,17,-11,0.35
202504,44001000,2S3,2,33,-31,0.06
202504,44001000,3,13,33,-20,0.39
202504,44001000,3S2,5,41,-36,0.12
202504,44001000,3S3,136,402,-266,0.34
202504,44001000,3S4,2,2,0,1
202504,44001000,4,0,1,-1,0
202504,44001000,CA,190,217,-27,0.88
202504,44001000,V2,17,0,17,NA
202504,44001000,V3,47,0,47,NA
202504,44001001,2,0,1,-1,0
202504,44001002,3S3,4,7,-3,0.57
202504,44001002,CA,0,1,-1,0
202504,44001003,3S2,0,2,-2,0
202504,44001003,3S3,0,1,-1,0
202504,44001011,2,0,2,-2,0
202504,44001011,2S3,0,1,-1,0
202504,44001011,3S3,0,2,-2,0
202504,44001012,CA,0,1,-1,0
202504,44001020,3S2,58,1,57,58
202504,44001020,3S3,0,5,-5,0
202504,44001025,2,2,0,2,NA
202504,44001025,3S2,162,6,156,27
202504,44001025,3S3,1,2,-1,0.5
202504,44001025,V3R3,21,0,21,NA
202504,44001026,CA,1,0,1,NA
202504,44035000,2,56,242,-186,0.23
202504,44035000,2S2,73,14,59,5.21
202504,44035000,2S3,15,8,7,1.88
202504,44035000,3,0,4,-4,0
202504,44035000,3S2,17,22,-5,0.77
202504,44035000,3S3,94,225,-131,0.42
202504,44035000,3S4,3,10,-7,0.3
202504,44035000,CA,4,83,-79,0.05
202504,44035001,2,19,15,4,1.27
202504,44035001,2S3,1,1,0,1
202504,44035001,3S2,2,1,1,2
202504,44035001,3S3,4,26,-22,0.15
202504,44035001,3S4,0,1,-1,0
202504,44035001,CA,2,2,0,1
202504,44078000,2,14,111,-97,0.13
202504,44078000,2S2,0,2,-2,0
202504,44078000,3,2,0,2,NA
202504,44078000,3S2,0,1,-1,0
202504,44078000,3S3,2,49,-47,0.04
202504,44078000,CA,0,33,-33,0
202504,44078000,V2,1,0,1,NA
202504,44078000,V3,2,0,2,NA
202504,44078006,2,0,13,-13,0
202504,44090000,2,17,93,-76,0.18
202504,44090000,2S2,2,1,1,2
202504,44090000,2S3,0,2,-2,0
202504,44090000,3R3,0,1,-1,0
202504,44090000,3S2,0,6,-6,0
202504,44090000,3S3,44,1630,-1586,0.03
202504,44090000,4,0,1,-1,0
202504,44090000,CA,1,26,-25,0.04
202504,44090002,2,0,1,-1,0
202504,44090003,2,9,27,-18,0.33
202504,44090003,2S2,1,1,0,1
202504,44090003,2S3,0,2,-2,0
202504,44090003,3R3,0,5,-5,0
202504,44090003,3S2,7,8,-1,0.88
202504,44090003,3S3,58,909,-851,0.06
202504,44090003,CA,5,5,0,1
202504,44090004,2,13,24,-11,0.54
202504,44090004,2S2,0,2,-2,0
202504,44090004,3S2,0,1,-1,0
202504,44090004,3S3,3,14,-11,0.21
202504,44090004,CA,2,13,-11,0.15
202504,44098000,2,3,16,-13,0.19
202504,44098000,3S3,0,3,-3,0
202504,44098000,CA,1,6,-5,0.17
202504,44098001,2,0,2,-2,0
202504,44110000,2,2,4,-2,0.5
202504,44110000,CA,0,1,-1,0
202504,44279000,2,62,279,-217,0.22
202504,44279000,2S2,2,2,0,1
202504,44279000,2S3,0,2,-2,0
202504,44279000,3,0,5,-5,0
202504,44279000,3S2,1,5,-4,0.2
202504,44279000,3S3,36,108,-72,0.33
202504,44279000,CA,0,80,-80,0
202504,44279002,3S3,0,1,-1,0
202504,44378000,2,22,91,-69,0.24
202504,44378000,3,1,0,1,NA
202504,44378000,3S2,1,2,-1,0.5
202504,44378000,3S3,9,19,-10,0.47
202504,44378000,CA,2,18,-16,0.11
202504,44420000,2,0,2,-2,0
202504,44430000,2,238,2010,-1772,0.12
202504,44430000,2B1,0,7,-7,0
202504,44430000,2R2,0,27,-27,0
202504,44430000,2S2,8,74,-66,0.11
202504,44430000,2S3,1,45,-44,0.02
202504,44430000,3,3,97,-94,0.03
202504,44430000,3S2,2,41,-39,0.05
202504,44430000,3S3,44,1055,-1011,0.04
202504,44430000,4,0,1,-1,0
202504,44430000,CA,8,257,-249,0.03
202504,44430000,V2,0,13,-13,0
202504,44430000,V3,0,47,-47,0
202504,44430002,2,1,0,1,NA
202504,44430002,3S3,0,1,-1,0
202504,44430005,2,0,3,-3,0
202504,44430005,3S3,12,13,-1,0.92
202504,44430007,2,11,62,-51,0.18
202504,44430007,2R2,0,1,-1,0
202504,44430007,2S2,18,23,-5,0.78
202504,44430007,2S3,5,10,-5,0.5
202504,44430007,3,0,1,-1,0
202504,44430007,3S2,26,36,-10,0.72
202504,44430007,3S3,98,359,-261,0.27
202504,44430007,3S4,0,2,-2,0
202504,44430007,CA,0,24,-24,0
202504,44560000,2,4,81,-77,0.05
202504,44560000,3,0,3,-3,0
202504,44560000,3S2,2,2,0,1
202504,44560000,3S3,1,55,-54,0.02
202504,44560000,CA,2,23,-21,0.09
202504,44560000,V2,0,5,-5,0
202504,44560000,V3,0,3,-3,0
202504,44560003,3S2,0,1,-1,0
202504,44560007,2,0,4,-4,0
202504,44560007,3S2,0,1,-1,0
202504,44560007,3S3,5,6,-1,0.83
202504,44560007,CA,0,1,-1,0
202504,44650000,2,43,119,-76,0.36
202504,44650000,2S2,0,1,-1,0
202504,44650000,3,0,3,-3,0
202504,44650000,3S2,0,2,-2,0
202504,44650000,3S3,6,22,-16,0.27
202504,44650000,CA,1,31,-30,0.03
202504,44650000,V3,6,1,5,6
202504,44650001,2,1,0,1,NA
202504,44650003,2,1,1,0,1
202504,44847000,2,165,252,-87,0.65
202504,44847000,2S2,6,6,0,1
202504,44847000,2S3,1,4,-3,0.25
202504,44847000,3,12,3,9,4
202504,44847000,3S2,8,7,1,1.14
202504,44847000,3S3,333,166,167,2.01
202504,44847000,4,1,0,1,NA
202504,44847000,CA,0,65,-65,0
202504,44847003,2,0,2,-2,0
202504,44847013,3S3,0,1,-1,0
202504,44855000,2,0,35,-35,0
202504,44855000,2S2,0,1,-1,0
202504,44855000,3S2,0,1,-1,0
202504,44855000,CA,0,9,-9,0
202504,44874000,2,1,100,-99,0.01
202504,44874000,3S2,0,2,-2,0
202504,44874000,3S3,5,33,-28,0.15
202504,44874000,CA,0,24,-24,0
202504,47001000,2,2264,6073,-3809,0.37
202504,47001000,2R2,3,230,-227,0.01
202504,47001000,2S2,637,850,-213,0.75
202504,47001000,2S3,162,219,-57,0.74
202504,47001000,3,83,185,-102,0.45
202504,47001000,3S2,1127,2776,-1649,0.41
202504,47001000,3S3,13533,7113,6420,1.9
202504,47001000,3S4,7,13,-6,0.54
202504,47001000,4,0,2,-2,0
202504,47001000,CA,603,1282,-679,0.47
202504,47001000,V2,3,0,3,NA
202504,47001000,V3,1,9,-8,0.11
202504,47001000,V3R3,20,26,-6,0.77
202504,47001000,V4,2,0,2,NA
202504,47001001,2,1,0,1,NA
202504,47001001,3S2,1,0,1,NA
202504,47001002,2,0,9,-9,0
202504,47001002,3S3,0,1,-1,0
202504,47001002,CA,0,1,-1,0
202504,47001003,3S2,23,1,22,23
202504,47001003,3S3,2,0,2,NA
202504,47001003,CA,0,2,-2,0
202504,47001005,2,7,0,7,NA
202504,47001005,3S3,0,260,-260,0
202504,47001006,2,2,10,-8,0.2
202504,47001006,3S2,31,32,-1,0.97
202504,47001006,3S3,10,0,10,NA
202504,47001006,CA,0,2,-2,0
202504,47001009,2,0,6,-6,0
202504,47001009,CA,0,1,-1,0
202504,47001010,2,1,0,1,NA
202504,47001010,3S3,0,2,-2,0
202504,47001010,CA,0,5,-5,0
202504,47001011,2,4,6,-2,0.67
202504,47001011,3S2,23,23,0,1
202504,47001011,3S3,0,2,-2,0
202504,47001011,CA,1,11,-10,0.09
202504,47001014,2,0,2,-2,0
202504,47001014,3S3,1,0,1,NA
202504,47001019,2,0,1,-1,0
202504,47001019,3S3,1,8,-7,0.12
202504,47001035,3S3,0,1,-1,0
202504,47030000,2,4,30,-26,0.13
202504,47030000,2S2,1,1,0,1
202504,47030000,2S3,0,1,-1,0
202504,47030000,3,0,1,-1,0
202504,47030000,3S3,0,5,-5,0
202504,47030000,CA,0,5,-5,0
202504,47030004,2,3,1,2,3
202504,47053000,2,18,146,-128,0.12
202504,47053000,2S2,1,0,1,NA
202504,47053000,2S3,0,8,-8,0
202504,47053000,3,7,0,7,NA
202504,47053000,3S2,124,8,116,15.5
202504,47053000,3S3,163,252,-89,0.65
202504,47053000,CA,1,25,-24,0.04
202504,47053000,V3R3,19,48,-29,0.4
202504,47053008,3,0,1,-1,0
202504,47053008,3S3,0,1,-1,0
202504,47058000,2,17,70,-53,0.24
202504,47058000,3,0,1,-1,0
202504,47058000,3S2,5,28,-23,0.18
202504,47058000,3S3,2,36,-34,0.06
202504,47058000,3S4,2,0,2,NA
202504,47058000,4,0,1,-1,0
202504,47058000,CA,0,4,-4,0
202504,47058003,2,4,2,2,2
202504,47058003,2S3,0,1,-1,0
202504,47058005,2,0,4,-4,0
202504,47058007,2,0,1,-1,0
202504,47058009,2S2,1,0,1,NA
202504,47161000,2,0,2,-2,0
202504,47170000,2,9,48,-39,0.19
202504,47170000,2S2,1,0,1,NA
202504,47170000,3,0,1,-1,0
202504,47170000,3S2,3,1,2,3
202504,47170000,3S3,0,14,-14,0
202504,47170000,CA,0,6,-6,0
202504,47189000,2,177,1167,-990,0.15
202504,47189000,2R2,0,21,-21,0
202504,47189000,2S2,24,13,11,1.85
202504,47189000,2S3,6,14,-8,0.43
202504,47189000,3,24,49,-25,0.49
202504,47189000,3S2,23,54,-31,0.43
202504,47189000,3S3,349,309,40,1.13
202504,47189000,3S4,1,0,1,NA
202504,47189000,CA,15,226,-211,0.07
202504,47189000,V3,9,0,9,NA
202504,47189004,2,0,1,-1,0
202504,47189006,2,1,0,1,NA
202504,47205000,2,0,5,-5,0
202504,47205001,2,0,1,-1,0
202504,47205003,2,0,3,-3,0
202504,47245000,2,47,453,-406,0.1
202504,47245000,2R2,0,13,-13,0
202504,47245000,3,0,10,-10,0
202504,47245000,3S2,0,3,-3,0
202504,47245000,3S3,1,30,-29,0.03
202504,47245000,4,0,1,-1,0
202504,47245000,CA,20,37,-17,0.54
202504,47245001,2,0,2,-2,0
202504,47258000,2,1,12,-11,0.08
202504,47258000,3S3,0,9,-9,0
202504,47258000,CA,0,3,-3,0
202504,47258003,2,0,1,-1,0
202504,47268000,2,3,77,-74,0.04
202504,47268000,2S2,0,1,-1,0
202504,47268000,2S3,0,1,-1,0
202504,47268000,3S2,15,15,0,1
202504,47268000,3S3,0,6,-6,0
202504,47268000,CA,1,5,-4,0.2
202504,47288000,2,94,556,-462,0.17
202504,47288000,2S2,2,26,-24,0.08
202504,47288000,2S3,1,4,-3,0.25
202504,47288000,3,6,32,-26,0.19
202504,47288000,3S2,69,22,47,3.14
202504,47288000,3S3,106,135,-29,0.79
202504,47288000,3S4,0,1,-1,0
202504,47288000,CA,9,95,-86,0.09
202504,47288004,CA,0,1,-1,0
202504,47288011,2,0,1,-1,0
202504,47318000,2,29,137,-108,0.21
202504,47318000,2S2,0,1,-1,0
202504,47318000,3,0,3,-3,0
202504,47318000,3S2,0,1,-1,0
202504,47318000,3S3,0,15,-15,0
202504,47318000,CA,10,31,-21,0.32
202504,47318012,2,0,2,-2,0
202504,47318012,CA,0,1,-1,0
202504,47460000,2,18,33,-15,0.55
202504,47460000,3,0,3,-3,0
202504,47460000,3S2,0,2,-2,0
202504,47460000,3S3,1,6,-5,0.17
202504,47460000,CA,0,3,-3,0
202504,47460001,2,0,2,-2,0
202504,47460001,CA,0,3,-3,0
202504,47460002,2,2,1,1,2
202504,47460004,2,0,3,-3,0
202504,47460005,2,0,4,-4,0
202504,47460005,3S3,0,1,-1,0
202504,47460005,CA,0,1,-1,0
202504,47541000,2,0,2,-2,0
202504,47541000,3S3,0,1,-1,0
202504,47545000,2,18,6,12,3
202504,47545000,3S3,1,2,-1,0.5
202504,47545000,CA,0,1,-1,0
202504,47551000,2,15,182,-167,0.08
202504,47551000,2S3,0,2,-2,0
202504,47551000,3,0,1,-1,0
202504,47551000,3S2,2,1,1,2
202504,47551000,3S3,1,5,-4,0.2
202504,47551000,3S4,0,1,-1,0
202504,47551000,CA,1,52,-51,0.02
202504,47551008,2,0,1,-1,0
202504,47551009,2,1,1,0,1
202504,47551011,2,2,0,2,NA
202504,47555000,2,58,312,-254,0.19
202504,47555000,2R2,0,6,-6,0
202504,47555000,2S3,0,1,-1,0
202504,47555000,3,0,16,-16,0
202504,47555000,3S2,58,6,52,9.67
202504,47555000,3S3,482,39,443,12.36
202504,47555000,CA,6,49,-43,0.12
202504,47555001,2,1,1,0,1
202504,47555001,3S3,0,2,-2,0
202504,47555006,3S3,0,1,-1,0
202504,47570000,2,0,22,-22,0
202504,47570000,CA,0,3,-3,0
202504,47570004,2,1,0,1,NA
202504,47605000,2,0,5,-5,0
202504,47605000,3,1,0,1,NA
202504,47605000,3S3,0,1,-1,0
202504,47605000,CA,0,4,-4,0
202504,47660000,2,4,13,-9,0.31
202504,47660000,2S2,0,1,-1,0
202504,47660000,3,0,6,-6,0
202504,47660000,3S2,1,1,0,1
202504,47660000,3S3,2,1,1,2
202504,47660000,CA,0,1,-1,0
202504,47660014,3,0,8,-8,0
202504,47675000,2,2,17,-15,0.12
202504,47675000,3S3,0,1,-1,0
202504,47675000,CA,0,3,-3,0
202504,47675001,2,0,1,-1,0
202504,47692000,2,10,38,-28,0.26
202504,47692000,2S2,0,1,-1,0
202504,47692000,3,0,6,-6,0
202504,47692000,3S2,1,0,1,NA
202504,47692000,3S3,88,19,69,4.63
202504,47703000,2,1,0,1,NA
202504,47707000,2,1,68,-67,0.01
202504,47707000,3,0,3,-3,0
202504,47707000,3S1,3,1,2,3
202504,47707000,3S2,0,6,-6,0
202504,47707000,3S3,3,79,-76,0.04
202504,47707000,3S4,0,11,-11,0
202504,47707000,CA,0,3,-3,0
202504,47707001,2,0,4,-4,0
202504,47707004,2,9,0,9,NA
202504,47720000,2,4,4,0,1
202504,47720000,3,0,1,-1,0
202504,47720001,2,0,1,-1,0
202504,47720001,3S3,2,0,2,NA
202504,47745000,2,10,41,-31,0.24
202504,47745000,2S2,1,82,-81,0.01
202504,47745000,2S3,63,4,59,15.75
202504,47745000,3,29,3,26,9.67
202504,47745000,3S2,200,50,150,4
202504,47745000,3S3,3894,936,2958,4.16
202504,47745000,3S4,2,6,-4,0.33
202504,47745000,CA,1,8,-7,0.12
202504,47745000,V2,112,2,110,56
202504,47745000,V3,357,24,333,14.88
202504,47745000,V4,53,0,53,NA
202504,47745003,2,249,56,193,4.45
202504,47745003,2S2,3,4,-1,0.75
202504,47745003,2S3,50,2,48,25
202504,47745003,3,99,9,90,11
202504,47745003,3S2,40,54,-14,0.74
202504,47745003,3S3,2406,2216,190,1.09
202504,47745003,3S4,2,0,2,NA
202504,47745003,CA,10,13,-3,0.77
202504,47745003,V2,0,20,-20,0
202504,47745003,V3,2,43,-41,0.05
202504,47798000,2,7,7,0,1
202504,47798000,3S3,0,1,-1,0
202504,47798000,CA,0,1,-1,0
202504,47960000,2,0,4,-4,0
202504,47960000,3,0,1,-1,0
202504,47980000,2,122,143,-21,0.85
202504,47980000,2R2,0,1,-1,0
202504,47980000,2S3,2,0,2,NA
202504,47980000,3,0,4,-4,0
202504,47980000,3S2,398,107,291,3.72
202504,47980000,3S3,24,34,-10,0.71
202504,47980000,CA,1,47,-46,0.02
202504,47980001,2,28,19,9,1.47
202504,47980001,3S2,101,38,63,2.66
202504,47980001,3S3,0,1,-1,0
202504,47980002,2,0,4,-4,0
202504,47980002,3S2,1,0,1,NA
202504,47980002,3S3,3,0,3,NA
202504,47980003,2,2,8,-6,0.25
202504,47980003,2R2,1,6,-5,0.17
202504,47980003,2S2,0,3,-3,0
202504,47980003,2S3,0,4,-4,0
202504,47980003,3S2,23,3,20,7.67
202504,47980003,3S3,4,33,-29,0.12
202504,47980004,2,96,76,20,1.26
202504,47980004,2R2,0,9,-9,0
202504,47980004,2S2,5,0,5,NA
202504,47980004,2S3,3,0,3,NA
202504,47980004,3,0,2,-2,0
202504,47980004,3S2,148,130,18,1.14
202504,47980004,3S3,0,7,-7,0
202504,47980004,CA,0,9,-9,0
202504,47980006,2,63,73,-10,0.86
202504,47980006,2S2,0,1,-1,0
202504,47980006,2S3,1,0,1,NA
202504,47980006,3,0,8,-8,0
202504,47980006,3S2,1,0,1,NA
202504,47980006,3S3,0,9,-9,0
202504,47980006,CA,0,1,-1,0
202504,47980007,3S2,0,4,-4,0
202504,47980007,3S3,14,1,13,14
202504,47980008,2,49,38,11,1.29
202504,47980008,3,0,2,-2,0
202504,47980008,3S2,182,104,78,1.75
202504,47980008,3S3,1,5,-4,0.2
202504,47980008,CA,0,1,-1,0
202504,47980010,2,9,15,-6,0.6
202504,47980010,2S2,1,1,0,1
202504,47980010,3,0,1,-1,0
202504,47980010,3S2,248,25,223,9.92
202504,47980010,3S3,28,3,25,9.33
202504,47980010,CA,0,1,-1,0
202504,47980010,V3R3,6,0,6,NA
202504,47980012,2,0,2,-2,0
202504,47980012,2S3,2,0,2,NA
202504,47980012,3S2,152,1,151,152
202504,47980012,3S3,47,1,46,47
202504,47980012,CA,0,1,-1,0
202504,47980013,2,4,4,0,1
202504,47980013,3,0,1,-1,0
202504,47980013,3S2,3,0,3,NA
202504,47980014,2,0,2,-2,0
202504,50001000,2,3607,5693,-2086,0.63
202504,50001000,2B1,1,1,0,1
202504,50001000,2R2,45,16,29,2.81
202504,50001000,2S2,202,754,-552,0.27
202504,50001000,2S3,83,151,-68,0.55
202504,50001000,3,471,468,3,1.01
202504,50001000,3R3,2,0,2,NA
202504,50001000,3S1,0,16,-16,0
202504,50001000,3S2,912,1285,-373,0.71
202504,50001000,3S3,2197,3703,-1506,0.59
202504,50001000,3S4,8,9,-1,0.89
202504,50001000,4,13,11,2,1.18
202504,50001000,CA,1182,1761,-579,0.67
202504,50001000,V2,3,9,-6,0.33
202504,50001000,V2R3,3,0,3,NA
202504,50001000,V3,247,20,227,12.35
202504,50001000,V3R2,4,0,4,NA
202504,50001000,V3R3,60,0,60,NA
202504,50001001,2S2,0,1,-1,0
202504,50001001,2S3,0,1,-1,0
202504,50001001,3S2,0,2,-2,0
202504,50001001,3S3,0,6,-6,0
202504,50001002,2,5,7,-2,0.71
202504,50001002,2S2,0,2,-2,0
202504,50001002,2S3,2,2,0,1
202504,50001002,3,0,1,-1,0
202504,50001002,3S2,3,14,-11,0.21
202504,50001002,3S3,8,95,-87,0.08
202504,50001002,3S4,1,2,-1,0.5
202504,50001002,4,0,1,-1,0
202504,50001002,CA,2,3,-1,0.67
202504,50001004,2,0,2,-2,0
202504,50001004,3S3,1,0,1,NA
202504,50001015,2,17,17,0,1
202504,50001015,3,2,0,2,NA
202504,50001015,3S3,6,81,-75,0.07
202504,50001015,3S4,0,1,-1,0
202504,50001015,CA,7,7,0,1
202504,50001015,V3,1,0,1,NA
202504,50001019,2,56,6,50,9.33
202504,50001019,2S2,1,3,-2,0.33
202504,50001019,2S3,0,2,-2,0
202504,50001019,3,98,0,98,NA
202504,50001019,3S2,23,6,17,3.83
202504,50001019,3S3,46,111,-65,0.41
202504,50001019,CA,6,14,-8,0.43
202504,50006000,2,385,857,-472,0.45
202504,50006000,2R2,0,12,-12,0
202504,50006000,2S1,1,1,0,1
202504,50006000,2S2,29,30,-1,0.97
202504,50006000,2S3,12,15,-3,0.8
202504,50006000,3,174,81,93,2.15
202504,50006000,3R2,0,20,-20,0
202504,50006000,3R3,0,9,-9,0
202504,50006000,3S1,9,2,7,4.5
202504,50006000,3S2,1784,122,1662,14.62
202504,50006000,3S2S3,0,1,-1,0
202504,50006000,3S3,902,791,111,1.14
202504,50006000,3S4,9,13,-4,0.69
202504,50006000,4,5,3,2,1.67
202504,50006000,CA,32,283,-251,0.11
202504,50006000,V2,4,74,-70,0.05
202504,50006000,V3,269,209,60,1.29
202504,50006000,V3R2,0,30,-30,0
202504,50006000,V3R3,0,12,-12,0
202504,50006001,2,0,2,-2,0
202504,50006001,2S2,1,1,0,1
202504,50006001,3,2,0,2,NA
202504,50006001,3S3,1,3,-2,0.33
202504,50006001,CA,1,2,-1,0.5
202504,50006003,2,12,54,-42,0.22
202504,50006003,2S2,2,4,-2,0.5
202504,50006003,3,1,2,-1,0.5
202504,50006003,3S1,0,7,-7,0
202504,50006003,3S2,6,14,-8,0.43
202504,50006003,3S3,5,62,-57,0.08
202504,50006003,3S4,2,1,1,2
202504,50006003,CA,9,9,0,1
202504,50006003,V2,1,0,1,NA
202504,50006003,V3,0,5,-5,0
202504,50110000,2,29,68,-39,0.43
202504,50110000,2S1,2,2,0,1
202504,50110000,2S2,8,18,-10,0.44
202504,50110000,2S3,3,3,0,1
202504,50110000,3,4,17,-13,0.24
202504,50110000,3S1,1,9,-8,0.11
202504,50110000,3S2,562,21,541,26.76
202504,50110000,3S3,1162,182,980,6.38
202504,50110000,3S4,3,3,0,1
202504,50110000,CA,3,23,-20,0.13
202504,50110000,V3,0,1,-1,0
202504,50110001,3S3,21,0,21,NA
202504,50110004,3S3,1,4,-3,0.25
202504,50124000,2,13,67,-54,0.19
202504,50124000,2S1,1,0,1,NA
202504,50124000,2S2,4,5,-1,0.8
202504,50124000,2S3,4,2,2,2
202504,50124000,3,4,41,-37,0.1
202504,50124000,3S1,7,0,7,NA
202504,50124000,3S2,2111,7,2104,301.57
202504,50124000,3S3,3554,95,3459,37.41
202504,50124000,3S4,1,1,0,1
202504,50124000,CA,4,14,-10,0.29
202504,50124000,V2,0,40,-40,0
202504,50124000,V3,143,143,0,1
202504,50150000,2,47,168,-121,0.28
202504,50150000,2S2,4,32,-28,0.12
202504,50150000,2S3,2,14,-12,0.14
202504,50150000,3,0,32,-32,0
202504,50150000,3S1,7,9,-2,0.78
202504,50150000,3S2,80,103,-23,0.78
202504,50150000,3S3,114,142,-28,0.8
202504,50150000,3S4,0,5,-5,0
202504,50150000,CA,6,45,-39,0.13
202504,50150000,V2,7,23,-16,0.3
202504,50150000,V3,24,22,2,1.09
202504,50150001,2,0,1,-1,0
202504,50150001,2S2,0,2,-2,0
202504,50150001,CA,0,2,-2,0
202504,50150001,V2,0,3,-3,0
202504,50223000,2,3,14,-11,0.21
202504,50223000,3,1,0,1,NA
202504,50223000,3S3,0,4,-4,0
202504,50223000,CA,1,7,-6,0.14
202504,50223003,CA,0,1,-1,0
202504,50226000,2,40,194,-154,0.21
202504,50226000,2R2,0,5,-5,0
202504,50226000,2S2,0,2,-2,0
202504,50226000,3,9,76,-67,0.12
202504,50226000,3S2,68,7,61,9.71
202504,50226000,3S3,281,63,218,4.46
202504,50226000,4,1,0,1,NA
202504,50226000,CA,19,107,-88,0.18
202504,50226005,2,2,3,-1,0.67
202504,50226005,3S3,1,0,1,NA
202504,50226005,CA,0,2,-2,0
202504,50245000,CA,1,0,1,NA
202504,50251000,2,11,23,-12,0.48
202504,50251000,3S2,0,1,-1,0
202504,50251000,3S3,0,14,-14,0
202504,50251000,CA,1,17,-16,0.06
202504,50270000,2,0,6,-6,0
202504,50270000,3,0,3,-3,0
202504,50270000,CA,0,8,-8,0
202504,50287000,2,2,53,-51,0.04
202504,50287000,2R2,0,2,-2,0
202504,50287000,3,0,1,-1,0
202504,50287000,3S2,0,1,-1,0
202504,50287000,3S3,1,12,-11,0.08
202504,50287000,CA,0,13,-13,0
202504,50313000,2,93,1015,-922,0.09
202504,50313000,2R2,0,9,-9,0
202504,50313000,2S2,0,16,-16,0
202504,50313000,2S3,3,2,1,1.5
202504,50313000,3,6,38,-32,0.16
202504,50313000,3S2,3,18,-15,0.17
202504,50313000,3S3,157,402,-245,0.39
202504,50313000,4,0,1,-1,0
202504,50313000,CA,19,283,-264,0.07
202504,50313002,2,0,23,-23,0
202504,50313002,2S2,0,9,-9,0
202504,50313007,3S3,1,0,1,NA
202504,50313007,CA,0,1,-1,0
202504,50318000,2,60,159,-99,0.38
202504,50318000,2R2,0,3,-3,0
202504,50318000,2S2,5,4,1,1.25
202504,50318000,2S3,2,6,-4,0.33
202504,50318000,3,221,41,180,5.39
202504,50318000,3S2,1065,170,895,6.26
202504,50318000,3S3,712,257,455,2.77
202504,50318000,3S4,3,6,-3,0.5
202504,50318000,4,1,1,0,1
202504,50318000,CA,10,77,-67,0.13
202504,50318000,V2,116,4,112,29
202504,50318000,V3,354,24,330,14.75
202504,50318001,2,2,3,-1,0.67
202504,50318001,3S2,0,2,-2,0
202504,50318004,3S2,0,48,-48,0
202504,50318004,3S3,0,1,-1,0
202504,50325000,2,3,13,-10,0.23
202504,50325000,2S3,1,1,0,1
202504,50325000,3,0,4,-4,0
202504,50325000,3S2,13,0,13,NA
202504,50325000,3S3,53,29,24,1.83
202504,50325000,CA,1,1,0,1
202504,50330000,2,1,46,-45,0.02
202504,50330000,2R2,0,1,-1,0
202504,50330000,2S2,1,1,0,1
202504,50330000,3S3,0,3,-3,0
202504,50330000,4,2,0,2,NA
202504,50330000,CA,2,14,-12,0.14
202504,50350000,2,11,15,-4,0.73
202504,50350000,3S3,0,1,-1,0
202504,50350000,CA,1,0,1,NA
202504,50350003,CA,1,1,0,1
202504,50370000,2,1,15,-14,0.07
202504,50370000,3S2,1,1,0,1
202504,50370000,3S3,0,17,-17,0
202504,50370000,CA,1,2,-1,0.5
202504,50370001,2,1,7,-6,0.14
202504,50370001,CA,1,2,-1,0.5
202504,50400000,2,0,29,-29,0
202504,50400000,2S2,1,1,0,1
202504,50400000,3S3,0,6,-6,0
202504,50400000,CA,1,31,-30,0.03
202504,50400001,2,0,4,-4,0
202504,50400001,3S3,0,7,-7,0
202504,50450000,2,3,15,-12,0.2
202504,50450000,3,0,1,-1,0
202504,50450000,3S3,0,17,-17,0
202504,50450000,CA,2,4,-2,0.5
202504,50450001,3S3,0,1,-1,0
202504,50568000,2,172,914,-742,0.19
202504,50568000,2R2,0,3,-3,0
202504,50568000,2S1,0,2,-2,0
202504,50568000,2S2,37,59,-22,0.63
202504,50568000,2S3,7,26,-19,0.27
202504,50568000,3,16,65,-49,0.25
202504,50568000,3R2,0,1,-1,0
202504,50568000,3R3,1,10,-9,0.1
202504,50568000,3S1,1,3,-2,0.33
202504,50568000,3S2,1289,578,711,2.23
202504,50568000,3S3,2909,1794,1115,1.62
202504,50568000,3S4,5,8,-3,0.62
202504,50568000,CA,27,226,-199,0.12
202504,50568000,V2R2,0,3,-3,0
202504,50568000,V2R3,3,50,-47,0.06
202504,50568000,V3,3,9,-6,0.33
202504,50568000,V3R2,0,67,-67,0
202504,50568000,V3R3,10,306,-296,0.03
202504,50568000,V4,2,0,2,NA
202504,50568000,V4R2,0,2,-2,0
202504,50568001,2,0,7,-7,0
202504,50568001,3S3,1,1,0,1
202504,50568002,2,0,1,-1,0
202504,50568002,3S3,0,7,-7,0
202504,50568002,CA,0,1,-1,0
202504,50568004,3S2,1,0,1,NA
202504,50568005,2,1,0,1,NA
202504,50568007,2,3,6,-3,0.5
202504,50568007,3,1,0,1,NA
202504,50568007,3S3,1,31,-30,0.03
202504,50568007,CA,1,2,-1,0.5
202504,50568007,V2,0,5,-5,0
202504,50568007,V3,0,14,-14,0
202504,50568007,V3R2,0,8,-8,0
202504,50568007,V3R3,0,5,-5,0
202504,50568008,2,0,1,-1,0
202504,50568008,3S3,0,3,-3,0
202504,50568010,2,12,28,-16,0.43
202504,50568010,2S2,1,2,-1,0.5
202504,50568010,2S3,12,14,-2,0.86
202504,50568010,3S2,1,2,-1,0.5
202504,50568010,3S3,11,37,-26,0.3
202504,50568010,3S4,2,0,2,NA
202504,50568010,CA,0,11,-11,0
202504,50568010,V2,0,9,-9,0
202504,50568010,V3,0,6,-6,0
202504,50568011,2,53,200,-147,0.26
202504,50568011,2S2,4,9,-5,0.44
202504,50568011,2S3,4,16,-12,0.25
202504,50568011,3,2,21,-19,0.1
202504,50568011,3R2,0,3,-3,0
202504,50568011,3R3,0,12,-12,0
202504,50568011,3S1,1,1,0,1
202504,50568011,3S2,58,251,-193,0.23
202504,50568011,3S3,148,724,-576,0.2
202504,50568011,3S4,4,3,1,1.33
202504,50568011,CA,3,41,-38,0.07
202504,50568011,V2R2,0,3,-3,0
202504,50568011,V2R3,0,29,-29,0
202504,50568011,V3,5,8,-3,0.62
202504,50568011,V3R2,0,23,-23,0
202504,50568011,V3R3,0,226,-226,0
202504,50573000,2,65,282,-217,0.23
202504,50573000,2R2,0,1,-1,0
202504,50573000,2S2,3,17,-14,0.18
202504,50573000,2S3,8,7,1,1.14
202504,50573000,3,10,23,-13,0.43
202504,50573000,3R2,4,0,4,NA
202504,50573000,3R3,19,0,19,NA
202504,50573000,3S1,0,3,-3,0
202504,50573000,3S2,260,18,242,14.44
202504,50573000,3S3,774,216,558,3.58
202504,50573000,3S4,0,1,-1,0
202504,50573000,4,1,1,0,1
202504,50573000,CA,9,90,-81,0.1
202504,50573000,V2,49,0,49,NA
202504,50573000,V2R2,6,0,6,NA
202504,50573000,V2R3,73,0,73,NA
202504,50573000,V3,155,0,155,NA
202504,50573000,V3R2,86,0,86,NA
202504,50573000,V3R3,464,0,464,NA
202504,50573000,V4R2,2,0,2,NA
202504,50573001,2,0,1,-1,0
202504,50573001,2S2,1,0,1,NA
202504,50573001,3S3,38,0,38,NA
202504,50573001,V2,6,0,6,NA
202504,50573001,V3,16,0,16,NA
202504,50573001,V3R2,9,0,9,NA
202504,50573001,V3R3,14,0,14,NA
202504,50573003,2,7,8,-1,0.88
202504,50573003,2S2,1,2,-1,0.5
202504,50573003,3,2,0,2,NA
202504,50573003,3S3,6,18,-12,0.33
202504,50573003,CA,1,2,-1,0.5
202504,50577000,2,6,23,-17,0.26
202504,50577000,2S2,0,1,-1,0
202504,50577000,3,0,2,-2,0
202504,50577000,3S2,1,1,0,1
202504,50577000,3S3,3,3,0,1
202504,50577000,CA,1,5,-4,0.2
202504,50590000,2,4,28,-24,0.14
202504,50590000,2S2,0,5,-5,0
202504,50590000,3,1,0,1,NA
202504,50590000,3S2,16,1,15,16
202504,50590000,3S3,110,59,51,1.86
202504,50590000,4,1,0,1,NA
202504,50590000,CA,2,5,-3,0.4
202504,50590000,V3,178,0,178,NA
202504,50606000,2,14,220,-206,0.06
202504,50606000,2R2,0,2,-2,0
202504,50606000,2S2,5,3,2,1.67
202504,50606000,2S3,1,1,0,1
202504,50606000,3,1,57,-56,0.02
202504,50606000,3R2,2,0,2,NA
202504,50606000,3R3,4,0,4,NA
202504,50606000,3S2,2,35,-33,0.06
202504,50606000,3S3,67,64,3,1.05
202504,50606000,4,0,1,-1,0
202504,50606000,CA,16,76,-60,0.21
202504,50606000,V3,0,6,-6,0
202504,50680000,2,16,89,-73,0.18
202504,50680000,2S2,2,4,-2,0.5
202504,50680000,2S3,2,6,-4,0.33
202504,50680000,3,16,40,-24,0.4
202504,50680000,3R2,18,0,18,NA
202504,50680000,3R3,5,0,5,NA
202504,50680000,3S2,98,116,-18,0.84
202504,50680000,3S3,638,290,348,2.2
202504,50680000,CA,4,16,-12,0.25
202504,50680000,V2,0,17,-17,0
202504,50680000,V3,6,389,-383,0.02
202504,50680000,V3R2,30,0,30,NA
202504,50680000,V3R3,12,0,12,NA
202504,50680001,3S2,1,0,1,NA
202504,50680002,3S2,1,1,0,1
202504,50680003,2,2,2,0,1
202504,50680003,3S3,1,14,-13,0.07
202504,50683000,2,3,21,-18,0.14
202504,50683000,2S2,0,1,-1,0
202504,50683000,3S2,1,0,1,NA
202504,50683000,3S3,1,6,-5,0.17
202504,50683000,CA,1,5,-4,0.2
202504,50686000,CA,1,0,1,NA
202504,50689000,2,126,126,0,1
202504,50689000,2R2,0,1,-1,0
202504,50689000,2S2,2,1,1,2
202504,50689000,2S3,1,0,1,NA
202504,50689000,3,8,4,4,2
202504,50689000,3S2,56,3,53,18.67
202504,50689000,3S3,304,54,250,5.63
202504,50689000,4,1,1,0,1
202504,50689000,CA,53,31,22,1.71
202504,50689000,V3,0,178,-178,0
202504,50711000,2,3,71,-68,0.04
202504,50711000,2S2,2,0,2,NA
202504,50711000,3,1,1,0,1
202504,50711000,3S2,1,0,1,NA
202504,50711000,3S3,2,24,-22,0.08
202504,50711000,CA,2,22,-20,0.09
202504,50711000,V2,2,0,2,NA
202504,50711000,V3,17,0,17,NA
202504,50711001,2,1,0,1,NA
202504,52001000,2,3210,4524,-1314,0.71
202504,52001000,2S2,49,345,-296,0.14
202504,52001000,2S3,19,89,-70,0.21
202504,52001000,3,15,104,-89,0.14
202504,52001000,3S2,301,399,-98,0.75
202504,52001000,3S3,305,1603,-1298,0.19
202504,52001000,3S4,0,2,-2,0
202504,52001000,CA,1365,523,842,2.61
202504,52001000,V3,0,1,-1,0
202504,52001001,2,42,46,-4,0.91
202504,52001001,3,3,0,3,NA
202504,52001001,3S2,12,0,12,NA
202504,52001001,3S3,4,5,-1,0.8
202504,52001001,CA,19,23,-4,0.83
202504,52001003,2,0,7,-7,0
202504,52001003,3S3,0,1,-1,0
202504,52001003,CA,0,24,-24,0
202504,52001004,3S2,0,1,-1,0
202504,52001006,2,7,10,-3,0.7
202504,52001006,3S3,0,2,-2,0
202504,52001006,CA,0,1,-1,0
202504,52001010,2,0,4,-4,0
202504,52001039,2,0,5,-5,0
202504,52001052,3,2,1,1,2
202504,52019000,2,2,27,-25,0.07
202504,52019000,3,0,1,-1,0
202504,52019003,2,1,4,-3,0.25
202504,52019003,CA,0,21,-21,0
202504,52022000,2,0,10,-10,0
202504,52022000,CA,0,25,-25,0
202504,52036000,2,0,3,-3,0
202504,52036000,CA,0,20,-20,0
202504,52051000,2,0,7,-7,0
202504,52051000,CA,0,1,-1,0
202504,52079000,2,3,94,-91,0.03
202504,52079000,3,0,1,-1,0
202504,52079000,3S3,0,1,-1,0
202504,52079000,CA,0,24,-24,0
202504,52079012,2,0,6,-6,0
202504,52079019,CA,0,1,-1,0
202504,52083000,2,7,16,-9,0.44
202504,52083000,3,0,1,-1,0
202504,52083000,CA,0,22,-22,0
202504,52110000,2,6,50,-44,0.12
202504,52110000,2S2,0,1,-1,0
202504,52110000,3,1,0,1,NA
202504,52110000,3S2,1,0,1,NA
202504,52110000,3S3,2,13,-11,0.15
202504,52110000,CA,0,15,-15,0
202504,52110000,V3,1,0,1,NA
202504,52110007,2,2,1,1,2
202504,52203000,2,1,23,-22,0.04
202504,52203000,3,0,3,-3,0
202504,52203000,CA,0,32,-32,0
202504,52203001,2,0,1,-1,0
202504,52203004,2,2,0,2,NA
202504,52203007,2,0,10,-10,0
202504,52203007,CA,0,3,-3,0
202504,52207000,2,1,32,-31,0.03
202504,52207000,3,0,1,-1,0
202504,52207000,3S2,0,1,-1,0
202504,52207000,3S3,1,0,1,NA
202504,52207000,CA,0,23,-23,0
202504,52207003,CA,0,1,-1,0
202504,52210000,2,1,7,-6,0.14
202504,52210000,3S2,1,0,1,NA
202504,52210000,CA,0,6,-6,0
202504,52215000,2,0,21,-21,0
202504,52215000,CA,1,28,-27,0.04
202504,52215002,2,0,4,-4,0
202504,52215004,2,0,7,-7,0
202504,52224000,2,1,36,-35,0.03
202504,52224000,3S3,14,0,14,NA
202504,52224000,CA,0,6,-6,0
202504,52227000,2,6,97,-91,0.06
202504,52227000,3S2,0,1,-1,0
202504,52227000,3S3,2,13,-11,0.15
202504,52227000,CA,0,31,-31,0
202504,52233000,2,0,4,-4,0
202504,52233003,2,0,1,-1,0
202504,52240000,2,7,30,-23,0.23
202504,52240000,3S2,2,1,1,2
202504,52240000,3S3,0,4,-4,0
202504,52240000,CA,38,24,14,1.58
202504,52250000,2,0,4,-4,0
202504,52254000,2,1,18,-17,0.06
202504,52254000,CA,0,1,-1,0
202504,52254002,2,0,1,-1,0
202504,52256000,2,1,5,-4,0.2
202504,52256000,3,1,0,1,NA
202504,52256000,CA,0,20,-20,0
202504,52256003,2,0,4,-4,0
202504,52256005,2,0,5,-5,0
202504,52256016,2,0,2,-2,0
202504,52256017,2,0,4,-4,0
202504,52256021,2,0,2,-2,0
202504,52256021,3S3,0,2,-2,0
202504,52258000,2,2,24,-22,0.08
202504,52258000,3,1,0,1,NA
202504,52258001,2,0,1,-1,0
202504,52258003,2,0,4,-4,0
202504,52258003,CA,0,7,-7,0
202504,52258004,2,0,1,-1,0
202504,52260000,2,24,70,-46,0.34
202504,52260000,CA,1,11,-10,0.09
202504,52260009,2,17,3,14,5.67
202504,52260009,3S3,0,1,-1,0
202504,52287000,2,0,11,-11,0
202504,52287000,CA,0,9,-9,0
202504,52317000,2,4,139,-135,0.03
202504,52317000,3,0,1,-1,0
202504,52317000,3S2,1,0,1,NA
202504,52317000,3S3,1,26,-25,0.04
202504,52317000,CA,0,31,-31,0
202504,52320000,2,2,23,-21,0.09
202504,52320000,3S2,1,0,1,NA
202504,52320000,3S3,0,4,-4,0
202504,52320000,CA,0,11,-11,0
202504,52320001,2,0,1,-1,0
202504,52320001,2S2,0,4,-4,0
202504,52320001,2S3,0,2,-2,0
202504,52320001,CA,0,3,-3,0
202504,52323000,2,0,10,-10,0
202504,52352000,2,2,18,-16,0.11
202504,52352000,3S3,0,1,-1,0
202504,52352000,CA,0,13,-13,0
202504,52354000,2,1,5,-4,0.2
202504,52354000,CA,0,18,-18,0
202504,52354002,2,0,1,-1,0
202504,52354002,3S3,0,1,-1,0
202504,52356000,2,590,2977,-2387,0.2
202504,52356000,2S2,59,82,-23,0.72
202504,52356000,2S3,13,24,-11,0.54
202504,52356000,3,10,26,-16,0.38
202504,52356000,3S2,72,149,-77,0.48
202504,52356000,3S3,1030,986,44,1.04
202504,52356000,3S4,1,2,-1,0.5
202504,52356000,CA,192,349,-157,0.55
202504,52356001,CA,0,1,-1,0
202504,52356003,2,0,16,-16,0
202504,52356003,3S3,0,45,-45,0
202504,52356006,2,0,2,-2,0
202504,52356009,2,0,2,-2,0
202504,52378000,2,0,51,-51,0
202504,52378000,3,0,7,-7,0
202504,52378000,3S3,0,2,-2,0
202504,52378000,CA,0,33,-33,0
202504,52378009,2,0,1,-1,0
202504,52381000,2,1,5,-4,0.2
202504,52381000,3S3,0,1,-1,0
202504,52381000,CA,0,21,-21,0
202504,52385000,2,0,22,-22,0
202504,52385000,CA,0,11,-11,0
202504,52385001,2,0,1,-1,0
202504,52385007,2,0,1,-1,0
202504,52399000,2,132,271,-139,0.49
202504,52399000,2S2,0,1,-1,0
202504,52399000,3,1,2,-1,0.5
202504,52399000,3S2,0,1,-1,0
202504,52399000,3S3,4,46,-42,0.09
202504,52399000,CA,29,72,-43,0.4
202504,52399001,2,0,4,-4,0
202504,52399003,3,0,1,-1,0
202504,52405000,2,0,17,-17,0
202504,52405000,3,0,1,-1,0
202504,52405000,CA,0,2,-2,0
202504,52405004,2,0,8,-8,0
202504,52405004,3,0,1,-1,0
202504,52405005,2,0,1,-1,0
202504,52405005,3,0,1,-1,0
202504,52405005,3S3,0,2,-2,0
202504,52405008,2,6,1,5,6
202504,52405008,CA,0,8,-8,0
202504,52411000,2,1,37,-36,0.03
202504,52411000,CA,0,25,-25,0
202504,52418000,2,1,23,-22,0.04
202504,52418000,3S3,0,2,-2,0
202504,52427000,2,0,1,-1,0
202504,52427000,3S2,0,1,-1,0
202504,52435000,2,0,2,-2,0
202504,52435000,CA,0,11,-11,0
202504,52435001,2,0,2,-2,0
202504,52473000,2,2,2,0,1
202504,52473000,2S2,2,0,2,NA
202504,52473000,3S2,0,2,-2,0
202504,52473000,3S3,0,1,-1,0
202504,52473000,CA,0,2,-2,0
202504,52473010,2,0,2,-2,0
202504,52480000,2,2,22,-20,0.09
202504,52480000,3S3,0,3,-3,0
202504,52480000,CA,0,5,-5,0
202504,52506000,2,0,3,-3,0
202504,52506000,CA,0,13,-13,0
202504,52520001,2,0,4,-4,0
202504,52520003,2,0,2,-2,0
202504,52540000,2,3,29,-26,0.1
202504,52540000,CA,0,4,-4,0
202504,52540002,2,0,5,-5,0
202504,52560000,2,0,12,-12,0
202504,52560000,3S3,0,1,-1,0
202504,52560000,CA,0,25,-25,0
202504,52565000,2,0,2,-2,0
202504,52565000,CA,0,11,-11,0
202504,52573000,2,1,26,-25,0.04
202504,52573000,3S3,0,1,-1,0
202504,52573000,CA,4,23,-19,0.17
202504,52573004,2,0,1,-1,0
202504,52573004,3S3,0,1,-1,0
202504,52585000,2,3,87,-84,0.03
202504,52585000,3,0,1,-1,0
202504,52585000,3S3,13,20,-7,0.65
202504,52585000,CA,0,41,-41,0
202504,52585004,3S3,3,0,3,NA
202504,52612000,2,0,51,-51,0
202504,52612000,3S2,0,1,-1,0
202504,52612000,CA,0,13,-13,0
202504,52678000,2,6,95,-89,0.06
202504,52678000,3S2,0,4,-4,0
202504,52678000,3S3,0,2,-2,0
202504,52678000,CA,0,43,-43,0
202504,52678017,2,0,2,-2,0
202504,52678017,2S2,0,4,-4,0
202504,52678017,2S3,0,15,-15,0
202504,52678017,CA,1,0,1,NA
202504,52683000,2,29,77,-48,0.38
202504,52683000,3,0,1,-1,0
202504,52683000,3S3,1,15,-14,0.07
202504,52683000,CA,2,41,-39,0.05
202504,52683000,V2,0,1,-1,0
202504,52683003,2,0,2,-2,0
202504,52683021,3S3,0,3,-3,0
202504,52683024,3S3,0,1,-1,0
202504,52685000,2,12,31,-19,0.39
202504,52685000,3,0,2,-2,0
202504,52685000,CA,0,24,-24,0
202504,52687000,2,0,27,-27,0
202504,52687000,3S3,0,13,-13,0
202504,52687000,CA,0,25,-25,0
202504,52687003,2,0,1,-1,0
202504,52693000,2,3,75,-72,0.04
202504,52693000,3,0,1,-1,0
202504,52693000,3S2,1,0,1,NA
202504,52693000,3S3,0,2,-2,0
202504,52693000,CA,0,31,-31,0
202504,52694000,2,0,5,-5,0
202504,52696000,3,0,1,-1,0
202504,52696005,CA,0,1,-1,0
202504,52699000,2,0,2,-2,0
202504,52720000,2,0,8,-8,0
202504,52720000,3S3,1,1,0,1
202504,52720000,CA,0,6,-6,0
202504,52720001,2,1,0,1,NA
202504,52720001,3S2,0,2,-2,0
202504,52720001,3S3,0,1,-1,0
202504,52786000,2,2,69,-67,0.03
202504,52786000,3,0,3,-3,0
202504,52786000,3S2,0,1,-1,0
202504,52786000,3S3,0,2,-2,0
202504,52786000,CA,0,37,-37,0
202504,52786002,3,1,0,1,NA
202504,52786019,2,4,19,-15,0.21
202504,52786019,3S2,6,2,4,3
202504,52786019,3S3,1,12,-11,0.08
202504,52788000,2,17,8,9,2.12
202504,52788000,3,1,0,1,NA
202504,52788000,CA,0,21,-21,0
202504,52788001,2,0,2,-2,0
202504,52788007,3S3,1,0,1,NA
202504,52835000,2,53,1080,-1027,0.05
202504,52835000,2S2,2,6,-4,0.33
202504,52835000,2S3,0,1,-1,0
202504,52835000,3,13,42,-29,0.31
202504,52835000,3S2,7,59,-52,0.12
202504,52835000,3S3,131,260,-129,0.5
202504,52835000,3S4,0,1,-1,0
202504,52835000,CA,26,168,-142,0.15
202504,52835004,2,1,2,-1,0.5
202504,52835017,2,0,1,-1,0
202504,52835017,3S2,2,0,2,NA
202504,52835017,3S3,0,1,-1,0
202504,52835017,CA,0,1,-1,0
202504,52835030,2,1,0,1,NA
202504,52835030,CA,0,1,-1,0
202504,52835031,2,3,85,-82,0.04
202504,52835031,3,2,3,-1,0.67
202504,52835031,3S2,15,0,15,NA
202504,52835031,3S3,14,2,12,7
202504,52835031,3S4,1,0,1,NA
202504,52835031,CA,0,3,-3,0
202504,52835062,2,0,6,-6,0
202504,52835141,3S2,4,0,4,NA
202504,52835159,2,0,1,-1,0
202504,52835159,CA,0,1,-1,0
202504,52835160,3S2,24,0,24,NA
202504,52835160,3S3,12,0,12,NA
202504,52835163,3,0,4,-4,0
202504,52838000,2,23,341,-318,0.07
202504,52838000,2S2,1,7,-6,0.14
202504,52838000,3,0,4,-4,0
202504,52838000,3S3,4,68,-64,0.06
202504,52838000,CA,103,86,17,1.2
202504,52838001,2,0,1,-1,0
202504,52885000,2,0,31,-31,0
202504,52885000,3,0,1,-1,0
202504,52885000,3S2,1,1,0,1
202504,52885000,3S3,6,1,5,6
202504,52885000,CA,0,16,-16,0
202504,54001000,2,4390,8557,-4167,0.51
202504,54001000,2B1,0,1,-1,0
202504,54001000,2R2,65,3,62,21.67
202504,54001000,2S2,169,431,-262,0.39
202504,54001000,2S3,20,101,-81,0.2
202504,54001000,3,250,387,-137,0.65
202504,54001000,3R3,0,16,-16,0
202504,54001000,3S1,1,0,1,NA
202504,54001000,3S2,252,557,-305,0.45
202504,54001000,3S3,4502,4296,206,1.05
202504,54001000,3S4,1,4,-3,0.25
202504,54001000,4,1,2,-1,0.5
202504,54001000,CA,988,1281,-293,0.77
202504,54001000,V2,206,100,106,2.06
202504,54001000,V3,84,19,65,4.42
202504,54001000,V4,85,328,-243,0.26
202504,54001001,2,3,23,-20,0.13
202504,54001001,3S3,2,36,-34,0.06
202504,54001001,CA,0,23,-23,0
202504,54001015,2,0,2,-2,0
202504,54001017,2,0,2,-2,0
202504,54001017,2S2,0,1,-1,0
202504,54001017,3S3,102,8,94,12.75
202504,54001018,V2,64,0,64,NA
202504,54001018,V3,25,0,25,NA
202504,54001025,2,1,1,0,1
202504,54001025,3S3,2,0,2,NA
202504,54001026,3S3,1,15,-14,0.07
202504,54001027,3S3,10,0,10,NA
202504,54001042,2,6,13,-7,0.46
202504,54001042,3S3,7,11,-4,0.64
202504,54001045,2,1,1,0,1
202504,54001047,2,0,7,-7,0
202504,54001047,3,0,7,-7,0
202504,54001049,CA,0,1,-1,0
202504,54003000,2,31,291,-260,0.11
202504,54003000,3,1,8,-7,0.12
202504,54003000,3S3,2,20,-18,0.1
202504,54003000,CA,1,17,-16,0.06
202504,54003012,CA,1,0,1,NA
202504,54003014,2,1,0,1,NA
202504,54003018,2,0,2,-2,0
202504,54003020,2,0,1,-1,0
202504,54051000,2,1,28,-27,0.04
202504,54051000,CA,0,25,-25,0
202504,54099000,2,25,31,-6,0.81
202504,54099000,2S2,1,4,-3,0.25
202504,54099000,3,4,0,4,NA
202504,54099000,3R3,13,0,13,NA
202504,54099000,3S3,217,7,210,31
202504,54099000,V2,40,0,40,NA
202504,54099002,2,10,0,10,NA
202504,54099002,2S2,2,0,2,NA
202504,54099002,3S2,1,1,0,1
202504,54099002,3S3,33,0,33,NA
202504,54099002,V2,52,0,52,NA
202504,54109000,2,0,23,-23,0
202504,54128000,2,0,4,-4,0
202504,54128000,CA,0,6,-6,0
202504,54128007,2,0,4,-4,0
202504,54172000,2,4,102,-98,0.04
202504,54172000,2S2,6,0,6,NA
202504,54172000,3,0,20,-20,0
202504,54172000,3S2,3,1,2,3
202504,54172000,3S3,1,2,-1,0.5
202504,54172000,CA,1,11,-10,0.09
202504,54172000,V2,0,28,-28,0
202504,54174000,2,21,16,5,1.31
202504,54174000,2S2,2,0,2,NA
202504,54174000,3S2,0,1,-1,0
202504,54174000,3S3,2,3,-1,0.67
202504,54174000,CA,0,8,-8,0
202504,54174000,V2,34,0,34,NA
202504,54206000,2,0,14,-14,0
202504,54206000,3S3,1,1,0,1
202504,54206002,2,1,0,1,NA
202504,54206010,2,1,1,0,1
202504,54206010,3,4,2,2,2
202504,54206010,3S3,4,6,-2,0.67
202504,54206013,2,0,19,-19,0
202504,54206013,2S3,0,1,-1,0
202504,54206013,3,0,1,-1,0
202504,54206013,CA,0,3,-3,0
202504,54223000,2,2,7,-5,0.29
202504,54223000,CA,0,26,-26,0
202504,54239000,2,0,13,-13,0
202504,54239000,2S2,0,1,-1,0
202504,54239000,3,0,2,-2,0
202504,54239000,V2,31,0,31,NA
202504,54245000,2,0,7,-7,0
202504,54245006,2,0,6,-6,0
202504,54250000,2,0,3,-3,0
202504,54250000,3,0,1,-1,0
202504,54261000,2,87,230,-143,0.38
202504,54261000,2S2,0,3,-3,0
202504,54261000,2S3,2,1,1,2
202504,54261000,3,10,23,-13,0.43
202504,54261000,3S2,5,4,1,1.25
202504,54261000,3S3,1575,79,1496,19.94
202504,54261000,CA,2,77,-75,0.03
202504,54261000,V2,37,224,-187,0.17
202504,54261000,V3,30,0,30,NA
202504,54261000,V4,2,0,2,NA
202504,54261003,2,0,12,-12,0
202504,54261005,2,3,0,3,NA
202504,54261005,3S2,1,1,0,1
202504,54261007,2,3,2,1,1.5
202504,54261007,3S2,2,0,2,NA
202504,54261007,3S3,1,2,-1,0.5
202504,54261007,CA,0,23,-23,0
202504,54313000,2,3,5,-2,0.6
202504,54313000,3S3,0,1,-1,0
202504,54344000,2,0,3,-3,0
202504,54347000,V2,28,0,28,NA
202504,54347002,2,1,2,-1,0.5
202504,54377000,2,1,7,-6,0.14
202504,54377000,CA,0,3,-3,0
202504,54385000,2,44,31,13,1.42
202504,54385000,3,0,3,-3,0
202504,54385000,3S3,28,8,20,3.5
202504,54385000,CA,0,12,-12,0
202504,54398000,2,0,16,-16,0
202504,54405000,2,603,460,143,1.31
202504,54405000,2S2,0,5,-5,0
202504,54405000,2S3,3,7,-4,0.43
202504,54405000,3,75,20,55,3.75
202504,54405000,3R3,1,0,1,NA
202504,54405000,3S2,4,14,-10,0.29
202504,54405000,3S3,180,1014,-834,0.18
202504,54405000,CA,21,138,-117,0.15
202504,54405000,V2,117,45,72,2.6
202504,54405000,V3,11,33,-22,0.33
202504,54405001,2S2,1,0,1,NA
202504,54405001,3S2,1,0,1,NA
202504,54405001,3S3,0,1,-1,0
202504,54405003,2,16,0,16,NA
202504,54405003,2S2,0,1,-1,0
202504,54405003,3,3,2,1,1.5
202504,54405003,3S3,2,0,2,NA
202504,54405004,2,2,0,2,NA
202504,54405004,3S3,0,1,-1,0
202504,54418000,2,2,2,0,1
202504,54480000,2,1,5,-4,0.2
202504,54480001,2,0,6,-6,0
202504,54498000,2,197,2270,-2073,0.09
202504,54498000,2S2,3,3,0,1
202504,54498000,2S3,0,3,-3,0
202504,54498000,3,0,86,-86,0
202504,54498000,3S2,2,9,-7,0.22
202504,54498000,3S3,7,359,-352,0.02
202504,54498000,CA,8,139,-131,0.06
202504,54498000,V3,0,13,-13,0
202504,54498001,2,0,5,-5,0
202504,54498002,2,0,2,-2,0
202504,54498003,3S3,0,8,-8,0
202504,54498006,3S3,0,1,-1,0
202504,54498008,2,0,4,-4,0
202504,54498008,3,0,2,-2,0
202504,54498009,2,0,1,-1,0
202504,54498021,CA,0,4,-4,0
202504,54518000,2,23,411,-388,0.06
202504,54518000,2S2,5,0,5,NA
202504,54518000,3,0,6,-6,0
202504,54518000,3R3,2,0,2,NA
202504,54518000,3S1,0,1,-1,0
202504,54518000,3S2,2,4,-2,0.5
202504,54518000,3S3,340,51,289,6.67
202504,54518000,3S4,1,0,1,NA
202504,54518000,CA,2,94,-92,0.02
202504,54518000,V2,0,49,-49,0
202504,54518000,V3,0,111,-111,0
202504,54518000,V4,30,0,30,NA
202504,54520000,2,0,11,-11,0
202504,54520000,2S2,0,1,-1,0
202504,54520000,3S2,1,0,1,NA
202504,54520000,3S3,2,0,2,NA
202504,54520000,CA,0,2,-2,0
202504,54520000,V2,30,0,30,NA
202504,54520000,V4,10,0,10,NA
202504,54520001,2,2,1,1,2
202504,54520001,2S2,2,1,1,2
202504,54520001,3S3,0,1,-1,0
202504,54553000,2,1,69,-68,0.01
202504,54553000,2S2,1,0,1,NA
202504,54553000,3S2,1,0,1,NA
202504,54553000,3S3,14,1,13,14
202504,54553000,CA,0,37,-37,0
202504,54599000,2,0,8,-8,0
202504,54660000,2,24,11,13,2.18
202504,54660000,3S2,1,0,1,NA
202504,54660000,CA,0,31,-31,0
202504,54660000,V2,23,0,23,NA
202504,54670000,2,0,2,-2,0
202504,54673000,2,5,42,-37,0.12
202504,54673000,2S2,7,1,6,7
202504,54673000,2S3,2,0,2,NA
202504,54673000,3,1,17,-16,0.06
202504,54673000,3S2,0,1,-1,0
202504,54673000,3S3,585,2,583,292.5
202504,54673000,CA,0,34,-34,0
202504,54673000,V2,1,122,-121,0.01
202504,54673000,V3,0,88,-88,0
202504,54673000,V4,27,16,11,1.69
202504,54673005,2,0,3,-3,0
202504,54673005,3S2,0,1,-1,0
202504,54673005,3S3,68,0,68,NA
202504,54673005,V2,0,92,-92,0
202504,54673005,V3,0,36,-36,0
202504,54680000,2,2,10,-8,0.2
202504,54680000,2S2,0,2,-2,0
202504,54680000,3S2,0,1,-1,0
202504,54680000,4,0,1,-1,0
202504,54680000,CA,0,25,-25,0
202504,54680000,V2,0,30,-30,0
202504,54720000,2,10,84,-74,0.12
202504,54720000,2S2,5,3,2,1.67
202504,54720000,2S3,8,0,8,NA
202504,54720000,3,3,5,-2,0.6
202504,54720000,3S2,12,1,11,12
202504,54720000,3S3,2537,22,2515,115.32
202504,54720000,4,1,0,1,NA
202504,54720000,CA,1,9,-8,0.11
202504,54720000,V2,73,0,73,NA
202504,54720000,V3,30,0,30,NA
202504,54720000,V4,351,0,351,NA
202504,54720002,2,0,9,-9,0
202504,54720024,2,0,7,-7,0
202504,54720024,3S3,0,1,-1,0
202504,54720024,CA,0,1,-1,0
202504,54743000,2,0,13,-13,0
202504,54743000,CA,0,10,-10,0
202504,54800000,2,0,15,-15,0
202504,54810000,2,18,124,-106,0.15
202504,54810000,2S2,3,2,1,1.5
202504,54810000,2S3,2,0,2,NA
202504,54810000,3,0,15,-15,0
202504,54810000,3S2,5,1,4,5
202504,54810000,3S3,480,86,394,5.58
202504,54810000,3S4,2,0,2,NA
202504,54810000,4,0,1,-1,0
202504,54810000,CA,1,30,-29,0.03
202504,54810002,2,0,6,-6,0
202504,54810017,2,3,2,1,1.5
202504,54810017,3S2,15,1,14,15
202504,54810017,3S3,139,3,136,46.33
202504,54810017,CA,0,23,-23,0
202504,54820000,2,6,36,-30,0.17
202504,54820000,2S2,0,1,-1,0
202504,54820000,3,20,0,20,NA
202504,54820000,3S2,0,1,-1,0
202504,54820000,3S3,162,9,153,18
202504,54820000,4,2,0,2,NA
202504,54820000,CA,0,1,-1,0
202504,54820000,V2,15,0,15,NA
202504,54820000,V3,111,0,111,NA
202504,54820004,2,1,4,-3,0.25
202504,54820008,2,0,1,-1,0
202504,54820015,2,0,3,-3,0
202504,54820015,2S1,0,1,-1,0
202504,54820015,2S2,0,1,-1,0
202504,54820015,2S3,0,1,-1,0
202504,54820015,3,9,0,9,NA
202504,54820015,3S1,0,9,-9,0
202504,54820015,3S2,1,1,0,1
202504,54820015,3S3,3,30,-27,0.1
202504,54871000,2,0,1,-1,0
202504,54874000,2,152,293,-141,0.52
202504,54874000,2S2,7,3,4,2.33
202504,54874000,2S3,3,2,1,1.5
202504,54874000,3,3,7,-4,0.43
202504,54874000,3S2,6,21,-15,0.29
202504,54874000,3S3,3,781,-778,0
202504,54874000,CA,1,321,-320,0
202504,54874000,V2,0,25,-25,0
202504,54874000,V3,0,1,-1,0
202504,54874005,2,25,2,23,12.5
202504,54874005,3,2,0,2,NA
202504,54874005,3S3,10,0,10,NA
202504,63001000,2,2144,5054,-2910,0.42
202504,63001000,2R2,0,26,-26,0
202504,63001000,2S2,7,189,-182,0.04
202504,63001000,2S3,12,26,-14,0.46
202504,63001000,3,115,300,-185,0.38
202504,63001000,3S1,0,1,-1,0
202504,63001000,3S2,57,122,-65,0.47
202504,63001000,3S3,449,1182,-733,0.38
202504,63001000,3S4,0,1,-1,0
202504,63001000,4,20,4,16,5
202504,63001000,CA,385,1348,-963,0.29
202504,63001000,V2,1,0,1,NA
202504,63001000,V2R2,1,3,-2,0.33
202504,63001001,2,10,3,7,3.33
202504,63001001,3S3,1,0,1,NA
202504,63001001,CA,1,0,1,NA
202504,63111000,2,43,26,17,1.65
202504,63111000,3,0,2,-2,0
202504,63130000,2,142,688,-546,0.21
202504,63130000,2R2,0,3,-3,0
202504,63130000,2S2,5,3,2,1.67
202504,63130000,2S3,0,1,-1,0
202504,63130000,3,0,57,-57,0
202504,63130000,3S1,1,1,0,1
202504,63130000,3S2,103,97,6,1.06
202504,63130000,3S3,65,377,-312,0.17
202504,63130000,CA,15,178,-163,0.08
202504,63130000,V2R2,1,2,-1,0.5
202504,63130001,2,5,4,1,1.25
202504,63130001,3,0,1,-1,0
202504,63130001,CA,0,11,-11,0
202504,63130001,V3,2,0,2,NA
202504,63130004,2,1,2,-1,0.5
202504,63130004,CA,0,3,-3,0
202504,63190000,2,82,298,-216,0.28
202504,63190000,3,2,67,-65,0.03
202504,63190000,3S3,0,4,-4,0
202504,63190000,CA,7,58,-51,0.12
202504,63190019,3S2,0,1,-1,0
202504,63212000,2,1,23,-22,0.04
202504,63212000,CA,0,2,-2,0
202504,63272000,2,27,114,-87,0.24
202504,63272000,3S3,1,5,-4,0.2
202504,63272000,CA,3,41,-38,0.07
202504,63272000,V2,0,2,-2,0
202504,63302000,2,2,30,-28,0.07
202504,63302000,CA,0,44,-44,0
202504,63401000,2,862,974,-112,0.89
202504,63401000,2S2,36,23,13,1.57
202504,63401000,2S3,11,16,-5,0.69
202504,63401000,3,1,23,-22,0.04
202504,63401000,3S2,235,41,194,5.73
202504,63401000,3S3,113,149,-36,0.76
202504,63401000,CA,10,158,-148,0.06
202504,63401000,V2R2,3,0,3,NA
202504,63401000,V3,0,1,-1,0
202504,63401001,2,1,0,1,NA
202504,63401001,2S2,1,1,0,1
202504,63401001,2S3,1,0,1,NA
202504,63401001,3S2,0,9,-9,0
202504,63401001,3S3,1,0,1,NA
202504,63401001,CA,0,1,-1,0
202504,63401001,V2R2,1,0,1,NA
202504,63470000,2,91,335,-244,0.27
202504,63470000,2S2,2,1,1,2
202504,63470000,2S3,1,0,1,NA
202504,63470000,3,0,21,-21,0
202504,63470000,3S2,0,9,-9,0
202504,63470000,3S3,0,24,-24,0
202504,63470000,CA,3,117,-114,0.03
202504,63470003,2,4,20,-16,0.2
202504,63470003,3,0,2,-2,0
202504,63470003,3S2,0,1,-1,0
202504,63470003,V2,0,1,-1,0
202504,63470004,2,0,1,-1,0
202504,63548000,2,36,48,-12,0.75
202504,63548000,3,0,4,-4,0
202504,63548000,CA,0,14,-14,0
202504,63594000,2,335,391,-56,0.86
202504,63594000,2S2,0,4,-4,0
202504,63594000,3,1,82,-81,0.01
202504,63594000,3S2,2,1,1,2
202504,63594000,3S3,14,24,-10,0.58
202504,63594000,CA,4,109,-105,0.04
202504,63594000,V2R2,0,2,-2,0
202504,63690000,2,37,116,-79,0.32
202504,63690000,3S3,0,1,-1,0
202504,63690000,CA,1,49,-48,0.02
202504,66001000,2,13260,9686,3574,1.37
202504,66001000,2R2,170,7,163,24.29
202504,66001000,2S1,0,2,-2,0
202504,66001000,2S2,1349,1386,-37,0.97
202504,66001000,2S3,135,289,-154,0.47
202504,66001000,3,428,231,197,1.85
202504,66001000,3S1,1,4,-3,0.25
202504,66001000,3S2,627,1026,-399,0.61
202504,66001000,3S3,1248,3114,-1866,0.4
202504,66001000,3S4,5,8,-3,0.62
202504,66001000,4,6,6,0,1
202504,66001000,CA,2965,3033,-68,0.98
202504,66001000,V3,1,2,-1,0.5
202504,66001001,2,1,4,-3,0.25
202504,66001002,2,0,1,-1,0
202504,66001005,2,110,4,106,27.5
202504,66001005,3,0,51,-51,0
202504,66001010,2,0,3,-3,0
202504,66001010,3S2,1,0,1,NA
202504,66001012,2,1,0,1,NA
202504,66001015,2,0,5,-5,0
202504,66001015,2S2,1,0,1,NA
202504,66001018,2,3,7,-4,0.43
202504,66001018,2S2,0,2,-2,0
202504,66001018,3,0,1,-1,0
202504,66001018,3S3,0,4,-4,0
202504,66001022,3S2,0,1,-1,0
202504,66001031,2,0,9,-9,0
202504,66001036,2,0,1,-1,0
202504,66001037,3S2,0,1,-1,0
202504,66001037,3S3,0,1,-1,0
202504,66001041,2,0,1,-1,0
202504,66001049,2,0,1,-1,0
202504,66001053,2,0,35,-35,0
202504,66001053,3S3,0,4,-4,0
202504,66001056,2,0,2,-2,0
202504,66001069,2,0,2,-2,0
202504,66001072,2,30,1,29,30
202504,66001072,3,1,6,-5,0.17
202504,66001080,2,48,528,-480,0.09
202504,66001080,3S2,9,0,9,NA
202504,66045000,2,39,139,-100,0.28
202504,66045000,3S2,1,1,0,1
202504,66045000,3S3,0,1,-1,0
202504,66045000,CA,0,39,-39,0
202504,66045001,2S3,1,0,1,NA
202504,66045001,3S3,0,1,-1,0
202504,66075000,2,21,27,-6,0.78
202504,66075000,3S2,1,3,-2,0.33
202504,66075000,3S3,280,46,234,6.09
202504,66075000,CA,0,10,-10,0
202504,66075006,2,0,1,-1,0
202504,66075006,CA,0,1,-1,0
202504,66088000,2,8,165,-157,0.05
202504,66088000,3S3,0,4,-4,0
202504,66088000,CA,0,80,-80,0
202504,66170000,2,8648,4273,4375,2.02
202504,66170000,2R2,8,3,5,2.67
202504,66170000,2S2,407,310,97,1.31
202504,66170000,2S3,54,88,-34,0.61
202504,66170000,3,135,219,-84,0.62
202504,66170000,3S2,1640,756,884,2.17
202504,66170000,3S3,426,1047,-621,0.41
202504,66170000,3S4,0,1,-1,0
202504,66170000,4,7,4,3,1.75
202504,66170000,CA,5529,651,4878,8.49
202504,66170004,2S2,0,1,-1,0
202504,66170008,2,0,3,-3,0
202504,66170011,2,0,5,-5,0
202504,66318000,2,50,102,-52,0.49
202504,66318000,3S2,9,3,6,3
202504,66318000,3S3,17,6,11,2.83
202504,66318000,CA,0,18,-18,0
202504,66318002,2,0,1,-1,0
202504,66318002,3S2,8,1,7,8
202504,66318002,3S3,3,0,3,NA
202504,66383000,2,1,24,-23,0.04
202504,66383000,CA,0,22,-22,0
202504,66400000,2,757,544,213,1.39
202504,66400000,2S2,5,20,-15,0.25
202504,66400000,2S3,1,43,-42,0.02
202504,66400000,3,9,20,-11,0.45
202504,66400000,3S2,30,49,-19,0.61
202504,66400000,3S3,86,148,-62,0.58
202504,66400000,CA,20,160,-140,0.12
202504,66440000,2,3,77,-74,0.04
202504,66440000,3,1,3,-2,0.33
202504,66440000,3S2,1,0,1,NA
202504,66440000,CA,0,63,-63,0
202504,66440009,2,0,1,-1,0
202504,66456000,2,3,99,-96,0.03
202504,66456000,3,0,3,-3,0
202504,66456000,CA,0,62,-62,0
202504,66572000,2,5,79,-74,0.06
202504,66572000,3,0,3,-3,0
202504,66572000,3S2,5,7,-2,0.71
202504,66572000,3S3,0,6,-6,0
202504,66572000,CA,2,168,-166,0.01
202504,66572001,2,1,2,-1,0.5
202504,66572001,3,0,3,-3,0
202504,66572001,3S2,1,0,1,NA
202504,66572001,CA,0,5,-5,0
202504,66594000,2,25,141,-116,0.18
202504,66594000,3S3,0,2,-2,0
202504,66594000,CA,2,57,-55,0.04
202504,66594002,2,1,6,-5,0.17
202504,66594002,2S2,4,0,4,NA
202504,66594002,3,1,1,0,1
202504,66594002,3S3,0,28,-28,0
202504,66594019,3S3,1,0,1,NA
202504,66682000,2,161,750,-589,0.21
202504,66682000,2R2,0,4,-4,0
202504,66682000,2S2,37,24,13,1.54
202504,66682000,2S3,3,4,-1,0.75
202504,66682000,3,0,14,-14,0
202504,66682000,3S2,1,2,-1,0.5
202504,66682000,3S3,63,76,-13,0.83
202504,66682000,CA,7,281,-274,0.02
202504,66687000,2,30,136,-106,0.22
202504,66687000,2S2,0,1,-1,0
202504,66687000,3,0,11,-11,0
202504,66687000,3S3,0,4,-4,0
202504,66687000,CA,1,29,-28,0.03
202504,68001000,2,12926,12557,369,1.03
202504,68001000,2R2,1,21,-20,0.05
202504,68001000,2S2,146,816,-670,0.18
202504,68001000,2S3,50,185,-135,0.27
202504,68001000,3,1245,512,733,2.43
202504,68001000,3S1,0,1,-1,0
202504,68001000,3S2,526,874,-348,0.6
202504,68001000,3S3,2789,6443,-3654,0.43
202504,68001000,3S4,7,4,3,1.75
202504,68001000,4,3,5,-2,0.6
202504,68001000,CA,2053,3888,-1835,0.53
202504,68001000,V2,13,391,-378,0.03
202504,68001000,V3,1,1,0,1
202504,68001002,2S2,6,6,0,1
202504,68001002,3S3,1,1,0,1
202504,68001003,3S3,0,1,-1,0
202504,68001005,3S2,1,0,1,NA
202504,68001005,3S3,20,2,18,10
202504,68001010,2,0,16,-16,0
202504,68001010,3,0,1,-1,0
202504,68001010,3S3,0,10,-10,0
202504,68013000,2,0,3,-3,0
202504,68020000,2,0,2,-2,0
202504,68020000,3,0,1,-1,0
202504,68020000,CA,0,1,-1,0
202504,68051000,2,32,224,-192,0.14
202504,68051000,3,0,46,-46,0
202504,68051000,3S3,2,2,0,1
202504,68051000,CA,1,14,-13,0.07
202504,68051000,V2,0,5,-5,0
202504,68077000,2,105,724,-619,0.15
202504,68077000,2S2,1,18,-17,0.06
202504,68077000,2S3,0,4,-4,0
202504,68077000,3,21,23,-2,0.91
202504,68077000,3S2,0,5,-5,0
202504,68077000,3S2S3,1,2,-1,0.5
202504,68077000,3S3,0,154,-154,0
202504,68077000,CA,14,110,-96,0.13
202504,68077000,V2,0,16,-16,0
202504,68079000,2,3,32,-29,0.09
202504,68079000,CA,0,7,-7,0
202504,68081000,2,1508,2704,-1196,0.56
202504,68081000,2R2,0,58,-58,0
202504,68081000,2S2,30,129,-99,0.23
202504,68081000,2S3,28,40,-12,0.7
202504,68081000,3,284,567,-283,0.5
202504,68081000,3S1,6,1,5,6
202504,68081000,3S2,339,229,110,1.48
202504,68081000,3S3,4793,3612,1181,1.33
202504,68081000,3S3S2,6,9,-3,0.67
202504,68081000,3S4,6,1,5,6
202504,68081000,4,1,15,-14,0.07
202504,68081000,CA,205,695,-490,0.29
202504,68081000,V2,74,10,64,7.4
202504,68081000,V3,141,82,59,1.72
202504,68081001,2,3,5,-2,0.6
202504,68081001,3S2,1,0,1,NA
202504,68081001,3S3,6,13,-7,0.46
202504,68081001,3S3S2,0,1,-1,0
202504,68081001,CA,0,5,-5,0
202504,68081001,V3,0,1,-1,0
202504,68081002,2,0,1,-1,0
202504,68081002,3S2,0,1,-1,0
202504,68081002,3S3,2,5,-3,0.4
202504,68081002,3S3S2,1,0,1,NA
202504,68081003,2,6,12,-6,0.5
202504,68081003,3,1,1,0,1
202504,68081003,3S2,1,0,1,NA
202504,68081003,3S3,19,98,-79,0.19
202504,68081003,CA,0,2,-2,0
202504,68081009,2,1,0,1,NA
202504,68081009,3S3,1,0,1,NA
202504,68081010,2,15,3,12,5
202504,68081010,3,0,1,-1,0
202504,68081010,3S2,15,8,7,1.88
202504,68081010,3S3,459,104,355,4.41
202504,68081010,3S3S2,4,2,2,2
202504,68081010,CA,1,0,1,NA
202504,68092000,2,151,32,119,4.72
202504,68092000,2S3,4,2,2,2
202504,68092000,3,60,21,39,2.86
202504,68092000,3S2,30,28,2,1.07
202504,68092000,3S3,535,417,118,1.28
202504,68092000,CA,0,14,-14,0
202504,68092000,V2,2,18,-16,0.11
202504,68092000,V3,14,38,-24,0.37
202504,68092003,3S3,10,58,-48,0.17
202504,68101000,2,0,18,-18,0
202504,68101000,2S2,0,3,-3,0
202504,68101000,CA,1,6,-5,0.17
202504,68101010,2,12,12,0,1
202504,68121000,2,0,2,-2,0
202504,68121000,CA,0,4,-4,0
202504,68132000,2,0,2,-2,0
202504,68132000,CA,0,9,-9,0
202504,68147000,2,11,39,-28,0.28
202504,68147000,3,0,1,-1,0
202504,68147000,3S3,46,1,45,46
202504,68147000,CA,0,3,-3,0
202504,68152000,2,0,4,-4,0
202504,68160000,2,0,1,-1,0
202504,68160002,2,0,1,-1,0
202504,68162000,2,1,15,-14,0.07
202504,68162000,3,0,1,-1,0
202504,68162000,3S3,0,9,-9,0
202504,68162000,CA,16,29,-13,0.55
202504,68167000,2,3,105,-102,0.03
202504,68167000,3S3,0,3,-3,0
202504,68167000,CA,0,9,-9,0
202504,68169000,2,0,2,-2,0
202504,68169000,3S2,0,1,-1,0
202504,68179000,2,0,2,-2,0
202504,68179007,2,0,2,-2,0
202504,68190000,2,90,208,-118,0.43
202504,68190000,2S2,1,2,-1,0.5
202504,68190000,2S3,2,1,1,2
202504,68190000,3,22,11,11,2
202504,68190000,3S1,2,0,2,NA
202504,68190000,3S2,207,5,202,41.4
202504,68190000,3S3,2147,128,2019,16.77
202504,68190000,CA,0,62,-62,0
202504,68190000,V2,0,1,-1,0
202504,68190000,V3,0,3,-3,0
202504,68190002,2,18,20,-2,0.9
202504,68190002,3S2,2,2,0,1
202504,68190002,3S3,5,4,1,1.25
202504,68190002,3S4,0,1,-1,0
202504,68190003,2,69,2,67,34.5
202504,68190003,3,11,0,11,NA
202504,68190003,3S2,8,0,8,NA
202504,68190003,3S3,59,5,54,11.8
202504,68190004,3S3,0,4,-4,0
202504,68190004,CA,0,1,-1,0
202504,68207000,2,0,3,-3,0
202504,68209000,2,1,16,-15,0.06
202504,68211000,2,1,4,-3,0.25
202504,68217000,2,0,1,-1,0
202504,68229000,2,67,76,-9,0.88
202504,68229000,2B1,0,1,-1,0
202504,68229000,2R2,1,0,1,NA
202504,68229000,3,2,12,-10,0.17
202504,68229000,3S3,124,2,122,62
202504,68229000,CA,7,12,-5,0.58
202504,68235000,2,1,40,-39,0.03
202504,68235000,3,0,16,-16,0
202504,68235000,3S2,1,0,1,NA
202504,68235000,CA,1,12,-11,0.08
202504,68235000,V2,0,10,-10,0
202504,68235000,V3,0,1,-1,0
202504,68235007,2,0,1,-1,0
202504,68250000,2,0,1,-1,0
202504,68250003,CA,0,1,-1,0
202504,68255000,2,19,163,-144,0.12
202504,68255000,3,0,15,-15,0
202504,68255000,3S2,0,2,-2,0
202504,68255000,3S3,2,11,-9,0.18
202504,68255000,CA,12,42,-30,0.29
202504,68255000,V2,0,10,-10,0
202504,68255000,V3,0,4,-4,0
202504,68264000,2,1,2,-1,0.5
202504,68266000,2,0,6,-6,0
202504,68271000,2,0,9,-9,0
202504,68271000,3,0,1,-1,0
202504,68271000,CA,0,7,-7,0
202504,68276000,2,2606,5384,-2778,0.48
202504,68276000,2R2,6,7,-1,0.86
202504,68276000,2S2,5,37,-32,0.14
202504,68276000,2S3,1,3,-2,0.33
202504,68276000,3,228,162,66,1.41
202504,68276000,3S2,181,243,-62,0.74
202504,68276000,3S3,136,149,-13,0.91
202504,68276000,4,1,1,0,1
202504,68276000,CA,756,1004,-248,0.75
202504,68276000,V2,332,0,332,NA
202504,68276011,3S3,0,1,-1,0
202504,68276013,2,0,1,-1,0
202504,68276013,CA,0,10,-10,0
202504,68276014,2,0,4,-4,0
202504,68296000,2,0,1,-1,0
202504,68298000,2,0,13,-13,0
202504,68307000,2,11825,4939,6886,2.39
202504,68307000,2B1,1,0,1,NA
202504,68307000,2R2,4,1,3,4
202504,68307000,2S1,1,1,0,1
202504,68307000,2S2,34,117,-83,0.29
202504,68307000,2S3,17,20,-3,0.85
202504,68307000,3,957,335,622,2.86
202504,68307000,3S1,5,2,3,2.5
202504,68307000,3S2,857,686,171,1.25
202504,68307000,3S3,997,3955,-2958,0.25
202504,68307000,3S4,1,0,1,NA
202504,68307000,4,13,1,12,13
202504,68307000,CA,3944,551,3393,7.16
202504,68307000,V2,60,11,49,5.45
202504,68307000,V3,6,9,-3,0.67
202504,68307007,2,0,32,-32,0
202504,68307007,3,0,7,-7,0
202504,68307007,3S3,0,4,-4,0
202504,68307007,V2,0,6,-6,0
202504,68307018,3S2,22,10,12,2.2
202504,68318000,2,0,7,-7,0
202504,68318000,3,0,9,-9,0
202504,68318000,CA,0,4,-4,0
202504,68320000,2,2,9,-7,0.22
202504,68320000,CA,1,2,-1,0.5
202504,68322000,2,1,0,1,NA
202504,68322000,3,0,1,-1,0
202504,68324000,2,0,12,-12,0
202504,68327000,2,7,9,-2,0.78
202504,68327000,2S3,1,0,1,NA
202504,68327000,3S2,0,1,-1,0
202504,68327000,3S3,0,2,-2,0
202504,68327000,CA,2,0,2,NA
202504,68344000,2,0,9,-9,0
202504,68368000,2,1,8,-7,0.12
202504,68368000,3S2,1,1,0,1
202504,68377000,2,1,13,-12,0.08
202504,68377000,3,0,2,-2,0
202504,68377000,3S3,0,1,-1,0
202504,68377000,CA,1,0,1,NA
202504,68385000,2,10,41,-31,0.24
202504,68385000,3,18,20,-2,0.9
202504,68385000,3S2,0,1,-1,0
202504,68385000,3S3,70,2,68,35
202504,68385000,4,0,1,-1,0
202504,68385000,CA,41,47,-6,0.87
202504,68385000,V2,63,0,63,NA
202504,68385000,V3,117,1,116,117
202504,68385000,V4,9,0,9,NA
202504,68385012,2,0,1,-1,0
202504,68397000,2,0,2,-2,0
202504,68397000,CA,0,2,-2,0
202504,68406000,2,1479,2031,-552,0.73
202504,68406000,2S2,4,45,-41,0.09
202504,68406000,2S3,1,2,-1,0.5
202504,68406000,3,122,177,-55,0.69
202504,68406000,3S2,95,51,44,1.86
202504,68406000,3S3,55,328,-273,0.17
202504,68406000,3S4,3,0,3,NA
202504,68406000,CA,613,286,327,2.14
202504,68406000,V2,19,16,3,1.19
202504,68406000,V3,0,26,-26,0
202504,68406008,2,0,1,-1,0
202504,68406008,V2,0,1,-1,0
202504,68406009,2,0,1,-1,0
202504,68406015,3S3,1,1,0,1
202504,68418000,2,927,1023,-96,0.91
202504,68418000,3,2,256,-254,0.01
202504,68418000,3S3,0,17,-17,0
202504,68418000,CA,6,60,-54,0.1
202504,68418000,V2,0,20,-20,0
202504,68432000,2,39,170,-131,0.23
202504,68432000,2S2,0,1,-1,0
202504,68432000,3,1,5,-4,0.2
202504,68432000,3S2,34,1,33,34
202504,68432000,3S3,21,17,4,1.24
202504,68432000,CA,9,25,-16,0.36
202504,68444000,2,0,6,-6,0
202504,68444000,3S2,1,1,0,1
202504,68444000,3S3,2,2,0,1
202504,68444000,CA,0,3,-3,0
202504,68464000,2,0,101,-101,0
202504,68464000,3,5,0,5,NA
202504,68464000,CA,0,2,-2,0
202504,68498000,2,0,4,-4,0
202504,68498000,V2,0,2,-2,0
202504,68500000,2,37,129,-92,0.29
202504,68500000,2S3,2,2,0,1
202504,68500000,3,1,18,-17,0.06
202504,68500000,3S2,2,0,2,NA
202504,68500000,3S3,8,15,-7,0.53
202504,68500000,CA,2,17,-15,0.12
202504,68500000,V2,0,24,-24,0
202504,68502000,2,0,2,-2,0
202504,68502000,CA,0,5,-5,0
202504,68524000,2,22,33,-11,0.67
202504,68524000,CA,0,2,-2,0
202504,68533000,2,0,67,-67,0
202504,68533000,3,0,11,-11,0
202504,68547000,2,1386,2254,-868,0.61
202504,68547000,2S2,6,36,-30,0.17
202504,68547000,2S3,2,5,-3,0.4
202504,68547000,3,137,183,-46,0.75
202504,68547000,3S2,67,18,49,3.72
202504,68547000,3S3,1364,506,858,2.7
202504,68547000,3S4,0,1,-1,0
202504,68547000,CA,223,547,-324,0.41
202504,68547000,V2,0,8,-8,0
202504,68547008,2,0,1,-1,0
202504,68547011,2,1,2,-1,0.5
202504,68547011,3S3,224,0,224,NA
202504,68549000,2,1,58,-57,0.02
202504,68549000,3,1,0,1,NA
202504,68549000,3S3,6,65,-59,0.09
202504,68572000,2,5,141,-136,0.04
202504,68572000,3,0,8,-8,0
202504,68572000,3S2,0,1,-1,0
202504,68572000,3S3,98,107,-9,0.92
202504,68572000,CA,2,18,-16,0.11
202504,68573000,2,11,46,-35,0.24
202504,68573000,3,2,32,-30,0.06
202504,68573000,3S2,13,1,12,13
202504,68573000,3S3,89,28,61,3.18
202504,68573000,3S3S2,4,1,3,4
202504,68573000,CA,1,7,-6,0.14
202504,68573000,V2,1,8,-7,0.12
202504,68573000,V3,36,10,26,3.6
202504,68573001,2,7,0,7,NA
202504,68573002,CA,0,3,-3,0
202504,68575000,2,28,152,-124,0.18
202504,68575000,2S2,1,5,-4,0.2
202504,68575000,2S3,0,1,-1,0
202504,68575000,3,10,20,-10,0.5
202504,68575000,3S1,0,1,-1,0
202504,68575000,3S2,73,5,68,14.6
202504,68575000,3S3,617,113,504,5.46
202504,68575000,3S4,0,1,-1,0
202504,68575000,CA,9,34,-25,0.26
202504,68575000,V2,11,0,11,NA
202504,68575000,V3,8,79,-71,0.1
202504,68575000,V3R3,1,0,1,NA
202504,68575001,2,0,1,-1,0
202504,68575001,3S3,0,1,-1,0
202504,68575002,3S3,0,1,-1,0
202504,68575007,3S3,1,0,1,NA
202504,68575015,2,0,2,-2,0
202504,68575015,3S3,0,1,-1,0
202504,68575015,CA,0,4,-4,0
202504,68575024,2,0,1,-1,0
202504,68575024,CA,0,2,-2,0
202504,68615000,2,238,830,-592,0.29
202504,68615000,2S2,0,2,-2,0
202504,68615000,2S3,1,0,1,NA
202504,68615000,3,136,116,20,1.17
202504,68615000,3S2,118,36,82,3.28
202504,68615000,3S3,93,35,58,2.66
202504,68615000,CA,0,33,-33,0
202504,68615000,V2,0,2,-2,0
202504,68615000,V3,12,0,12,NA
202504,68615013,3S3,13,0,13,NA
202504,68615013,CA,0,4,-4,0
202504,68615031,2,0,2,-2,0
202504,68615031,2S3,0,1,-1,0
202504,68615031,3,17,0,17,NA
202504,68615031,3S3,4,2,2,2
202504,68655000,2,871,344,527,2.53
202504,68655000,2S2,1,6,-5,0.17
202504,68655000,3,170,461,-291,0.37
202504,68655000,3S1,1,1,0,1
202504,68655000,3S2,27,12,15,2.25
202504,68655000,3S3,204,171,33,1.19
202504,68655000,3S3S2,0,1,-1,0
202504,68655000,4,0,7,-7,0
202504,68655000,CA,10,119,-109,0.08
202504,68655000,V2,27,3,24,9
202504,68655000,V3,111,27,84,4.11
202504,68655001,2,1,0,1,NA
202504,68669000,2,2,27,-25,0.07
202504,68669000,2S2,0,1,-1,0
202504,68669000,3,0,11,-11,0
202504,68669000,3S3,0,4,-4,0
202504,68669000,CA,0,1,-1,0
202504,68669013,2,0,1,-1,0
202504,68673000,2,0,1,-1,0
202504,68679000,2,130,1025,-895,0.13
202504,68679000,2S2,1,5,-4,0.2
202504,68679000,2S3,2,1,1,2
202504,68679000,3,2,31,-29,0.06
202504,68679000,3S2,0,10,-10,0
202504,68679000,3S3,173,471,-298,0.37
202504,68679000,4,0,1,-1,0
202504,68679000,CA,46,208,-162,0.22
202504,68679001,3S3,0,1,-1,0
202504,68682000,2,0,5,-5,0
202504,68684000,2,0,5,-5,0
202504,68686000,2,0,17,-17,0
202504,68686000,CA,0,6,-6,0
202504,68689000,2,8,101,-93,0.08
202504,68689000,2S2,0,1,-1,0
202504,68689000,3,1,7,-6,0.14
202504,68689000,3S2,2,3,-1,0.67
202504,68689000,3S3,41,13,28,3.15
202504,68689000,CA,20,74,-54,0.27
202504,68689000,V2,5,21,-16,0.24
202504,68689000,V3,17,63,-46,0.27
202504,68689001,3S2,1,0,1,NA
202504,68689012,2,3,9,-6,0.33
202504,68689012,3S3,8,0,8,NA
202504,68689012,CA,22,33,-11,0.67
202504,68689012,V2,0,1,-1,0
202504,68689024,2,17,0,17,NA
202504,68689024,3,10,0,10,NA
202504,68689024,3S2,0,3,-3,0
202504,68689024,3S3,143,16,127,8.94
202504,68705000,2,1,12,-11,0.08
202504,68705000,3S2,1,0,1,NA
202504,68705000,CA,0,3,-3,0
202504,68720000,2,1,28,-27,0.04
202504,68720000,3,1,0,1,NA
202504,68720000,3S3,0,3,-3,0
202504,68720000,CA,0,2,-2,0
202504,68745000,2,85,15,70,5.67
202504,68745000,3,0,65,-65,0
202504,68745000,3S2,10,0,10,NA
202504,68745000,3S3,90,0,90,NA
202504,68745000,CA,0,4,-4,0
202504,68755000,2,68,450,-382,0.15
202504,68755000,2S2,0,1,-1,0
202504,68755000,2S3,5,6,-1,0.83
202504,68755000,3,1,10,-9,0.1
202504,68755000,3S2,0,1,-1,0
202504,68755000,3S3,8,71,-63,0.11
202504,68755000,CA,30,135,-105,0.22
202504,68755000,V2,53,0,53,NA
202504,68770000,2,1,25,-24,0.04
202504,68770000,3,0,14,-14,0
202504,68770000,CA,0,12,-12,0
202504,68770000,V2,0,1,-1,0
202504,68770001,2,1,1,0,1
202504,68770003,2,0,4,-4,0
202504,68770003,CA,2,1,1,2
202504,68773000,2,0,1,-1,0
202504,68773000,4,0,1,-1,0
202504,68773000,CA,0,3,-3,0
202504,68773011,3S3,1,0,1,NA
202504,68780000,2,0,2,-2,0
202504,68820000,2,120,63,57,1.9
202504,68820000,3S3,3,0,3,NA
202504,68820000,CA,0,7,-7,0
202504,68820001,2,1,14,-13,0.07
202504,68820001,3S3,1,0,1,NA
202504,68820001,CA,1,9,-8,0.11
202504,68855000,2,1,50,-49,0.02
202504,68855000,3S3,6,1,5,6
202504,68855000,V2,0,6,-6,0
202504,68861000,2,5,184,-179,0.03
202504,68861000,3,0,1,-1,0
202504,68861000,3S2,1,1,0,1
202504,68861000,3S3,6,40,-34,0.15
202504,68861000,CA,11,37,-26,0.3
202504,68861000,V2,0,4,-4,0
202504,68861002,2,1,0,1,NA
202504,68861006,2,0,1,-1,0
202504,68867000,2,0,2,-2,0
202504,68867000,CA,0,5,-5,0
202504,68872000,2,2,111,-109,0.02
202504,68872000,3S3,0,1,-1,0
202504,68872000,V2,0,20,-20,0
202504,68895000,2,62,207,-145,0.3
202504,68895000,2S2,3,3,0,1
202504,68895000,3,2,39,-37,0.05
202504,68895000,3S2,0,1,-1,0
202504,68895000,CA,21,37,-16,0.57
202504,70001000,2,1316,3159,-1843,0.42
202504,70001000,2R2,2,38,-36,0.05
202504,70001000,2S2,3,105,-102,0.03
202504,70001000,2S3,19,31,-12,0.61
202504,70001000,3,7,283,-276,0.02
202504,70001000,3S2,120,421,-301,0.29
202504,70001000,3S3,102,705,-603,0.14
202504,70001000,3S4,2,1,1,2
202504,70001000,4,0,3,-3,0
202504,70001000,CA,320,490,-170,0.65
202504,70001000,V3,0,1,-1,0
202504,70001000,V3R3,0,1,-1,0
202504,70001001,2,0,14,-14,0
202504,70001001,CA,1,1,0,1
202504,70001002,2,0,1,-1,0
202504,70001003,2,4,2,2,2
202504,70001005,2,1,2,-1,0.5
202504,70110000,2,5,18,-13,0.28
202504,70110000,2R2,0,1,-1,0
202504,70110000,3,0,6,-6,0
202504,70110000,3S2,1,0,1,NA
202504,70110000,3S3,0,11,-11,0
202504,70124000,2,6,25,-19,0.24
202504,70124000,3,6,0,6,NA
202504,70124000,3S2,11,3,8,3.67
202504,70124000,3S3,23,17,6,1.35
202504,70124000,CA,0,1,-1,0
202504,70204000,2,2,9,-7,0.22
202504,70204000,CA,0,2,-2,0
202504,70215000,2,260,372,-112,0.7
202504,70215000,2R2,0,3,-3,0
202504,70215000,2S2,1,3,-2,0.33
202504,70215000,3,2,20,-18,0.1
202504,70215000,3S2,19,7,12,2.71
202504,70215000,3S3,292,422,-130,0.69
202504,70215000,CA,46,80,-34,0.58
202504,70215009,CA,1,0,1,NA
202504,70221000,2,12,190,-178,0.06
202504,70221000,2R2,0,15,-15,0
202504,70221000,2S2,0,1,-1,0
202504,70221000,2S3,10,1,9,10
202504,70221000,3,2,18,-16,0.11
202504,70221000,3S2,0,1,-1,0
202504,70221000,3S3,0,33,-33,0
202504,70221000,3S4,0,1,-1,0
202504,70221000,CA,5,35,-30,0.14
202504,70221005,CA,0,1,-1,0
202504,70230000,2,1,5,-4,0.2
202504,70230000,3,0,1,-1,0
202504,70230000,3S2,0,1,-1,0
202504,70230000,CA,0,1,-1,0
202504,70230001,2,0,4,-4,0
202504,70233000,2,7,9,-2,0.78
202504,70233000,2S3,0,1,-1,0
202504,70233000,3,0,4,-4,0
202504,70233000,3S2,1,0,1,NA
202504,70233000,3S3,27,2,25,13.5
202504,70233000,3S4,2,0,2,NA
202504,70233000,CA,1,4,-3,0.25
202504,70233002,2,0,1,-1,0
202504,70233004,2,0,3,-3,0
202504,70235000,2,18,111,-93,0.16
202504,70235000,CA,1,5,-4,0.2
202504,70235000,V3,3,0,3,NA
202504,70235001,2,0,3,-3,0
202504,70235002,2,0,1,-1,0
202504,70235008,3S3,0,39,-39,0
202504,70265000,2,2,85,-83,0.02
202504,70265000,2R2,0,1,-1,0
202504,70265000,3,0,28,-28,0
202504,70265000,3S2,0,3,-3,0
202504,70265000,3S3,1,2,-1,0.5
202504,70265000,CA,0,16,-16,0
202504,70400000,2,16,126,-110,0.13
202504,70400000,2S2,2,1,1,2
202504,70400000,2S3,1,0,1,NA
202504,70400000,3,19,48,-29,0.4
202504,70400000,3S1,2,0,2,NA
202504,70400000,3S2,1,6,-5,0.17
202504,70400000,3S3,6,19,-13,0.32
202504,70400000,3S4,0,1,-1,0
202504,70400000,CA,0,3,-3,0
202504,70418000,2,3,33,-30,0.09
202504,70418000,2S2,0,1,-1,0
202504,70418000,3S3,0,1,-1,0
202504,70418000,CA,1,8,-7,0.12
202504,70418002,2,0,1,-1,0
202504,70429000,2,21,60,-39,0.35
202504,70429000,2R2,0,2,-2,0
202504,70429000,3,4,32,-28,0.12
202504,70429000,3S2,0,1,-1,0
202504,70429000,3S3,2,11,-9,0.18
202504,70429000,4,0,3,-3,0
202504,70429000,CA,0,16,-16,0
202504,70429006,2,0,2,-2,0
202504,70429006,3,0,1,-1,0
202504,70473000,2,0,10,-10,0
202504,70473000,3S3,0,5,-5,0
202504,70473000,CA,0,4,-4,0
202504,70473005,3S2,0,8,-8,0
202504,70508000,2,6,71,-65,0.08
202504,70508000,2R2,0,1,-1,0
202504,70508000,2S2,3,7,-4,0.43
202504,70508000,2S3,0,2,-2,0
202504,70508000,3,0,12,-12,0
202504,70508000,3S2,2,17,-15,0.12
202504,70508000,3S3,1,53,-52,0.02
202504,70508000,3S4,0,1,-1,0
202504,70508000,CA,2,18,-16,0.11
202504,70508011,2,0,1,-1,0
202504,70523000,2,5,18,-13,0.28
202504,70523000,2S2,1,1,0,1
202504,70523000,3S2,0,2,-2,0
202504,70523000,3S3,0,2,-2,0
202504,70523000,CA,0,8,-8,0
202504,70670000,2,78,138,-60,0.57
202504,70670000,2R2,0,1,-1,0
202504,70670000,2S2,1,1,0,1
202504,70670000,2S3,0,2,-2,0
202504,70670000,3,0,10,-10,0
202504,70670000,3S2,0,1,-1,0
202504,70670000,3S3,0,6,-6,0
202504,70670000,CA,26,36,-10,0.72
202504,70670009,2,1,1,0,1
202504,70670010,3S3,0,2,-2,0
202504,70670011,CA,0,1,-1,0
202504,70678000,2,3,20,-17,0.15
202504,70678000,3S2,2,0,2,NA
202504,70678000,CA,0,3,-3,0
202504,70678010,2,0,2,-2,0
202504,70678010,3S3,0,1,-1,0
202504,70702000,2,1,26,-25,0.04
202504,70702000,CA,1,4,-3,0.25
202504,70702001,2,0,2,-2,0
202504,70702004,2,0,5,-5,0
202504,70702004,2R2,0,2,-2,0
202504,70708000,2,75,251,-176,0.3
202504,70708000,2R2,1,3,-2,0.33
202504,70708000,2S2,4,3,1,1.33
202504,70708000,2S3,3,2,1,1.5
202504,70708000,3,21,17,4,1.24
202504,70708000,3S2,25,6,19,4.17
202504,70708000,3S3,29,72,-43,0.4
202504,70708000,3S4,0,2,-2,0
202504,70708000,4,0,3,-3,0
202504,70708000,CA,6,55,-49,0.11
202504,70708003,2,30,3,27,10
202504,70708006,2,2,1,1,2
202504,70708007,2,2,2,0,1
202504,70708007,3S1,2,1,1,2
202504,70708007,3S2,0,1,-1,0
202504,70708007,4,1,0,1,NA
202504,70708013,2,0,1,-1,0
202504,70708016,2,0,2,-2,0
202504,70708021,3,0,1,-1,0
202504,70713000,2,78,180,-102,0.43
202504,70713000,2R2,0,2,-2,0
202504,70713000,2S3,0,1,-1,0
202504,70713000,3,0,38,-38,0
202504,70713000,3S2,4,5,-1,0.8
202504,70713000,3S3,1,8,-7,0.12
202504,70713000,CA,0,35,-35,0
202504,70713000,V3,0,2,-2,0
202504,70713003,2,0,3,-3,0
202504,70713006,2,0,6,-6,0
202504,70713007,2,0,1,-1,0
202504,70713007,3S2,0,7,-7,0
202504,70713008,3S2,0,1,-1,0
202504,70713008,V3,0,1,-1,0
202504,70713010,2,0,7,-7,0
202504,70713012,2,0,1,-1,0
202504,70717000,2,12,38,-26,0.32
202504,70717000,2R2,0,1,-1,0
202504,70717000,2S2,0,4,-4,0
202504,70717000,2S3,1,7,-6,0.14
202504,70717000,3S1,0,2,-2,0
202504,70717000,3S2,1,1,0,1
202504,70717000,3S3,11,31,-20,0.35
202504,70717000,3S4,0,3,-3,0
202504,70717000,CA,4,9,-5,0.44
202504,70717002,2,0,1,-1,0
202504,70742000,2,4,92,-88,0.04
202504,70742000,2S2,0,1,-1,0
202504,70742000,3,1,0,1,NA
202504,70742000,3S3,0,1,-1,0
202504,70742000,CA,0,10,-10,0
202504,70742005,2,0,4,-4,0
202504,70742011,2,0,6,-6,0
202504,70771000,2,2,1,1,2
202504,70771000,3,0,3,-3,0
202504,70771000,3S3,0,8,-8,0
202504,70771000,CA,0,1,-1,0
202504,70771007,2,0,4,-4,0
202504,70771013,2,0,3,-3,0
202504,70771013,3S3,0,11,-11,0
202504,70771018,2,1,1,0,1
202504,70771026,3S3,0,14,-14,0
202504,70820000,2,37,205,-168,0.18
202504,70820000,2S2,2,4,-2,0.5
202504,70820000,2S3,1,0,1,NA
202504,70820000,3,2,19,-17,0.11
202504,70820000,3S2,2,5,-3,0.4
202504,70820000,3S3,2845,736,2109,3.87
202504,70820000,CA,3,38,-35,0.08
202504,70820000,V3,0,1,-1,0
202504,70820001,2,0,4,-4,0
202504,70820001,2S2,1,0,1,NA
202504,70820001,CA,0,1,-1,0
202504,70820008,3S2,0,110,-110,0
202504,70820008,3S3,0,384,-384,0
202504,70820008,V3,0,1,-1,0
202504,70823000,2,686,146,540,4.7
202504,70823000,2R2,0,6,-6,0
202504,70823000,2S2,3,4,-1,0.75
202504,70823000,3,396,20,376,19.8
202504,70823000,3S2,243,4,239,60.75
202504,70823000,3S3,607,366,241,1.66
202504,70823000,CA,2,31,-29,0.06
202504,70823003,2,0,1,-1,0
202504,70823005,2,0,5,-5,0
202504,70823005,2S3,0,1,-1,0
202504,73001000,2,3978,6808,-2830,0.58
202504,73001000,2R2,27,129,-102,0.21
202504,73001000,2S1,0,1,-1,0
202504,73001000,2S2,298,593,-295,0.5
202504,73001000,2S3,29,71,-42,0.41
202504,73001000,3,135,304,-169,0.44
202504,73001000,3S1,1,1,0,1
202504,73001000,3S2,543,674,-131,0.81
202504,73001000,3S3,3660,2153,1507,1.7
202504,73001000,3S4,2,2,0,1
202504,73001000,4,1,2,-1,0.5
202504,73001000,CA,1508,1802,-294,0.84
202504,73001000,V2,0,1,-1,0
202504,73001000,V3,21,8,13,2.62
202504,73001001,2,0,1,-1,0
202504,73001001,CA,0,3,-3,0
202504,73001009,2,0,1,-1,0
202504,73001009,CA,0,1,-1,0
202504,73001010,2,0,1,-1,0
202504,73001015,2,0,1,-1,0
202504,73001022,CA,0,1,-1,0
202504,73001031,2,0,3,-3,0
202504,73001032,2,0,1,-1,0
202504,73001032,3S3,5,20,-15,0.25
202504,73001032,CA,0,1,-1,0
202504,73001039,2,1,0,1,NA
202504,73001051,3S3,0,2,-2,0
202504,73024000,2,1,5,-4,0.2
202504,73024000,CA,6,8,-2,0.75
202504,73024001,CA,0,1,-1,0
202504,73024004,2,1,5,-4,0.2
202504,73024004,3S3,0,2,-2,0
202504,73024004,CA,1,6,-5,0.17
202504,73026000,2,106,94,12,1.13
202504,73026000,2S2,1,3,-2,0.33
202504,73026000,2S3,0,18,-18,0
202504,73026000,3,0,2,-2,0
202504,73026000,3S2,1,9,-8,0.11
202504,73026000,3S3,14,9,5,1.56
202504,73026000,3S4,1,0,1,NA
202504,73026000,CA,6,18,-12,0.33
202504,73026001,3S3,1,0,1,NA
202504,73030000,2,28,25,3,1.12
202504,73030000,3,1,0,1,NA
202504,73030000,3S3,16,5,11,3.2
202504,73030000,CA,1,7,-6,0.14
202504,73043000,2,2,29,-27,0.07
202504,73043000,CA,2,15,-13,0.13
202504,73055000,2,42,59,-17,0.71
202504,73055000,2S2,1,0,1,NA
202504,73055000,2S3,0,1,-1,0
202504,73055000,3,2,1,1,2
202504,73055000,3S2,15,0,15,NA
202504,73055000,3S3,3,4,-1,0.75
202504,73055000,CA,1,9,-8,0.11
202504,73055004,2,0,2,-2,0
202504,73055004,2S3,2,2,0,1
202504,73055004,3S3,3,12,-9,0.25
202504,73067000,2,2,39,-37,0.05
202504,73067000,2S2,0,1,-1,0
202504,73067000,3,0,13,-13,0
202504,73067000,3S2,0,1,-1,0
202504,73067000,3S3,0,1,-1,0
202504,73067000,CA,26,27,-1,0.96
202504,73067007,2,0,10,-10,0
202504,73067007,CA,1,1,0,1
202504,73067015,CA,0,6,-6,0
202504,73124000,2,4,90,-86,0.04
202504,73124000,3,1,2,-1,0.5
202504,73124000,3S2,1,0,1,NA
202504,73124000,3S3,2,2,0,1
202504,73124000,3S4,1,0,1,NA
202504,73124000,CA,5,35,-30,0.14
202504,73124001,CA,0,1,-1,0
202504,73148000,2,6,131,-125,0.05
202504,73148000,2R2,0,3,-3,0
202504,73148000,2S2,1,0,1,NA
202504,73148000,3,0,1,-1,0
202504,73148000,3S2,3,3,0,1
202504,73148000,3S3,2,10,-8,0.2
202504,73148000,CA,4,58,-54,0.07
202504,73152000,2,3,24,-21,0.12
202504,73152000,CA,0,3,-3,0
202504,73168000,2,74,372,-298,0.2
202504,73168000,2R2,0,3,-3,0
202504,73168000,2S1,0,1,-1,0
202504,73168000,2S2,1,15,-14,0.07
202504,73168000,2S3,0,12,-12,0
202504,73168000,3,192,28,164,6.86
202504,73168000,3S2,6,15,-9,0.4
202504,73168000,3S3,152,119,33,1.28
202504,73168000,3S4,0,3,-3,0
202504,73168000,4,1,0,1,NA
202504,73168000,CA,30,129,-99,0.23
202504,73200000,2,395,23,372,17.17
202504,73200000,2S2,36,0,36,NA
202504,73200000,2S3,1,0,1,NA
202504,73200000,3,134,0,134,NA
202504,73200000,3S2,1,12,-11,0.08
202504,73200000,3S3,79,68,11,1.16
202504,73200000,CA,1,11,-10,0.09
202504,73200001,2,151,8,143,18.88
202504,73200001,2S2,44,2,42,22
202504,73200001,3,93,3,90,31
202504,73200001,3S2,17,12,5,1.42
202504,73200001,3S3,104,103,1,1.01
202504,73200001,CA,0,1,-1,0
202504,73200010,2,1,1,0,1
202504,73200010,3S2,1,0,1,NA
202504,73217000,2,2,51,-49,0.04
202504,73217000,2S2,1,0,1,NA
202504,73217000,3,0,3,-3,0
202504,73217000,3S2,2,1,1,2
202504,73217000,3S3,6,9,-3,0.67
202504,73217000,CA,0,6,-6,0
202504,73217001,2,0,1,-1,0
202504,73217001,3,0,1,-1,0
202504,73217001,3S3,0,1,-1,0
202504,73217001,CA,0,1,-1,0
202504,73226000,2,16,25,-9,0.64
202504,73226000,CA,0,15,-15,0
202504,73236000,2,2,46,-44,0.04
202504,73236000,CA,0,9,-9,0
202504,73268000,2,630,880,-250,0.72
202504,73268000,2R2,14,7,7,2
202504,73268000,2S2,6,22,-16,0.27
202504,73268000,2S3,2,11,-9,0.18
202504,73268000,3,65,20,45,3.25
202504,73268000,3S2,17,12,5,1.42
202504,73268000,3S3,975,274,701,3.56
202504,73268000,4,4,0,4,NA
202504,73268000,CA,98,349,-251,0.28
202504,73268000,V3,2,0,2,NA
202504,73268001,2,15,17,-2,0.88
202504,73268001,2S2,2,0,2,NA
202504,73268001,3,1,0,1,NA
202504,73268001,3S2,1,0,1,NA
202504,73268001,3S3,24,9,15,2.67
202504,73268001,CA,2,1,1,2
202504,73270000,2,0,10,-10,0
202504,73270000,CA,1,4,-3,0.25
202504,73270004,CA,0,26,-26,0
202504,73275000,2,261,340,-79,0.77
202504,73275000,2R2,0,2,-2,0
202504,73275000,2S2,0,1,-1,0
202504,73275000,2S3,0,1,-1,0
202504,73275000,3,1,23,-22,0.04
202504,73275000,3S2,22,45,-23,0.49
202504,73275000,3S3,38,35,3,1.09
202504,73275000,CA,1,113,-112,0.01
202504,73283000,2,36,266,-230,0.14
202504,73283000,2S2,0,1,-1,0
202504,73283000,2S3,1,0,1,NA
202504,73283000,3,0,7,-7,0
202504,73283000,3S3,1,90,-89,0.01
202504,73283000,CA,3,49,-46,0.06
202504,73283000,V3,0,3,-3,0
202504,73319000,2,22,188,-166,0.12
202504,73319000,2R2,0,5,-5,0
202504,73319000,2S2,1,1,0,1
202504,73319000,3,0,57,-57,0
202504,73319000,3S2,1,5,-4,0.2
202504,73319000,3S3,9,10,-1,0.9
202504,73319000,CA,1,44,-43,0.02
202504,73319000,V3,1,0,1,NA
202504,73319002,2S2,1,0,1,NA
202504,73347000,2,16,5,11,3.2
202504,73347000,3,0,1,-1,0
202504,73347000,3S3,13,0,13,NA
202504,73347000,CA,3,5,-2,0.6
202504,73347003,2,57,1,56,57
202504,73347003,2S2,0,1,-1,0
202504,73347003,3,12,0,12,NA
202504,73347003,3S3,81,4,77,20.25
202504,73347005,2,2,5,-3,0.4
202504,73347005,2S2,0,1,-1,0
202504,73347005,3,1,0,1,NA
202504,73349000,2,16,269,-253,0.06
202504,73349000,2R2,0,2,-2,0
202504,73349000,2S2,4,1,3,4
202504,73349000,2S3,0,1,-1,0
202504,73349000,3,1,14,-13,0.07
202504,73349000,3S2,0,17,-17,0
202504,73349000,3S3,124,174,-50,0.71
202504,73349000,CA,12,61,-49,0.2
202504,73352000,2,2,45,-43,0.04
202504,73352000,2S2,0,1,-1,0
202504,73352000,3S2,1,0,1,NA
202504,73352000,CA,1,14,-13,0.07
202504,73408000,2,20,98,-78,0.2
202504,73408000,2R2,0,2,-2,0
202504,73408000,2S2,0,1,-1,0
202504,73408000,3,3,5,-2,0.6
202504,73408000,3S2,1,0,1,NA
202504,73408000,3S3,33,54,-21,0.61
202504,73408000,CA,3,41,-38,0.07
202504,73408002,3,1,0,1,NA
202504,73408003,2,1,0,1,NA
202504,73408003,3,0,2,-2,0
202504,73411000,2,41,216,-175,0.19
202504,73411000,2S2,1,1,0,1
202504,73411000,3,2,33,-31,0.06
202504,73411000,3S2,1,1,0,1
202504,73411000,3S3,1,25,-24,0.04
202504,73411000,CA,8,70,-62,0.11
202504,73411000,V3,5,6,-1,0.83
202504,73411002,2,0,1,-1,0
202504,73411009,2,0,6,-6,0
202504,73411009,3,0,3,-3,0
202504,73443000,2,326,426,-100,0.77
202504,73443000,2R2,0,2,-2,0
202504,73443000,2S2,5,4,1,1.25
202504,73443000,2S3,3,4,-1,0.75
202504,73443000,3,40,15,25,2.67
202504,73443000,3S2,40,32,8,1.25
202504,73443000,3S3,553,213,340,2.6
202504,73443000,4,0,2,-2,0
202504,73443000,CA,9,86,-77,0.1
202504,73443000,V3,0,2,-2,0
202504,73449000,2,29,587,-558,0.05
202504,73449000,2R2,0,1,-1,0
202504,73449000,2S2,3,1,2,3
202504,73449000,2S3,1,0,1,NA
202504,73449000,3,0,22,-22,0
202504,73449000,3S2,1,4,-3,0.25
202504,73449000,3S3,4,55,-51,0.07
202504,73449000,4,1,0,1,NA
202504,73449000,CA,12,289,-277,0.04
202504,73449000,V2,1,0,1,NA
202504,73449000,V3,0,1,-1,0
202504,73461000,2,1,14,-13,0.07
202504,73461000,CA,1,1,0,1
202504,73483000,2,23,162,-139,0.14
202504,73483000,2R2,0,2,-2,0
202504,73483000,2S2,0,7,-7,0
202504,73483000,3,0,6,-6,0
202504,73483000,3S3,0,2,-2,0
202504,73483000,CA,0,19,-19,0
202504,73483001,CA,0,1,-1,0
202504,73504000,2,13,93,-80,0.14
202504,73504000,2R2,0,7,-7,0
202504,73504000,2S2,0,9,-9,0
202504,73504000,3,70,7,63,10
202504,73504000,3S1,0,1,-1,0
202504,73504000,3S2,0,2,-2,0
202504,73504000,3S3,40,5,35,8
202504,73504000,CA,3,9,-6,0.33
202504,73520000,2,0,29,-29,0
202504,73520000,3,0,1,-1,0
202504,73520000,CA,1,6,-5,0.17
202504,73547000,2,68,25,43,2.72
202504,73547000,3,0,1,-1,0
202504,73547000,3S3,122,11,111,11.09
202504,73547000,CA,0,17,-17,0
202504,73547002,2,11,4,7,2.75
202504,73547002,3S3,1,4,-3,0.25
202504,73547002,CA,13,0,13,NA
202504,73555000,2,10,69,-59,0.14
202504,73555000,2S2,0,1,-1,0
202504,73555000,3,4,4,0,1
202504,73555000,3S2,0,1,-1,0
202504,73555000,3S3,0,2,-2,0
202504,73555000,3S4,1,1,0,1
202504,73555000,CA,8,22,-14,0.36
202504,73555002,2,0,1,-1,0
202504,73555005,3S3,1,0,1,NA
202504,73563000,2,6,46,-40,0.13
202504,73563000,3,0,1,-1,0
202504,73563000,3S3,0,2,-2,0
202504,73563000,CA,1,17,-16,0.06
202504,73585000,2,29,120,-91,0.24
202504,73585000,2R2,0,7,-7,0
202504,73585000,2S3,1,0,1,NA
202504,73585000,3,45,20,25,2.25
202504,73585000,3S1,1,0,1,NA
202504,73585000,3S2,3,1,2,3
202504,73585000,3S3,145,27,118,5.37
202504,73585000,4,1,0,1,NA
202504,73585000,CA,3,24,-21,0.12
202504,73616000,2,3,39,-36,0.08
202504,73616000,CA,0,8,-8,0
202504,73616001,2,2,0,2,NA
202504,73622000,2,2,5,-3,0.4
202504,73622000,CA,23,26,-3,0.88
202504,73624000,2,3,110,-107,0.03
202504,73624000,3,0,1,-1,0
202504,73624000,CA,1,41,-40,0.02
202504,73671000,2,25,91,-66,0.27
202504,73671000,2R2,0,1,-1,0
202504,73671000,3,6,10,-4,0.6
202504,73671000,3S2,847,1,846,847
202504,73671000,3S3,360,69,291,5.22
202504,73671000,CA,2,21,-19,0.1
202504,73675000,2,0,25,-25,0
202504,73675000,CA,1,5,-4,0.2
202504,73678000,2,3,50,-47,0.06
202504,73678000,3S2,6,0,6,NA
202504,73678000,3S3,144,2,142,72
202504,73678000,4,3,0,3,NA
202504,73678000,CA,0,25,-25,0
202504,73678000,V3,19,0,19,NA
202504,73678000,V4,4,0,4,NA
202504,73678004,2,1,1,0,1
202504,73678004,3,0,16,-16,0
202504,73678004,3S2,1,1,0,1
202504,73678004,3S3,7,1,6,7
202504,73686000,2,2,10,-8,0.2
202504,73686000,CA,2,5,-3,0.4
202504,73770000,2,0,18,-18,0
202504,73770000,3,8,0,8,NA
202504,73770000,3S2,44,2,42,22
202504,73770000,3S3,15,5,10,3
202504,73770000,4,3,0,3,NA
202504,73770000,CA,0,3,-3,0
202504,73770000,V2,9,0,9,NA
202504,73770000,V3,218,0,218,NA
202504,73770000,V4,8,0,8,NA
202504,73854000,2,6,9,-3,0.67
202504,73854000,3,0,1,-1,0
202504,73854000,CA,0,4,-4,0
202504,73854000,V3,1,0,1,NA
202504,73861000,2,24,55,-31,0.44
202504,73861000,2R2,0,1,-1,0
202504,73861000,2S2,0,1,-1,0
202504,73861000,3,12,2,10,6
202504,73861000,3S2,1,0,1,NA
202504,73861000,3S3,108,21,87,5.14
202504,73861000,CA,4,12,-8,0.33
202504,73861000,V3,1,0,1,NA
202504,73861002,2S2,0,1,-1,0
202504,73870000,2,30,11,19,2.73
202504,73873000,2,3,16,-13,0.19
202504,73873000,CA,9,26,-17,0.35
202504,76001000,2,13432,25275,-11843,0.53
202504,76001000,2B1,0,4,-4,0
202504,76001000,2R2,1,51,-50,0.02
202504,76001000,2S2,697,2753,-2056,0.25
202504,76001000,2S3,179,420,-241,0.43
202504,76001000,3,124,908,-784,0.14
202504,76001000,3S1,8,3,5,2.67
202504,76001000,3S2,2293,2355,-62,0.97
202504,76001000,3S3,2332,4993,-2661,0.47
202504,76001000,3S4,8,10,-2,0.8
202504,76001000,4,3,15,-12,0.2
202504,76001000,CA,4511,9277,-4766,0.49
202504,76001000,V2,117,1,116,117
202504,76001000,V3,2,1,1,2
202504,76001001,CA,1,0,1,NA
202504,76001002,CA,0,1,-1,0
202504,76001003,2,1,0,1,NA
202504,76001005,2,0,1,-1,0
202504,76001013,2,0,213,-213,0
202504,76001013,3S2,0,6,-6,0
202504,76001013,CA,0,378,-378,0
202504,76001014,2,0,1,-1,0
202504,76001016,2,0,6,-6,0
202504,76001016,3S3,0,3,-3,0
202504,76001016,CA,0,1,-1,0
202504,76001019,2,1,5,-4,0.2
202504,76001019,3S2,2,1,1,2
202504,76001019,3S3,3,26,-23,0.12
202504,76001043,2,0,3,-3,0
202504,76020000,2,89,204,-115,0.44
202504,76020000,3,0,35,-35,0
202504,76020000,3S3,0,11,-11,0
202504,76020000,CA,3,20,-17,0.15
202504,76020003,2,0,1,-1,0
202504,76036000,2,108,139,-31,0.78
202504,76036000,2S2,0,4,-4,0
202504,76036000,2S3,1,1,0,1
202504,76036000,3,1,28,-27,0.04
202504,76036000,3S2,3,13,-10,0.23
202504,76036000,3S3,16,74,-58,0.22
202504,76036000,4,0,1,-1,0
202504,76036000,CA,1,37,-36,0.03
202504,76036001,2,0,5,-5,0
202504,76041000,2,57,175,-118,0.33
202504,76041000,2S2,0,1,-1,0
202504,76041000,3,0,14,-14,0
202504,76041000,3S2,1,0,1,NA
202504,76041000,3S3,1,44,-43,0.02
202504,76041000,CA,0,81,-81,0
202504,76041000,V2,0,1,-1,0
202504,76041006,2,0,3,-3,0
202504,76054000,2,39,15,24,2.6
202504,76054000,3,0,1,-1,0
202504,76100000,2,110,65,45,1.69
202504,76100000,2S2,0,1,-1,0
202504,76100000,3S3,3,0,3,NA
202504,76100000,CA,0,10,-10,0
202504,76100004,2,0,1,-1,0
202504,76100004,3S3,1,0,1,NA
202504,76100007,2,0,2,-2,0
202504,76100009,2,0,1,-1,0
202504,76100010,2,1,0,1,NA
202504,76109000,2,4137,3339,798,1.24
202504,76109000,2R2,0,4,-4,0
202504,76109000,2S1,1,2,-1,0.5
202504,76109000,2S2,13163,5715,7448,2.3
202504,76109000,2S3,3850,1898,1952,2.03
202504,76109000,3,142,51,91,2.78
202504,76109000,3S1,19,0,19,NA
202504,76109000,3S2,4577,2853,1724,1.6
202504,76109000,3S3,34232,9521,24711,3.6
202504,76109000,3S4,31,11,20,2.82
202504,76109000,4,41,24,17,1.71
202504,76109000,CA,986,839,147,1.18
202504,76109000,V2,4,0,4,NA
202504,76109000,V4,3,3,0,1
202504,76109006,2,0,4,-4,0
202504,76109006,3S3,0,16,-16,0
202504,76109006,CA,1,3,-2,0.33
202504,76109008,2,5,7,-2,0.71
202504,76109008,3S3,12,1,11,12
202504,76109008,CA,0,2,-2,0
202504,76109009,2,18,5,13,3.6
202504,76109009,2S2,0,1,-1,0
202504,76109009,3S3,34,1,33,34
202504,76109009,CA,2,3,-1,0.67
202504,76109015,2,20,1,19,20
202504,76109015,2S2,3,0,3,NA
202504,76109015,2S3,1,0,1,NA
202504,76109015,3S3,7,0,7,NA
202504,76109016,2,0,1,-1,0
202504,76109048,3S3,1,0,1,NA
202504,76109056,2,0,10,-10,0
202504,76109056,3S3,0,7,-7,0
202504,76109066,2,0,1,-1,0
202504,76109066,3S2,2,0,2,NA
202504,76109076,2,3,5,-2,0.6
202504,76109076,3S3,85,0,85,NA
202504,76109078,2,0,3,-3,0
202504,76109078,2S2,0,1,-1,0
202504,76109078,3,0,2,-2,0
202504,76109078,3S3,12,2,10,6
202504,76111000,2,4602,3684,918,1.25
202504,76111000,2R2,0,6,-6,0
202504,76111000,2S2,62,75,-13,0.83
202504,76111000,2S3,50,51,-1,0.98
202504,76111000,3,839,82,757,10.23
202504,76111000,3S2,600,303,297,1.98
202504,76111000,3S3,2885,6041,-3156,0.48
202504,76111000,4,6,2,4,3
202504,76111000,CA,656,520,136,1.26
202504,76111000,V2,1,0,1,NA
202504,76111000,V3,4,0,4,NA
202504,76111000,V4,1,3,-2,0.33
202504,76111002,2,0,1,-1,0
202504,76111002,3S3,1,0,1,NA
202504,76111016,3S3,2,0,2,NA
202504,76111020,2,5,0,5,NA
202504,76111020,3S3,0,1,-1,0
202504,76111024,3S2,0,2,-2,0
202504,76113000,2,210,538,-328,0.39
202504,76113000,2R2,0,1,-1,0
202504,76113000,2S2,6,51,-45,0.12
202504,76113000,2S3,11,15,-4,0.73
202504,76113000,3,36,36,0,1
202504,76113000,3S2,177,45,132,3.93
202504,76113000,3S3,247,365,-118,0.68
202504,76113000,4,0,2,-2,0
202504,76113000,CA,33,202,-169,0.16
202504,76113000,V3,0,3,-3,0
202504,76113000,V4,1,0,1,NA
202504,76113004,2,0,1,-1,0
202504,76113004,3S2,0,3,-3,0
202504,76113008,2,0,1,-1,0
202504,76113013,2,2,5,-3,0.4
202504,76113016,2,1,0,1,NA
202504,76113016,3S2,1,1,0,1
202504,76122000,2,32,269,-237,0.12
202504,76122000,2S3,2,0,2,NA
202504,76122000,3,0,9,-9,0
202504,76122000,3S2,1,0,1,NA
202504,76122000,3S3,4,17,-13,0.24
202504,76122000,CA,3,105,-102,0.03
202504,76126000,2,14,188,-174,0.07
202504,76126000,2R2,0,1,-1,0
202504,76126000,2S2,0,1,-1,0
202504,76126000,3,0,14,-14,0
202504,76126000,3S2,1,1,0,1
202504,76126000,CA,1,99,-98,0.01
202504,76126013,2,0,4,-4,0
202504,76126019,2,0,1,-1,0
202504,76130000,2,1592,2852,-1260,0.56
202504,76130000,2S1,50,1,49,50
202504,76130000,2S2,174,47,127,3.7
202504,76130000,2S3,10,13,-3,0.77
202504,76130000,3,400,126,274,3.17
202504,76130000,3S1,41,0,41,NA
202504,76130000,3S2,364,232,132,1.57
202504,76130000,3S3,830,1725,-895,0.48
202504,76130000,3S4,5,3,2,1.67
202504,76130000,4,0,1,-1,0
202504,76130000,CA,595,469,126,1.27
202504,76130000,V2,3,0,3,NA
202504,76130001,3S3,0,1,-1,0
202504,76130002,3S3,0,3,-3,0
202504,76130003,2,1,0,1,NA
202504,76130003,CA,0,1,-1,0
202504,76130004,2,2,3,-1,0.67
202504,76130006,2,1,5,-4,0.2
202504,76130007,2,11,3,8,3.67
202504,76130007,3S3,7,4,3,1.75
202504,76130008,2,417,38,379,10.97
202504,76130008,2S1,0,4,-4,0
202504,76130008,2S2,13,19,-6,0.68
202504,76130008,3,7,33,-26,0.21
202504,76130008,3S1,0,2,-2,0
202504,76130008,3S2,59,19,40,3.11
202504,76130008,3S3,8,11,-3,0.73
202504,76130008,CA,654,11,643,59.45
202504,76130009,3S3,37,0,37,NA
202504,76130016,2,0,21,-21,0
202504,76130016,CA,0,3,-3,0
202504,76147000,2,1633,2040,-407,0.8
202504,76147000,2R2,0,2,-2,0
202504,76147000,2S2,15,74,-59,0.2
202504,76147000,2S3,9,16,-7,0.56
202504,76147000,3,78,164,-86,0.48
202504,76147000,3S2,115,66,49,1.74
202504,76147000,3S3,1177,2161,-984,0.54
202504,76147000,3S4,0,2,-2,0
202504,76147000,4,0,1,-1,0
202504,76147000,CA,59,553,-494,0.11
202504,76147000,V2,0,1,-1,0
202504,76147000,V3,7,0,7,NA
202504,76147002,2,0,2,-2,0
202504,76147010,2,257,192,65,1.34
202504,76147010,3,6,0,6,NA
202504,76147010,3S2,3,0,3,NA
202504,76147010,3S3,48,14,34,3.43
202504,76147010,CA,32,2,30,16
202504,76147010,V2,1,0,1,NA
202504,76233000,2,231,195,36,1.18
202504,76233000,2S2,0,1,-1,0
202504,76233000,2S3,2,1,1,2
202504,76233000,3,1,0,1,NA
202504,76233000,3S2,104,0,104,NA
202504,76233000,3S3,159,42,117,3.79
202504,76233000,CA,0,178,-178,0
202504,76233000,V2,1,0,1,NA
202504,76233001,CA,0,1,-1,0
202504,76233002,2,0,5,-5,0
202504,76233004,2,1,2,-1,0.5
202504,76233005,2,0,7,-7,0
202504,76233009,2,0,10,-10,0
202504,76233011,2,0,24,-24,0
202504,76233011,CA,1,9,-8,0.11
202504,76233012,2,0,4,-4,0
202504,76233017,2,11,25,-14,0.44
202504,76233017,2S2,0,3,-3,0
202504,76233017,2S3,1,0,1,NA
202504,76233017,3S2,1,1,0,1
202504,76233017,3S3,2,23,-21,0.09
202504,76233017,4,1,0,1,NA
202504,76233017,CA,1,0,1,NA
202504,76233024,2,0,7,-7,0
202504,76233025,3S3,2,2,0,1
202504,76233043,2,0,7,-7,0
202504,76243000,2,1,10,-9,0.1
202504,76243000,CA,0,3,-3,0
202504,76243009,2,2,0,2,NA
202504,76243010,2,0,1,-1,0
202504,76243010,3S2,0,1,-1,0
202504,76243010,3S3,1,1,0,1
202504,76246000,2,1,20,-19,0.05
202504,76246000,CA,1,27,-26,0.04
202504,76246001,2,1,0,1,NA
202504,76248000,2,415,521,-106,0.8
202504,76248000,2R2,0,2,-2,0
202504,76248000,2S1,0,2,-2,0
202504,76248000,2S2,0,26,-26,0
202504,76248000,2S3,1,6,-5,0.17
202504,76248000,3,3,37,-34,0.08
202504,76248000,3S1,0,1,-1,0
202504,76248000,3S2,212,9,203,23.56
202504,76248000,3S3,766,64,702,11.97
202504,76248000,CA,112,321,-209,0.35
202504,76248000,V2,0,4,-4,0
202504,76248000,V3,0,2,-2,0
202504,76248001,3S2,2,0,2,NA
202504,76248005,2,0,2,-2,0
202504,76248005,3S3,16,46,-30,0.35
202504,76248009,2,1,19,-18,0.05
202504,76248009,3S3,0,1,-1,0
202504,76248009,CA,0,2,-2,0
202504,76250000,2,79,96,-17,0.82
202504,76250000,3,1,7,-6,0.14
202504,76250000,CA,0,14,-14,0
202504,76250005,2,0,2,-2,0
202504,76250013,2,0,5,-5,0
202504,76250013,2S2,1,0,1,NA
202504,76250013,3S3,0,1,-1,0
202504,76250013,CA,0,4,-4,0
202504,76275000,2,67,266,-199,0.25
202504,76275000,2R2,0,2,-2,0
202504,76275000,3,1,5,-4,0.2
202504,76275000,3S2,11,1,10,11
202504,76275000,3S3,190,7,183,27.14
202504,76275000,3S4,0,1,-1,0
202504,76275000,CA,6,236,-230,0.03
202504,76275000,V2,0,1,-1,0
202504,76275000,V4,2,0,2,NA
202504,76275008,2,0,81,-81,0
202504,76275008,3S2,1,2,-1,0.5
202504,76275008,3S3,5,16,-11,0.31
202504,76275008,CA,0,13,-13,0
202504,76306000,2,961,960,1,1
202504,76306000,2S1,0,18,-18,0
202504,76306000,2S2,18,33,-15,0.55
202504,76306000,2S3,1,5,-4,0.2
202504,76306000,3,1,58,-57,0.02
202504,76306000,3S1,0,17,-17,0
202504,76306000,3S2,3,54,-51,0.06
202504,76306000,3S3,3,57,-54,0.05
202504,76306000,CA,42,114,-72,0.37
202504,76306001,2,0,1,-1,0
202504,76306001,CA,0,2,-2,0
202504,76318000,2,190,308,-118,0.62
202504,76318000,2R2,0,4,-4,0
202504,76318000,2S2,2,17,-15,0.12
202504,76318000,3,6,23,-17,0.26
202504,76318000,3S2,33,29,4,1.14
202504,76318000,3S3,307,52,255,5.9
202504,76318000,4,0,1,-1,0
202504,76318000,CA,22,166,-144,0.13
202504,76318004,V2,0,2,-2,0
202504,76318006,3,1,0,1,NA
202504,76318006,3S3,1,0,1,NA
202504,76318008,2,1,8,-7,0.12
202504,76318008,2S2,0,1,-1,0
202504,76318008,3S3,0,22,-22,0
202504,76318008,CA,1,0,1,NA
202504,76364000,2,978,1975,-997,0.5
202504,76364000,2R2,0,4,-4,0
202504,76364000,2S1,2,2,0,1
202504,76364000,2S2,17,82,-65,0.21
202504,76364000,2S3,3,13,-10,0.23
202504,76364000,3,34,82,-48,0.41
202504,76364000,3S1,0,1,-1,0
202504,76364000,3S2,10,89,-79,0.11
202504,76364000,3S3,80,365,-285,0.22
202504,76364000,4,1,1,0,1
202504,76364000,CA,91,1083,-992,0.08
202504,76364000,V4,0,3,-3,0
202504,76364002,2,0,1,-1,0
202504,76364006,2,0,3,-3,0
202504,76364006,3S3,0,7,-7,0
202504,76364009,2,0,1,-1,0
202504,76364013,2,1,2,-1,0.5
202504,76364015,2,0,5,-5,0
202504,76377000,2,3,60,-57,0.05
202504,76377000,CA,0,32,-32,0
202504,76377001,2,0,6,-6,0
202504,76377004,2,0,1,-1,0
202504,76400000,2,135,380,-245,0.36
202504,76400000,2S2,0,3,-3,0
202504,76400000,2S3,1,6,-5,0.17
202504,76400000,3,5,51,-46,0.1
202504,76400000,3S2,20,1,19,20
202504,76400000,3S3,49,169,-120,0.29
202504,76400000,CA,0,61,-61,0
202504,76400007,2,31,36,-5,0.86
202504,76400007,3,0,3,-3,0
202504,76400007,3S3,11,24,-13,0.46
202504,76400007,CA,0,2,-2,0
202504,76403000,2,161,132,29,1.22
202504,76403000,3,233,16,217,14.56
202504,76403000,3S2,17,1,16,17
202504,76403000,3S3,22,0,22,NA
202504,76403000,CA,0,23,-23,0
202504,76403003,2,0,1,-1,0
202504,76403007,2,0,17,-17,0
202504,76403007,3,0,1,-1,0
202504,76403007,3S3,1,5,-4,0.2
202504,76403007,CA,0,1,-1,0
202504,76403010,2,0,2,-2,0
202504,76497000,2,118,88,30,1.34
202504,76497000,2S3,0,2,-2,0
202504,76497000,3,2,25,-23,0.08
202504,76497000,3S2,1,2,-1,0.5
202504,76497000,3S3,0,8,-8,0
202504,76497000,CA,0,34,-34,0
202504,76520000,2,10393,4994,5399,2.08
202504,76520000,2B1,0,4,-4,0
202504,76520000,2R2,155,0,155,NA
202504,76520000,2S1,0,11,-11,0
202504,76520000,2S2,1321,1494,-173,0.88
202504,76520000,2S3,343,279,64,1.23
202504,76520000,3,279,267,12,1.04
202504,76520000,3S1,2,9,-7,0.22
202504,76520000,3S2,1784,1667,117,1.07
202504,76520000,3S3,2795,3530,-735,0.79
202504,76520000,3S4,4,14,-10,0.29
202504,76520000,4,5,1,4,5
202504,76520000,CA,1647,1594,53,1.03
202504,76520000,V2,0,123,-123,0
202504,76520001,2,0,4,-4,0
202504,76520002,2,5,3,2,1.67
202504,76520002,2S1,0,2,-2,0
202504,76520002,2S2,0,9,-9,0
202504,76520002,3,0,5,-5,0
202504,76520002,3S2,0,7,-7,0
202504,76520002,3S3,9,2,7,4.5
202504,76520002,CA,1,1,0,1
202504,76520005,2,0,2,-2,0
202504,76520005,3S2,2,1,1,2
202504,76520009,CA,0,3,-3,0
202504,76520010,2,12,3,9,4
202504,76520010,3S3,2,0,2,NA
202504,76520014,2,0,2,-2,0
202504,76520014,3S3,0,2,-2,0
202504,76520014,4,0,1,-1,0
202504,76520022,2,1,7,-6,0.14
202504,76520022,2S2,0,1,-1,0
202504,76520022,2S3,0,1,-1,0
202504,76520022,3S2,0,1,-1,0
202504,76520022,3S3,0,4,-4,0
202504,76520023,2,0,9,-9,0
202504,76520024,2,306,74,232,4.14
202504,76520024,2S2,336,1166,-830,0.29
202504,76520024,3S2,1,72,-71,0.01
202504,76520024,3S3,0,1,-1,0
202504,76520024,CA,12,0,12,NA
202504,76520026,2,123,58,65,2.12
202504,76520026,2S2,1,6,-5,0.17
202504,76520026,2S3,0,10,-10,0
202504,76520026,3,7,4,3,1.75
202504,76520026,3S2,2,6,-4,0.33
202504,76520026,3S3,9,78,-69,0.12
202504,76520026,3S4,1,0,1,NA
202504,76520026,CA,3,36,-33,0.08
202504,76520028,2,1,1,0,1
202504,76520028,CA,1,1,0,1
202504,76520032,2,0,1,-1,0
202504,76520038,2,63,21,42,3
202504,76520038,2S3,0,1,-1,0
202504,76520038,3S2,0,8,-8,0
202504,76520038,3S3,6,23,-17,0.26
202504,76520038,CA,1,2,-1,0.5
202504,76563000,2,229,332,-103,0.69
202504,76563000,2R2,0,1,-1,0
202504,76563000,2S2,0,21,-21,0
202504,76563000,2S3,0,5,-5,0
202504,76563000,3,2,13,-11,0.15
202504,76563000,3S1,0,1,-1,0
202504,76563000,3S2,15,4,11,3.75
202504,76563000,3S3,120,156,-36,0.77
202504,76563000,4,0,1,-1,0
202504,76563000,CA,14,182,-168,0.08
202504,76563001,2,0,2,-2,0
202504,76563013,2,0,2,-2,0
202504,76563018,2,0,8,-8,0
202504,76563018,2S2,0,3,-3,0
202504,76563018,3S2,0,1,-1,0
202504,76563020,2,0,1,-1,0
202504,76606000,2,270,261,9,1.03
202504,76606000,2R2,0,1,-1,0
202504,76606000,2S2,0,16,-16,0
202504,76606000,3,4,95,-91,0.04
202504,76606000,3S2,0,16,-16,0
202504,76606000,3S3,0,12,-12,0
202504,76606000,CA,3,80,-77,0.04
202504,76616000,2,83,98,-15,0.85
202504,76616000,2S2,0,2,-2,0
202504,76616000,2S3,1,0,1,NA
202504,76616000,3,3,10,-7,0.3
202504,76616000,3S2,3,1,2,3
202504,76616000,3S3,118,8,110,14.75
202504,76616000,4,0,1,-1,0
202504,76616000,CA,0,34,-34,0
202504,76616009,2,0,5,-5,0
202504,76616009,CA,0,1,-1,0
202504,76622000,2,264,403,-139,0.66
202504,76622000,2S2,0,8,-8,0
202504,76622000,2S3,0,1,-1,0
202504,76622000,3,3,28,-25,0.11
202504,76622000,3S2,2,2,0,1
202504,76622000,3S3,32,51,-19,0.63
202504,76622000,4,1,3,-2,0.33
202504,76622000,CA,5,142,-137,0.04
202504,76622000,V3,0,4,-4,0
202504,76622005,2,6,27,-21,0.22
202504,76622005,3S2,2,0,2,NA
202504,76622005,3S3,28,61,-33,0.46
202504,76622005,3S4,0,1,-1,0
202504,76622005,CA,5,8,-3,0.62
202504,76670000,2,53,98,-45,0.54
202504,76670000,2S2,1,5,-4,0.2
202504,76670000,2S3,7,26,-19,0.27
202504,76670000,3,3,11,-8,0.27
202504,76670000,3S2,3,35,-32,0.09
202504,76670000,3S3,38,191,-153,0.2
202504,76670000,CA,3,18,-15,0.17
202504,76670007,2,4,26,-22,0.15
202504,76670007,3S2,0,16,-16,0
202504,76670007,3S3,0,8,-8,0
202504,76670011,2,0,1,-1,0
202504,76670012,2,0,1,-1,0
202504,76670015,3S2,0,1,-1,0
202504,76736000,2,166,530,-364,0.31
202504,76736000,3,1,6,-5,0.17
202504,76736000,3S2,10,0,10,NA
202504,76736000,3S3,1,11,-10,0.09
202504,76736000,CA,2,165,-163,0.01
202504,76736004,2,1,0,1,NA
202504,76736004,3S2,1,0,1,NA
202504,76736004,V2R2,2,1,1,2
202504,76823000,2,9,159,-150,0.06
202504,76823000,3,1,1,0,1
202504,76823000,3S3,0,3,-3,0
202504,76823000,CA,3,64,-61,0.05
202504,76828000,2,86,141,-55,0.61
202504,76828000,3,0,15,-15,0
202504,76828000,3S3,0,1,-1,0
202504,76828000,CA,0,45,-45,0
202504,76828004,2,0,2,-2,0
202504,76828004,CA,0,1,-1,0
202504,76828006,2,1,0,1,NA
202504,76828017,CA,0,2,-2,0
202504,76834000,2,863,2973,-2110,0.29
202504,76834000,2R2,0,30,-30,0
202504,76834000,2S1,2,6,-4,0.33
202504,76834000,2S2,40,142,-102,0.28
202504,76834000,2S3,9,33,-24,0.27
202504,76834000,3,52,86,-34,0.6
202504,76834000,3S1,2,7,-5,0.29
202504,76834000,3S2,109,109,0,1
202504,76834000,3S3,795,1451,-656,0.55
202504,76834000,4,1,1,0,1
202504,76834000,CA,574,910,-336,0.63
202504,76834002,3S3,0,14,-14,0
202504,76834003,2,0,1,-1,0
202504,76834004,3S3,0,4,-4,0
202504,76834010,2,0,5,-5,0
202504,76834023,2,0,2,-2,0
202504,76845000,2,2,26,-24,0.08
202504,76845000,3,0,1,-1,0
202504,76845000,3S3,0,1,-1,0
202504,76845000,CA,1,25,-24,0.04
202504,76863000,2,143,31,112,4.61
202504,76863000,3,2,0,2,NA
202504,76863000,CA,0,45,-45,0
202504,76863012,2,0,1,-1,0
202504,76869000,2,39,115,-76,0.34
202504,76869000,2S2,1,4,-3,0.25
202504,76869000,2S3,0,2,-2,0
202504,76869000,3,14,0,14,NA
202504,76869000,3S2,4,29,-25,0.14
202504,76869000,3S3,40,977,-937,0.04
202504,76869000,3S4,3,1,2,3
202504,76869000,CA,2,72,-70,0.03
202504,76869000,V2,7,0,7,NA
202504,76890000,2,1058,250,808,4.23
202504,76890000,2R2,0,3,-3,0
202504,76890000,2S1,0,3,-3,0
202504,76890000,2S2,2180,2204,-24,0.99
202504,76890000,2S3,273,49,224,5.57
202504,76890000,3,45,55,-10,0.82
202504,76890000,3S1,0,3,-3,0
202504,76890000,3S2,61,365,-304,0.17
202504,76890000,3S3,911,1271,-360,0.72
202504,76890000,4,12,0,12,NA
202504,76890000,CA,5,56,-51,0.09
202504,76890000,V2,1,0,1,NA
202504,76890006,2,20,4,16,5
202504,76890006,2S2,6,7,-1,0.86
202504,76890006,2S3,3,2,1,1.5
202504,76890006,3,9,0,9,NA
202504,76890006,3S3,15,2,13,7.5
202504,76890006,CA,0,1,-1,0
202504,76890007,2,0,4,-4,0
202504,76890008,2S3,1,0,1,NA
202504,76892000,2,35316,7804,27512,4.53
202504,76892000,2B1,3,9,-6,0.33
202504,76892000,2R2,5,8,-3,0.62
202504,76892000,2R3,4,4,0,1
202504,76892000,2S1,0,2,-2,0
202504,76892000,2S2,1589,2645,-1056,0.6
202504,76892000,2S3,423,710,-287,0.6
202504,76892000,3,1343,160,1183,8.39
202504,76892000,3S1,0,2,-2,0
202504,76892000,3S2,3248,3521,-273,0.92
202504,76892000,3S3,7821,8372,-551,0.93
202504,76892000,3S4,9,13,-4,0.69
202504,76892000,4,21,5,16,4.2
202504,76892000,CA,10486,1187,9299,8.83
202504,76892000,V2,17,0,17,NA
202504,76892000,V3,7,0,7,NA
202504,76892000,V4,9,0,9,NA
202504,76892002,2,0,24,-24,0
202504,76892002,CA,0,2,-2,0
202504,76892004,2,152,116,36,1.31
202504,76892004,2S2,2,0,2,NA
202504,76892004,3,0,3,-3,0
202504,76892004,3S2,11,1,10,11
202504,76892004,3S3,30,22,8,1.36
202504,76892004,4,0,1,-1,0
202504,76892004,CA,3,2,1,1.5
202504,76892005,2,18,1,17,18
202504,76892005,3,3,0,3,NA
202504,76892005,3S2,2,0,2,NA
202504,76892005,3S3,3,30,-27,0.1
202504,76892008,2,123,2,121,61.5
202504,76892008,3,11,1,10,11
202504,76892008,3S2,2,0,2,NA
202504,76892008,3S3,52,0,52,NA
202504,76892010,2,1,2,-1,0.5
202504,76892010,3S2,0,1,-1,0
202504,76892010,3S3,0,2,-2,0
202504,76892012,2,0,19,-19,0
202504,76892017,2,297,5,292,59.4
202504,76892017,3S2,4,50,-46,0.08
202504,76892017,3S3,48,22,26,2.18
202504,76892017,CA,174,0,174,NA
202504,76895000,2,76,572,-496,0.13
202504,76895000,2R2,0,10,-10,0
202504,76895000,2S2,0,12,-12,0
202504,76895000,2S3,2,8,-6,0.25
202504,76895000,3,10,6,4,1.67
202504,76895000,3S2,97,36,61,2.69
202504,76895000,3S3,287,133,154,2.16
202504,76895000,4,1,0,1,NA
202504,76895000,CA,3,165,-162,0.02
202504,76895002,2,181,410,-229,0.44
202504,76895002,2S2,44,20,24,2.2
202504,76895002,2S3,16,17,-1,0.94
202504,76895002,3,7,0,7,NA
202504,76895002,3S2,91,64,27,1.42
202504,76895002,3S3,266,256,10,1.04
202504,76895002,3S4,0,4,-4,0
202504,76895002,CA,2,80,-78,0.03
202504,76895002,V2,0,2,-2,0
202504,76895003,3S3,0,2,-2,0
202504,76895004,2,1,0,1,NA
202504,76895005,2,1,0,1,NA
202504,81001000,2,210,1927,-1717,0.11
202504,81001000,2S2,0,6,-6,0
202504,81001000,2S3,0,1,-1,0
202504,81001000,3,23,59,-36,0.39
202504,81001000,3S2,0,4,-4,0
202504,81001000,3S3,54,426,-372,0.13
202504,81001000,3S4,2,2,0,1
202504,81001000,4,0,2,-2,0
202504,81001000,CA,25,86,-61,0.29
202504,81001000,V2,19,10,9,1.9
202504,81001000,V3,148,77,71,1.92
202504,81001003,2,0,1,-1,0
202504,81065000,2,25,193,-168,0.13
202504,81065000,2S2,0,1,-1,0
202504,81065000,3,0,38,-38,0
202504,81065000,3S1,0,7,-7,0
202504,81065000,3S2,1,1,0,1
202504,81065000,3S3,7,35,-28,0.2
202504,81065000,CA,1,11,-10,0.09
202504,81065000,V2,4,80,-76,0.05
202504,81065000,V3,6,374,-368,0.02
202504,81065008,2,1,12,-11,0.08
202504,81065009,2,0,3,-3,0
202504,81065017,2,0,14,-14,0
202504,81065017,CA,2,0,2,NA
202504,81065020,2,1,1,0,1
202504,81065020,2S2,0,1,-1,0
202504,81065020,3S3,3,7,-4,0.43
202504,81220000,2,0,23,-23,0
202504,81300000,2,1,99,-98,0.01
202504,81300000,2S3,1,0,1,NA
202504,81300000,3,0,1,-1,0
202504,81300000,3S2,1,0,1,NA
202504,81300000,3S3,7,13,-6,0.54
202504,81300000,CA,0,5,-5,0
202504,81591000,2,2,3,-1,0.67
202504,81591000,3,0,1,-1,0
202504,81591000,3S3,0,1,-1,0
202504,81736000,2,156,1017,-861,0.15
202504,81736000,2S2,0,1,-1,0
202504,81736000,2S3,3,1,2,3
202504,81736000,3,77,11,66,7
202504,81736000,3S1,0,1,-1,0
202504,81736000,3S2,2,5,-3,0.4
202504,81736000,3S3,33,73,-40,0.45
202504,81736000,4,5,1,4,5
202504,81736000,CA,7,22,-15,0.32
202504,81736000,V2,87,0,87,NA
202504,81736000,V3,346,0,346,NA
202504,81736008,2,0,2,-2,0
202504,81794000,2,100,581,-481,0.17
202504,81794000,2S2,0,5,-5,0
202504,81794000,2S3,2,3,-1,0.67
202504,81794000,3,2,30,-28,0.07
202504,81794000,3S1,1,1,0,1
202504,81794000,3S2,8,4,4,2
202504,81794000,3S3,1077,70,1007,15.39
202504,81794000,CA,3,56,-53,0.05
202504,81794004,2,5,10,-5,0.5
202504,81794004,3S3,79,1,78,79
202504,81794004,CA,0,3,-3,0
202504,81794010,2,0,4,-4,0
202504,81794019,2,0,1,-1,0
202504,85001000,2,1182,3211,-2029,0.37
202504,85001000,2R2,0,1,-1,0
202504,85001000,2S1,4,4,0,1
202504,85001000,2S2,94,208,-114,0.45
202504,85001000,2S3,37,48,-11,0.77
202504,85001000,3,168,278,-110,0.6
202504,85001000,3S1,19,9,10,2.11
202504,85001000,3S2,549,1067,-518,0.51
202504,85001000,3S3,3467,3562,-95,0.97
202504,85001000,3S4,22,7,15,3.14
202504,85001000,4,1,3,-2,0.33
202504,85001000,4S2,3,3,0,1
202504,85001000,CA,351,679,-328,0.52
202504,85001000,V2,84,13,71,6.46
202504,85001000,V3,333,26,307,12.81
202504,85001000,V4,0,1,-1,0
202504,85001001,2,3,2,1,1.5
202504,85001001,3,1,0,1,NA
202504,85001001,3S2,6,4,2,1.5
202504,85001001,3S3,62,13,49,4.77
202504,85001001,CA,0,2,-2,0
202504,85001002,2,4,16,-12,0.25
202504,85001002,3,6,2,4,3
202504,85001002,3S2,9,22,-13,0.41
202504,85001002,3S3,49,273,-224,0.18
202504,85001002,CA,0,2,-2,0
202504,85001002,V3,88,5,83,17.6
202504,85001003,2,2,8,-6,0.25
202504,85001003,2S2,0,2,-2,0
202504,85001003,2S3,0,1,-1,0
202504,85001003,3S2,24,2,22,12
202504,85001003,3S3,43,12,31,3.58
202504,85001003,CA,0,2,-2,0
202504,85001006,2S2,0,1,-1,0
202504,85001006,3S2,0,11,-11,0
202504,85001006,3S3,0,8,-8,0
202504,85001006,CA,0,1,-1,0
202504,85001007,2,0,1,-1,0
202504,85001007,3S3,6,1,5,6
202504,85010000,2,133,226,-93,0.59
202504,85010000,2S2,3,11,-8,0.27
202504,85010000,2S3,0,1,-1,0
202504,85010000,3,224,130,94,1.72
202504,85010000,3S1,0,16,-16,0
202504,85010000,3S2,376,1596,-1220,0.24
202504,85010000,3S3,997,1488,-491,0.67
202504,85010000,CA,4,65,-61,0.06
202504,85010000,V2,18,70,-52,0.26
202504,85010000,V3,138,1083,-945,0.13
202504,85010000,V4,3,36,-33,0.08
202504,85010001,3S2,6,0,6,NA
202504,85010001,3S3,198,7,191,28.29
202504,85010001,CA,0,1,-1,0
202504,85010002,CA,0,1,-1,0
202504,85010005,2,1,2,-1,0.5
202504,85010005,3S3,0,6,-6,0
202504,85010005,V3,0,25,-25,0
202504,85010010,3S3,16,0,16,NA
202504,85015000,2,0,3,-3,0
202504,85015000,3,0,3,-3,0
202504,85015000,CA,0,1,-1,0
202504,85125000,2,23,100,-77,0.23
202504,85125000,2S3,0,1,-1,0
202504,85125000,3,1,10,-9,0.1
202504,85125000,3S2,5,62,-57,0.08
202504,85125000,3S3,0,138,-138,0
202504,85125000,CA,1,11,-10,0.09
202504,85125000,V2,0,16,-16,0
202504,85125000,V3,0,42,-42,0
202504,85139000,2,46,136,-90,0.34
202504,85139000,2S2,8,13,-5,0.62
202504,85139000,2S3,1,2,-1,0.5
202504,85139000,3,6,86,-80,0.07
202504,85139000,3S2,147,118,29,1.25
202504,85139000,3S3,421,539,-118,0.78
202504,85139000,3S4,0,1,-1,0
202504,85139000,CA,1,65,-64,0.02
202504,85139000,V2,0,66,-66,0
202504,85139000,V3,0,284,-284,0
202504,85139003,3S3,1,0,1,NA
202504,85139005,3S2,5,1,4,5
202504,85139005,3S3,5,3,2,1.67
202504,85162000,2,19,113,-94,0.17
202504,85162000,2S2,2,8,-6,0.25
202504,85162000,3,13,36,-23,0.36
202504,85162000,3S2,18,778,-760,0.02
202504,85162000,3S3,18,1807,-1789,0.01
202504,85162000,CA,5,39,-34,0.13
202504,85162000,V3,0,4,-4,0
202504,85162004,3S3,0,99,-99,0
202504,85225000,2,35,33,2,1.06
202504,85225000,2S2,3,6,-3,0.5
202504,85225000,2S3,2,2,0,1
202504,85225000,3,2,6,-4,0.33
202504,85225000,3S1,4,0,4,NA
202504,85225000,3S2,10,4,6,2.5
202504,85225000,3S3,157,74,83,2.12
202504,85225000,3S4,0,2,-2,0
202504,85225000,CA,1,1,0,1
202504,85225000,V3,15,3,12,5
202504,85225009,2,5,9,-4,0.56
202504,85225009,2S2,0,1,-1,0
202504,85225009,2S3,0,1,-1,0
202504,85225009,3S3,1,8,-7,0.12
202504,85225009,CA,2,6,-4,0.33
202504,85225016,2,1,3,-2,0.33
202504,85225016,3S2,1,1,0,1
202504,85225016,3S3,0,1,-1,0
202504,85225016,V3,15,0,15,NA
202504,85230000,2,51,140,-89,0.36
202504,85230000,2S1,1,1,0,1
202504,85230000,2S2,23,12,11,1.92
202504,85230000,2S3,13,8,5,1.62
202504,85230000,3,24,49,-25,0.49
202504,85230000,3S1,2,0,2,NA
202504,85230000,3S2,471,23,448,20.48
202504,85230000,3S3,1082,190,892,5.69
202504,85230000,3S4,2,5,-3,0.4
202504,85230000,CA,2,11,-9,0.18
202504,85230000,V2,8,24,-16,0.33
202504,85230000,V3,37,342,-305,0.11
202504,85230003,2,0,4,-4,0
202504,85230003,3S2,297,0,297,NA
202504,85230003,3S3,106,0,106,NA
202504,85230006,3S3,26,0,26,NA
202504,85250000,2,91,477,-386,0.19
202504,85250000,2S2,8,4,4,2
202504,85250000,2S3,2,1,1,2
202504,85250000,3,3,36,-33,0.08
202504,85250000,3S2,211,31,180,6.81
202504,85250000,3S3,464,269,195,1.72
202504,85250000,3S4,0,3,-3,0
202504,85250000,CA,17,87,-70,0.2
202504,85250000,V2,0,4,-4,0
202504,85250000,V3,6,6,0,1
202504,85250001,3S3,5,0,5,NA
202504,85250002,2,7,10,-3,0.7
202504,85250002,2S1,1,0,1,NA
202504,85250002,2S2,2,0,2,NA
202504,85250002,3S1,3,0,3,NA
202504,85250002,3S2,10,4,6,2.5
202504,85250002,3S3,17,4,13,4.25
202504,85250002,3S4,1,0,1,NA
202504,85250002,4S2,0,2,-2,0
202504,85250003,2S2,0,2,-2,0
202504,85250003,2S3,0,2,-2,0
202504,85250003,3S2,2,2,0,1
202504,85250003,3S3,12,8,4,1.5
202504,85250003,CA,1,1,0,1
202504,85250005,2,0,2,-2,0
202504,85250006,2,0,1,-1,0
202504,85263000,2,22,102,-80,0.22
202504,85263000,2S2,2,1,1,2
202504,85263000,3,10,18,-8,0.56
202504,85263000,3S2,10,14,-4,0.71
202504,85263000,3S3,249,101,148,2.47
202504,85263000,4S2,1,0,1,NA
202504,85263000,CA,5,19,-14,0.26
202504,85263000,V3,19,6,13,3.17
202504,85279000,3S2,0,1,-1,0
202504,85300000,2,1,2,-1,0.5
202504,85300000,3,0,2,-2,0
202504,85300000,3S2,1,2,-1,0.5
202504,85300000,CA,0,1,-1,0
202504,85300001,2,0,2,-2,0
202504,85300001,3,1,2,-1,0.5
202504,85300001,CA,0,24,-24,0
202504,85315000,2,0,8,-8,0
202504,85315000,3S2,0,1,-1,0
202504,85315000,3S3,0,2,-2,0
202504,85325000,2,20,45,-25,0.44
202504,85325000,2S1,0,1,-1,0
202504,85325000,2S2,3,9,-6,0.33
202504,85325000,2S3,3,11,-8,0.27
202504,85325000,3,4,14,-10,0.29
202504,85325000,3S1,0,4,-4,0
202504,85325000,3S2,48,11,37,4.36
202504,85325000,3S3,332,216,116,1.54
202504,85325000,3S4,2,5,-3,0.4
202504,85325000,CA,5,7,-2,0.71
202504,85325000,V3,0,60,-60,0
202504,85400000,2,6,5,1,1.2
202504,85400000,3,0,2,-2,0
202504,85400000,3S2,1,0,1,NA
202504,85400000,CA,0,4,-4,0
202504,85410000,2,59,259,-200,0.23
202504,85410000,2S1,1,0,1,NA
202504,85410000,2S2,23,48,-25,0.48
202504,85410000,2S3,2,3,-1,0.67
202504,85410000,3,56,104,-48,0.54
202504,85410000,3S1,8,1,7,8
202504,85410000,3S2,231,1619,-1388,0.14
202504,85410000,3S3,850,3302,-2452,0.26
202504,85410000,3S4,1,0,1,NA
202504,85410000,4,0,5,-5,0
202504,85410000,CA,14,67,-53,0.21
202504,85410000,V2,58,2,56,29
202504,85410000,V3,177,0,177,NA
202504,85410001,2,0,1,-1,0
202504,85410001,3S2,0,66,-66,0
202504,85410001,3S3,0,141,-141,0
202504,85410002,2S3,0,1,-1,0
202504,85410002,3S2,0,1,-1,0
202504,85410002,3S3,0,2,-2,0
202504,85410004,CA,1,0,1,NA
202504,85410005,2S2,0,10,-10,0
202504,85410005,3S2,0,7,-7,0
202504,85410005,3S3,0,32,-32,0
202504,85410005,3S4,0,8,-8,0
202504,85430000,2,23,93,-70,0.25
202504,85430000,2S1,2,0,2,NA
202504,85430000,2S2,11,10,1,1.1
202504,85430000,2S3,11,1,10,11
202504,85430000,3,1,9,-8,0.11
202504,85430000,3S1,3,0,3,NA
202504,85430000,3S2,20,9,11,2.22
202504,85430000,3S3,38,192,-154,0.2
202504,85430000,3S4,5,0,5,NA
202504,85430000,4S2,2,1,1,2
202504,85430000,CA,5,23,-18,0.22
202504,85430000,V3,0,36,-36,0
202504,85430001,V3,6,0,6,NA
202504,85430006,3S2,0,1,-1,0
202504,85430006,3S3,0,3,-3,0
202504,85440000,2,111,472,-361,0.24
202504,85440000,2R2,0,1,-1,0
202504,85440000,2S1,0,2,-2,0
202504,85440000,2S2,22,35,-13,0.63
202504,85440000,2S3,14,20,-6,0.7
202504,85440000,3,70,111,-41,0.63
202504,85440000,3S1,1,0,1,NA
202504,85440000,3S2,457,97,360,4.71
202504,85440000,3S3,323,480,-157,0.67
202504,85440000,3S4,1,1,0,1
202504,85440000,CA,31,155,-124,0.2
202504,85440000,V2,5,0,5,NA
202504,85440000,V3,687,1,686,687
202504,85440001,2,1,1,0,1
202504,85440001,2S2,9,0,9,NA
202504,85440001,2S3,1,0,1,NA
202504,85440001,3,2,3,-1,0.67
202504,85440001,3S2,7,0,7,NA
202504,85440001,3S3,28,3,25,9.33
202504,85440001,3S4,8,0,8,NA
202504,85440001,CA,0,3,-3,0
202504,85440002,3S3,3,3,0,1
202504,85440003,2S2,1,1,0,1
202504,86001000,2,165,395,-230,0.42
202504,86001000,2R2,0,7,-7,0
202504,86001000,2S2,0,67,-67,0
202504,86001000,2S3,0,5,-5,0
202504,86001000,3,44,20,24,2.2
202504,86001000,3S2,2,7,-5,0.29
202504,86001000,3S3,9,170,-161,0.05
202504,86001000,3S4,1,4,-3,0.25
202504,86001000,CA,95,135,-40,0.7
202504,86001000,V2,2,2,0,1
202504,86001004,2,0,2,-2,0
202504,86001004,3,23,2,21,11.5
202504,86219000,2,0,3,-3,0
202504,86219000,3S3,0,1,-1,0
202504,86320000,2,115,153,-38,0.75
202504,86320000,2R2,0,7,-7,0
202504,86320000,2S1,0,1,-1,0
202504,86320000,2S3,0,6,-6,0
202504,86320000,3,151,7,144,21.57
202504,86320000,3S1,4,7,-3,0.57
202504,86320000,3S2,15,202,-187,0.07
202504,86320000,3S3,127,312,-185,0.41
202504,86320000,3S4,0,5,-5,0
202504,86320000,CA,1,32,-31,0.03
202504,86320000,V2,1,1,0,1
202504,86320012,2,0,1,-1,0
202504,86568000,2,113,687,-574,0.16
202504,86568000,2R2,0,3,-3,0
202504,86568000,2S2,4,13,-9,0.31
202504,86568000,2S3,1,8,-7,0.12
202504,86568000,3,6,182,-176,0.03
202504,86568000,3S1,5,3,2,1.67
202504,86568000,3S2,294,54,240,5.44
202504,86568000,3S3,609,500,109,1.22
202504,86568000,3S4,17,0,17,NA
202504,86568000,4,0,1,-1,0
202504,86568000,CA,25,87,-62,0.29
202504,86568000,V2,0,10,-10,0
202504,86568000,V3,0,5,-5,0
202504,86568012,2,0,4,-4,0
202504,86568012,3S2,0,1,-1,0
202504,86568013,2,5,58,-53,0.09
202504,86568013,3S3,32,4,28,8
202504,86568013,CA,0,14,-14,0
202504,86568014,2,2,0,2,NA
202504,86568016,2,0,2,-2,0
202504,86568016,3,1,0,1,NA
202504,86568016,3S2,5,0,5,NA
202504,86568016,3S3,2,4,-2,0.5
202504,86568016,CA,0,1,-1,0
202504,86568017,3S2,13,0,13,NA
202504,86568017,3S3,26,0,26,NA
202504,86568019,2,1,0,1,NA
202504,86568019,3,1,0,1,NA
202504,86568019,3S3,1,0,1,NA
202504,86568021,2,0,1,-1,0
202504,86568021,3S2,1,0,1,NA
202504,86568021,3S3,4,0,4,NA
202504,86568026,2,2,2,0,1
202504,86568026,3,1,0,1,NA
202504,86568026,3S2,3,0,3,NA
202504,86568026,3S3,14,1,13,14
202504,86569000,2,3,24,-21,0.12
202504,86569000,3,45,18,27,2.5
202504,86569000,3S2,1,2,-1,0.5
202504,86569000,3S3,0,3,-3,0
202504,86569000,CA,0,17,-17,0
202504,86569000,V2,11,0,11,NA
202504,86569000,V3,5,0,5,NA
202504,86571000,2,1,30,-29,0.03
202504,86571000,3,0,1,-1,0
202504,86571000,3S3,1,2,-1,0.5
202504,86571000,CA,0,2,-2,0
202504,86571000,V2,1,0,1,NA
202504,86573000,2,0,9,-9,0
202504,86573002,2,0,1,-1,0
202504,86749000,2,7,63,-56,0.11
202504,86749000,2S2,2,0,2,NA
202504,86749000,2S3,1,0,1,NA
202504,86749000,3,2,2,0,1
202504,86749000,3S3,4,10,-6,0.4
202504,86749000,CA,6,27,-21,0.22
202504,86749003,2,0,2,-2,0
202504,86749003,3,1,0,1,NA
202504,86755000,2,2,29,-27,0.07
202504,86755000,2S2,0,1,-1,0
202504,86755000,3S2,0,1,-1,0
202504,86755000,3S3,0,7,-7,0
202504,86755000,CA,0,28,-28,0
202504,86757000,2,9,81,-72,0.11
202504,86757000,2S1,1,0,1,NA
202504,86757000,2S2,0,1,-1,0
202504,86757000,2S3,3,0,3,NA
202504,86757000,3,7,149,-142,0.05
202504,86757000,3S1,7,1,6,7
202504,86757000,3S2,9,109,-100,0.08
202504,86757000,3S3,20,740,-720,0.03
202504,86757000,3S4,1,0,1,NA
202504,86757000,CA,1,16,-15,0.06
202504,86757001,2,0,9,-9,0
202504,86757001,3S3,1,0,1,NA
202504,86757001,CA,0,1,-1,0
202504,86760000,2,0,3,-3,0
202504,86760000,3S3,0,1,-1,0
202504,86760000,CA,0,12,-12,0
202504,86865000,2,34,445,-411,0.08
202504,86865000,2S2,0,1,-1,0
202504,86865000,2S3,0,1,-1,0
202504,86865000,3,22,37,-15,0.59
202504,86865000,3S2,4,4,0,1
202504,86865000,3S3,5,73,-68,0.07
202504,86865000,CA,3,22,-19,0.14
202504,86865000,V3,0,1,-1,0
202504,86865005,2,0,2,-2,0
202504,86865017,2,0,5,-5,0
202504,86865017,CA,0,10,-10,0
202504,86865021,3S3,0,2,-2,0
202504,86885000,2,13,131,-118,0.1
202504,86885000,3,65,88,-23,0.74
202504,86885000,3S2,62,7,55,8.86
202504,86885000,3S3,591,80,511,7.39
202504,86885000,3S4,0,3,-3,0
202504,86885000,CA,19,18,1,1.06
202504,86885000,V2,0,1,-1,0
202504,86885001,2,0,2,-2,0
202504,86885001,3,21,6,15,3.5
202504,86885001,3S2,2,0,2,NA
202504,86885001,3S3,25,0,25,NA
202504,86885004,2,0,4,-4,0
202504,86885009,2,0,2,-2,0
202504,86885009,3S3,0,1,-1,0
202504,86885010,2,1,1,0,1
202504,86885010,3S3,1,0,1,NA
202504,88001000,2,0,1,-1,0
202504,88564000,2,0,3,-3,0
202504,91001000,2,0,58,-58,0
202504,91001000,3S3,0,12,-12,0
202504,91001000,CA,0,4,-4,0
202504,91460000,2,0,1,-1,0
202504,94001000,2,0,28,-28,0
202504,94001000,3,0,8,-8,0
202504,94001000,3S2,0,16,-16,0
202504,94001000,3S3,0,30,-30,0
202504,94001000,CA,0,1,-1,0
202504,94343000,CA,0,1,-1,0
202504,94884000,2S2,0,1,-1,0
202504,95001000,2,114,1459,-1345,0.08
202504,95001000,2R2,0,2,-2,0
202504,95001000,2S2,1,11,-10,0.09
202504,95001000,3,6,73,-67,0.08
202504,95001000,3S2,1,25,-24,0.04
202504,95001000,3S3,2,349,-347,0.01
202504,95001000,4,0,2,-2,0
202504,95001000,CA,28,324,-296,0.09
202504,95001000,V2,0,2,-2,0
202504,95001000,V3,0,6,-6,0
202504,95015000,2,1,34,-33,0.03
202504,95015000,3,1,7,-6,0.14
202504,95015000,3S3,0,7,-7,0
202504,95015000,CA,0,5,-5,0
202504,95025000,2,0,31,-31,0
202504,95025000,2S3,0,1,-1,0
202504,95025000,3S3,1,9,-8,0.11
202504,95025000,CA,0,4,-4,0
202504,95200000,CA,0,1,-1,0
202504,97001000,2,0,23,-23,0
202504,97001000,3,0,11,-11,0
202504,97001000,3S4,0,1,-1,0
202504,97001000,CA,0,2,-2,0
202504,97161000,3,0,2,-2,0
202504,99001000,2,2,73,-71,0.03
202504,99001000,3,3,34,-31,0.09
202504,99001000,3S2,0,41,-41,0
202504,99001000,3S3,1,96,-95,0.01
202504,99001000,CA,0,9,-9,0
202504,99001000,V4,0,3,-3,0
202504,99001002,2,0,2,-2,0
202504,99524000,2,3,74,-71,0.04
202504,99524000,3,0,9,-9,0
202504,99524000,3S2,3,0,3,NA
202504,99524000,3S3,7,1,6,7
202504,99524000,CA,0,12,-12,0
202504,99524001,3,0,1,-1,0
202504,99524007,3S3,0,15,-15,0
202504,99624000,2,1,34,-33,0.03
202504,99624000,2S3,1,0,1,NA
202504,99624000,3,1,0,1,NA
202504,99624000,3S2,3,0,3,NA
202504,99624000,3S3,7,35,-28,0.2
202504,99624000,CA,0,5,-5,0
202504,99624000,V2,0,5,-5,0
202504,99624000,V3,0,4,-4,0
202504,99773000,2,1,30,-29,0.03
202504,99773000,3,1,30,-29,0.03
202504,99773000,3S2,3,3,0,1
202504,99773000,3S3,88,56,32,1.57
202504,99773000,4,1,0,1,NA
202504,99773000,CA,1,2,-1,0.5
202504,99773001,2,0,1,-1,0
202504,99773002,2,0,8,-8,0
202504,99773002,3,0,1,-1,0
202504,99773002,3S3,64,43,21,1.49
202504,99773002,CA,0,1,-1,0
202504,99773004,3S2,0,5,-5,0
202504,99773004,3S3,0,3,-3,0
202505,5001000,2,0,1428,-1428,0
202505,5001000,2R2,0,3,-3,0
202505,5001000,2S2,0,230,-230,0
202505,5001000,2S3,0,84,-84,0
202505,5001000,3,0,54,-54,0
202505,5001000,3S2,0,145,-145,0
202505,5001000,3S3,0,426,-426,0
202505,5001000,4,0,1,-1,0
202505,5001000,CA,0,392,-392,0
202505,5001000,V3,0,3,-3,0
202505,5001001,2,0,5,-5,0
202505,5001002,2,0,1,-1,0
202505,5001002,3,0,1,-1,0
202505,5001003,2,0,1,-1,0
202505,5001004,2,0,1,-1,0
202505,5001004,CA,0,1,-1,0
202505,5001010,2,0,1,-1,0
202505,5002000,2,0,2,-2,0
202505,5002010,2,0,1,-1,0
202505,5021000,2,0,2,-2,0
202505,5030000,2,0,25,-25,0
202505,5030000,3,0,1,-1,0
202505,5030000,3S2,0,1,-1,0
202505,5030000,3S3,0,22,-22,0
202505,5030000,CA,0,4,-4,0
202505,5030000,V3,0,1,-1,0
202505,5031000,2,0,1,-1,0
202505,5031000,3,0,1,-1,0
202505,5031000,3S2,0,1,-1,0
202505,5031000,CA,0,3,-3,0
202505,5034000,2,0,10,-10,0
202505,5034000,3,0,1,-1,0
202505,5034000,3S3,0,8,-8,0
202505,5034000,4,0,1,-1,0
202505,5034000,CA,0,4,-4,0
202505,5040000,2,0,2,-2,0
202505,5040000,3,0,1,-1,0
202505,5040000,3S2,0,2,-2,0
202505,5040000,CA,0,3,-3,0
202505,5042000,2,0,19,-19,0
202505,5042000,3,0,3,-3,0
202505,5042000,3S3,0,1,-1,0
202505,5042000,CA,0,4,-4,0
202505,5045000,2,0,92,-92,0
202505,5045000,2R2,0,1,-1,0
202505,5045000,2S2,0,5,-5,0
202505,5045000,2S3,0,4,-4,0
202505,5045000,3,0,13,-13,0
202505,5045000,3S2,0,4,-4,0
202505,5045000,3S3,0,51,-51,0
202505,5045000,CA,0,16,-16,0
202505,5051000,2,0,10,-10,0
202505,5051000,3S3,0,1,-1,0
202505,5059000,2,0,7,-7,0
202505,5059000,3,0,1,-1,0
202505,5079000,2,0,44,-44,0
202505,5079000,2S2,0,5,-5,0
202505,5079000,2S3,0,5,-5,0
202505,5079000,3,0,1,-1,0
202505,5079000,3S2,0,7,-7,0
202505,5079000,3S3,0,68,-68,0
202505,5079000,3S4,0,1,-1,0
202505,5079000,4,0,2,-2,0
202505,5079000,CA,0,14,-14,0
202505,5079001,3S3,0,1,-1,0
202505,5086000,3S3,0,1,-1,0
202505,5086000,CA,0,1,-1,0
202505,5088000,2,0,133,-133,0
202505,5088000,2S2,0,7,-7,0
202505,5088000,2S3,0,1,-1,0
202505,5088000,3,0,8,-8,0
202505,5088000,3S2,0,10,-10,0
202505,5088000,3S3,0,152,-152,0
202505,5088000,4,0,1,-1,0
202505,5088000,CA,0,31,-31,0
202505,5091000,3S3,0,5,-5,0
202505,5093000,2,0,1,-1,0
202505,5093000,3,0,1,-1,0
202505,5101000,2,0,9,-9,0
202505,5101000,3,0,1,-1,0
202505,5101000,3S3,0,3,-3,0
202505,5101000,CA,0,1,-1,0
202505,5113000,2,0,1,-1,0
202505,5113000,3,0,4,-4,0
202505,5113000,3S2,0,5,-5,0
202505,5113000,3S3,0,1,-1,0
202505,5113000,CA,0,1,-1,0
202505,5120000,CA,0,2,-2,0
202505,5125000,2,0,1,-1,0
202505,5129000,2,0,41,-41,0
202505,5129000,2S2,0,21,-21,0
202505,5129000,2S3,0,6,-6,0
202505,5129000,3,0,7,-7,0
202505,5129000,3S2,0,4,-4,0
202505,5129000,3S3,0,26,-26,0
202505,5129000,CA,0,8,-8,0
202505,5129000,V3,0,1,-1,0
202505,5134000,2,0,1,-1,0
202505,5134000,3,0,1,-1,0
202505,5134000,CA,0,2,-2,0
202505,5134000,V3,0,1,-1,0
202505,5138000,2,0,4,-4,0
202505,5138000,3,0,2,-2,0
202505,5138000,3S2,0,1,-1,0
202505,5138000,3S3,0,2,-2,0
202505,5138003,2,0,1,-1,0
202505,5142000,2,0,1,-1,0
202505,5142006,2,0,3,-3,0
202505,5147000,2,0,14,-14,0
202505,5147000,3S3,0,18,-18,0
202505,5147000,CA,0,1,-1,0
202505,5148000,2,0,37,-37,0
202505,5148000,2R2,0,1,-1,0
202505,5148000,2S2,0,1,-1,0
202505,5148000,3,0,4,-4,0
202505,5148000,3S3,0,7,-7,0
202505,5148000,CA,0,4,-4,0
202505,5150000,2,0,1,-1,0
202505,5150000,CA,0,1,-1,0
202505,5154000,2,0,71,-71,0
202505,5154000,2S3,0,1,-1,0
202505,5154000,3,0,7,-7,0
202505,5154000,3S2,0,1,-1,0
202505,5154000,3S3,0,47,-47,0
202505,5154000,CA,0,14,-14,0
202505,5172000,2,0,25,-25,0
202505,5172000,3,0,5,-5,0
202505,5172000,3S3,0,9,-9,0
202505,5172000,CA,0,1,-1,0
202505,5172003,3S3,0,1,-1,0
202505,5190000,2,0,1,-1,0
202505,5190000,CA,0,1,-1,0
202505,5197000,2,0,2,-2,0
202505,5206000,2,0,2,-2,0
202505,5209000,2,0,4,-4,0
202505,5209000,3,0,1,-1,0
202505,5209000,3S3,0,3,-3,0
202505,5212000,2,0,46,-46,0
202505,5212000,2S2,0,10,-10,0
202505,5212000,2S3,0,2,-2,0
202505,5212000,3,0,5,-5,0
202505,5212000,3S2,0,11,-11,0
202505,5212000,3S3,0,30,-30,0
202505,5212000,4,0,1,-1,0
202505,5212000,CA,0,20,-20,0
202505,5234000,2,0,7,-7,0
202505,5237000,2,0,7,-7,0
202505,5237000,3,0,7,-7,0
202505,5237000,3S3,0,3,-3,0
202505,5237000,CA,0,2,-2,0
202505,5240000,2,0,1,-1,0
202505,5240000,CA,0,1,-1,0
202505,5240003,2,0,2,-2,0
202505,5250000,2,0,14,-14,0
202505,5250000,3,0,2,-2,0
202505,5250000,3S2,0,1,-1,0
202505,5250000,3S3,0,5,-5,0
202505,5250000,CA,0,6,-6,0
202505,5250004,3S3,0,1,-1,0
202505,5264000,2,0,14,-14,0
202505,5264000,3S2,0,2,-2,0
202505,5264000,3S3,0,4,-4,0
202505,5264000,CA,0,5,-5,0
202505,5266000,2,0,109,-109,0
202505,5266000,2S2,0,19,-19,0
202505,5266000,2S3,0,6,-6,0
202505,5266000,3,0,12,-12,0
202505,5266000,3S2,0,4,-4,0
202505,5266000,3S3,0,67,-67,0
202505,5266000,CA,0,27,-27,0
202505,5266001,2,0,7,-7,0
202505,5282000,2S3,0,1,-1,0
202505,5282000,3S3,0,2,-2,0
202505,5282000,CA,0,2,-2,0
202505,5284000,2,0,3,-3,0
202505,5284000,CA,0,1,-1,0
202505,5284006,2,0,1,-1,0
202505,5306000,2,0,1,-1,0
202505,5306000,3S3,0,1,-1,0
202505,5308000,2,0,110,-110,0
202505,5308000,2S2,0,89,-89,0
202505,5308000,2S3,0,13,-13,0
202505,5308000,3,0,6,-6,0
202505,5308000,3S2,0,34,-34,0
202505,5308000,3S3,0,211,-211,0
202505,5308000,4,0,1,-1,0
202505,5308000,CA,0,28,-28,0
202505,5308000,V3,0,4,-4,0
202505,5308000,V4,0,4,-4,0
202505,5310000,2,0,1,-1,0
202505,5310000,CA,0,1,-1,0
202505,5310003,2,0,7,-7,0
202505,5310003,2S2,0,1,-1,0
202505,5310003,2S3,0,2,-2,0
202505,5310003,3S3,0,3,-3,0
202505,5310003,CA,0,2,-2,0
202505,5313000,2,0,4,-4,0
202505,5313000,CA,0,4,-4,0
202505,5315001,CA,0,2,-2,0
202505,5318000,2,0,113,-113,0
202505,5318000,2S2,0,6,-6,0
202505,5318000,2S3,0,3,-3,0
202505,5318000,3,0,4,-4,0
202505,5318000,3S2,0,16,-16,0
202505,5318000,3S3,0,59,-59,0
202505,5318000,CA,0,24,-24,0
202505,5321000,2,0,5,-5,0
202505,5321000,CA,0,1,-1,0
202505,5347000,2,0,1,-1,0
202505,5347000,3,0,1,-1,0
202505,5347000,CA,0,1,-1,0
202505,5353000,2,0,1,-1,0
202505,5353000,3S3,0,1,-1,0
202505,5360000,2,0,417,-417,0
202505,5360000,2S2,0,53,-53,0
202505,5360000,2S3,0,21,-21,0
202505,5360000,3,0,14,-14,0
202505,5360000,3S2,0,92,-92,0
202505,5360000,3S3,0,271,-271,0
202505,5360000,CA,0,26,-26,0
202505,5360003,2,0,1,-1,0
202505,5360007,3S3,0,1,-1,0
202505,5361000,2,0,5,-5,0
202505,5361000,3S2,0,1,-1,0
202505,5361000,3S3,0,1,-1,0
202505,5361000,3S4,0,2,-2,0
202505,5361000,CA,0,4,-4,0
202505,5364000,2,0,4,-4,0
202505,5364000,CA,0,3,-3,0
202505,5368000,2,0,1,-1,0
202505,5368000,CA,0,1,-1,0
202505,5376000,2,0,41,-41,0
202505,5376000,2S2,0,2,-2,0
202505,5376000,3,0,3,-3,0
202505,5376000,3S3,0,14,-14,0
202505,5376000,CA,0,5,-5,0
202505,5380000,2,0,105,-105,0
202505,5380000,2S2,0,18,-18,0
202505,5380000,2S3,0,5,-5,0
202505,5380000,3,0,4,-4,0
202505,5380000,3S2,0,7,-7,0
202505,5380000,3S3,0,77,-77,0
202505,5380000,CA,0,16,-16,0
202505,5380001,2,0,6,-6,0
202505,5380001,2S3,0,1,-1,0
202505,5380005,2,0,3,-3,0
202505,5390000,2,0,5,-5,0
202505,5390000,3,0,2,-2,0
202505,5390000,3S3,0,1,-1,0
202505,5400000,2,0,11,-11,0
202505,5400000,2S3,0,1,-1,0
202505,5400000,3,0,1,-1,0
202505,5400000,3S2,0,1,-1,0
202505,5400000,3S3,0,6,-6,0
202505,5400000,CA,0,2,-2,0
202505,5411008,2,0,1,-1,0
202505,5425000,2,0,2,-2,0
202505,5425000,3,0,1,-1,0
202505,5425000,4,0,2,-2,0
202505,5440000,2,0,54,-54,0
202505,5440000,3,0,5,-5,0
202505,5440000,3S3,0,13,-13,0
202505,5440000,3S4,0,1,-1,0
202505,5440000,CA,0,8,-8,0
202505,5440000,V3,0,1,-1,0
202505,5475000,2,0,1,-1,0
202505,5480000,2,0,6,-6,0
202505,5480000,3S3,0,1,-1,0
202505,5480000,CA,0,1,-1,0
202505,5480006,3,0,6,-6,0
202505,5483000,3,0,1,-1,0
202505,5483012,3,0,1,-1,0
202505,5490000,2,0,14,-14,0
202505,5490000,3,0,1,-1,0
202505,5490000,3S3,0,19,-19,0
202505,5490000,CA,0,3,-3,0
202505,5495000,2,0,5,-5,0
202505,5495000,3,0,1,-1,0
202505,5495000,3S2,0,2,-2,0
202505,5495000,3S3,0,1,-1,0
202505,5495000,CA,0,1,-1,0
202505,5541000,2,0,2,-2,0
202505,5541000,CA,0,1,-1,0
202505,5541001,2,0,2,-2,0
202505,5543000,2,0,1,-1,0
202505,5579000,2,0,7,-7,0
202505,5579000,3,0,1,-1,0
202505,5579000,3S2,0,1,-1,0
202505,5579000,3S3,0,3,-3,0
202505,5579000,CA,0,7,-7,0
202505,5585000,2,0,4,-4,0
202505,5585000,3S3,0,2,-2,0
202505,5585000,CA,0,1,-1,0
202505,5585003,3S3,0,4,-4,0
202505,5585003,CA,0,2,-2,0
202505,5585003,V3,0,1,-1,0
202505,5591000,2,0,8,-8,0
202505,5591000,3,0,3,-3,0
202505,5591000,3S3,0,3,-3,0
202505,5591000,CA,0,3,-3,0
202505,5591000,V3,0,1,-1,0
202505,5591004,2,0,5,-5,0
202505,5591004,3S3,0,2,-2,0
202505,5591004,CA,0,5,-5,0
202505,5604000,2,0,5,-5,0
202505,5604000,3,0,2,-2,0
202505,5604000,V3,0,1,-1,0
202505,5604005,3,0,1,-1,0
202505,5607000,2,0,18,-18,0
202505,5607000,2R2,0,1,-1,0
202505,5607000,3S3,0,3,-3,0
202505,5607000,CA,0,3,-3,0
202505,5615000,2,0,212,-212,0
202505,5615000,2S2,0,43,-43,0
202505,5615000,2S3,0,12,-12,0
202505,5615000,3,0,10,-10,0
202505,5615000,3S1,0,1,-1,0
202505,5615000,3S2,0,21,-21,0
202505,5615000,3S3,0,103,-103,0
202505,5615000,4,0,1,-1,0
202505,5615000,CA,0,47,-47,0
202505,5615000,V3,0,1,-1,0
202505,5615003,3S3,0,1,-1,0
202505,5615010,3S3,0,2,-2,0
202505,5628000,2,0,1,-1,0
202505,5631000,2,0,71,-71,0
202505,5631000,2S2,0,10,-10,0
202505,5631000,2S3,0,6,-6,0
202505,5631000,3,0,2,-2,0
202505,5631000,3S2,0,19,-19,0
202505,5631000,3S3,0,41,-41,0
202505,5631000,CA,0,12,-12,0
202505,5631000,V2,0,3,-3,0
202505,5631000,V3,0,2,-2,0
202505,5631000,V4,0,1,-1,0
202505,5642000,3,0,1,-1,0
202505,5642000,CA,0,3,-3,0
202505,5647000,2,0,1,-1,0
202505,5647000,3,0,2,-2,0
202505,5647000,3S2,0,1,-1,0
202505,5647000,V3,0,1,-1,0
202505,5649000,2,0,11,-11,0
202505,5649000,3,0,2,-2,0
202505,5649000,CA,0,2,-2,0
202505,5649001,CA,0,2,-2,0
202505,5652010,2S3,0,4,-4,0
202505,5656000,2,0,3,-3,0
202505,5656000,3S3,0,1,-1,0
202505,5659000,2,0,1,-1,0
202505,5659000,3,0,1,-1,0
202505,5659000,3S3,0,1,-1,0
202505,5659000,CA,0,2,-2,0
202505,5660000,2,0,1,-1,0
202505,5660000,CA,0,2,-2,0
202505,5660000,V3,0,1,-1,0
202505,5660013,CA,0,1,-1,0
202505,5664000,2,0,10,-10,0
202505,5664000,3,0,1,-1,0
202505,5664000,3S2,0,2,-2,0
202505,5664000,3S3,0,24,-24,0
202505,5664000,CA,0,3,-3,0
202505,5664005,3S3,0,1,-1,0
202505,5665000,2,0,5,-5,0
202505,5667000,2,0,3,-3,0
202505,5670003,CA,0,1,-1,0
202505,5674000,2,0,2,-2,0
202505,5679000,2,0,1,-1,0
202505,5679000,CA,0,1,-1,0
202505,5686000,2,0,21,-21,0
202505,5686000,3,0,4,-4,0
202505,5686000,3S2,0,1,-1,0
202505,5686000,3S3,0,29,-29,0
202505,5686000,CA,0,3,-3,0
202505,5686006,2,0,1,-1,0
202505,5686006,V2,0,1,-1,0
202505,5686011,2,0,1,-1,0
202505,5686011,2R2,0,3,-3,0
202505,5686011,3S3,0,1,-1,0
202505,5690000,2,0,1,-1,0
202505,5690000,CA,0,1,-1,0
202505,5690004,2,0,1,-1,0
202505,5690004,CA,0,1,-1,0
202505,5690010,2,0,1,-1,0
202505,5697000,2,0,23,-23,0
202505,5697000,2S2,0,1,-1,0
202505,5697000,2S3,0,2,-2,0
202505,5697000,3,0,2,-2,0
202505,5697000,3S3,0,15,-15,0
202505,5697000,CA,0,5,-5,0
202505,5736000,2,0,14,-14,0
202505,5736000,3,0,7,-7,0
202505,5736000,3S3,0,3,-3,0
202505,5736000,CA,0,2,-2,0
202505,5736002,3S2,0,1,-1,0
202505,5756000,2,0,5,-5,0
202505,5756000,3,0,2,-2,0
202505,5756000,3S3,0,4,-4,0
202505,5756000,CA,0,3,-3,0
202505,5756000,V2,0,1,-1,0
202505,5756000,V3,0,1,-1,0
202505,5756005,CA,0,1,-1,0
202505,5756033,3S3,0,70,-70,0
202505,5761000,2,0,2,-2,0
202505,5761000,3S3,0,2,-2,0
202505,5761000,CA,0,2,-2,0
202505,5761002,2S3,0,1,-1,0
202505,5789000,2,0,2,-2,0
202505,5789000,2S2,0,1,-1,0
202505,5790000,2,0,3,-3,0
202505,5790003,3S2,0,1,-1,0
202505,5809000,2,0,1,-1,0
202505,5819000,2,0,2,-2,0
202505,5819000,3S2,0,1,-1,0
202505,5819002,3S2,0,1,-1,0
202505,5837000,2,0,41,-41,0
202505,5837000,2S2,0,3,-3,0
202505,5837000,3,0,2,-2,0
202505,5837000,3S3,0,10,-10,0
202505,5837000,CA,0,16,-16,0
202505,5837001,2,0,1,-1,0
202505,5837002,3S2,0,7,-7,0
202505,5837002,3S3,0,7,-7,0
202505,5842000,CA,0,1,-1,0
202505,5847000,2,0,8,-8,0
202505,5847000,3,0,1,-1,0
202505,5847000,3S3,0,2,-2,0
202505,5847000,CA,0,3,-3,0
202505,5854000,2,0,1,-1,0
202505,5854000,3S3,0,2,-2,0
202505,5854000,CA,0,1,-1,0
202505,5854002,2,0,5,-5,0
202505,5854002,CA,0,1,-1,0
202505,5856000,2,0,1,-1,0
202505,5856000,CA,0,1,-1,0
202505,5858000,2,0,1,-1,0
202505,5858000,3,0,2,-2,0
202505,5858000,3S2,0,1,-1,0
202505,5858000,CA,0,2,-2,0
202505,5861000,2,0,1,-1,0
202505,5861002,2,0,2,-2,0
202505,5861002,3,0,3,-3,0
202505,5861002,3S3,0,2,-2,0
202505,5873000,2,0,1,-1,0
202505,5887000,2,0,16,-16,0
202505,5887000,3,0,1,-1,0
202505,5887000,3S3,0,15,-15,0
202505,5887000,CA,0,2,-2,0
202505,5887007,2,0,2,-2,0
202505,5887007,2R2,0,1,-1,0
202505,5887007,3S3,0,2,-2,0
202505,5890000,2,0,3,-3,0
202505,5890000,2S2,0,1,-1,0
202505,5890000,3,0,1,-1,0
202505,5890000,3S3,0,1,-1,0
202505,5890000,CA,0,2,-2,0
202505,5893000,2,0,3,-3,0
202505,5893000,3S3,0,13,-13,0
202505,5893000,3S4,0,16,-16,0
202505,5893000,CA,0,3,-3,0
202505,5893001,3S3,0,1,-1,0
202505,5895000,2,0,15,-15,0
202505,5895000,3S2,0,1,-1,0
202505,5895000,3S3,0,5,-5,0
202505,8001000,2,0,1200,-1200,0
202505,8001000,2B1,0,2,-2,0
202505,8001000,2R2,0,3,-3,0
202505,8001000,2S2,0,237,-237,0
202505,8001000,2S3,0,75,-75,0
202505,8001000,3,0,41,-41,0
202505,8001000,3S2,0,173,-173,0
202505,8001000,3S3,0,1566,-1566,0
202505,8001000,3S4,0,2,-2,0
202505,8001000,CA,0,139,-139,0
202505,8001000,V3,0,3,-3,0
202505,8001001,2,0,3,-3,0
202505,8001001,2S3,0,1,-1,0
202505,8001001,3S3,0,1,-1,0
202505,8001004,3S3,0,3,-3,0
202505,8078000,2,0,27,-27,0
202505,8078000,2S2,0,1,-1,0
202505,8078000,2S3,0,1,-1,0
202505,8078000,3,0,1,-1,0
202505,8078000,3S2,0,3,-3,0
202505,8078000,3S3,0,15,-15,0
202505,8078000,CA,0,6,-6,0
202505,8078000,V2,0,1,-1,0
202505,8078000,V3,0,1,-1,0
202505,8078000,V4,0,1,-1,0
202505,8078003,2,0,1,-1,0
202505,8137000,2,0,1,-1,0
202505,8137000,CA,0,1,-1,0
202505,8141000,2,0,1,-1,0
202505,8141000,CA,0,2,-2,0
202505,8296000,2,0,118,-118,0
202505,8296000,2S2,0,30,-30,0
202505,8296000,2S3,0,9,-9,0
202505,8296000,3,0,3,-3,0
202505,8296000,3S2,0,21,-21,0
202505,8296000,3S3,0,72,-72,0
202505,8296000,CA,0,13,-13,0
202505,8372000,2,0,4,-4,0
202505,8372000,CA,0,3,-3,0
202505,8372004,2,0,1,-1,0
202505,8421000,2,0,3,-3,0
202505,8421000,2S2,0,2,-2,0
202505,8421000,3S2,0,2,-2,0
202505,8421000,3S3,0,4,-4,0
202505,8421001,3S3,0,1,-1,0
202505,8421001,3S4,0,1,-1,0
202505,8421001,CA,0,1,-1,0
202505,8433000,2,0,90,-90,0
202505,8433000,2S2,0,18,-18,0
202505,8433000,2S3,0,9,-9,0
202505,8433000,3,0,2,-2,0
202505,8433000,3S2,0,7,-7,0
202505,8433000,3S3,0,120,-120,0
202505,8433000,3S4,0,3,-3,0
202505,8433000,CA,0,11,-11,0
202505,8433001,2,0,1,-1,0
202505,8436000,2,0,1,-1,0
202505,8436000,CA,0,2,-2,0
202505,8520000,2,0,7,-7,0
202505,8520000,2S2,0,2,-2,0
202505,8520000,3S3,0,19,-19,0
202505,8520000,CA,0,2,-2,0
202505,8549000,2,0,2,-2,0
202505,8549000,CA,0,1,-1,0
202505,8549003,2,0,1,-1,0
202505,8558000,2,0,8,-8,0
202505,8558000,3S3,0,1,-1,0
202505,8558000,CA,0,1,-1,0
202505,8558001,2,0,4,-4,0
202505,8560000,2,0,6,-6,0
202505,8560000,2S2,0,3,-3,0
202505,8560000,2S3,0,8,-8,0
202505,8560000,3,0,1,-1,0
202505,8560000,3S2,0,3,-3,0
202505,8560000,3S3,0,14,-14,0
202505,8560000,CA,0,4,-4,0
202505,8560003,2,0,2,-2,0
202505,8560003,3S3,0,1,-1,0
202505,8573000,2,0,37,-37,0
202505,8573000,3,0,8,-8,0
202505,8573000,3S3,0,7,-7,0
202505,8573000,CA,0,12,-12,0
202505,8606000,2,0,1,-1,0
202505,8606000,3S2,0,1,-1,0
202505,8606004,CA,0,2,-2,0
202505,8634000,2,0,14,-14,0
202505,8634000,2S2,0,2,-2,0
202505,8634000,3S2,0,3,-3,0
202505,8634000,3S3,0,40,-40,0
202505,8634000,CA,0,5,-5,0
202505,8634000,V2,0,1,-1,0
202505,8638000,2,0,29,-29,0
202505,8638000,3,0,1,-1,0
202505,8638000,3S3,0,5,-5,0
202505,8638000,CA,0,10,-10,0
202505,8638004,2,0,1,-1,0
202505,8638004,3,0,1,-1,0
202505,8685000,2,0,9,-9,0
202505,8685000,3S2,0,2,-2,0
202505,8685000,3S3,0,1,-1,0
202505,8685000,CA,0,5,-5,0
202505,8758000,2,0,153,-153,0
202505,8758000,2R2,0,1,-1,0
202505,8758000,2S2,0,11,-11,0
202505,8758000,2S3,0,2,-2,0
202505,8758000,3,0,2,-2,0
202505,8758000,3S2,0,18,-18,0
202505,8758000,3S3,0,49,-49,0
202505,8758000,CA,0,25,-25,0
202505,8758000,V2,0,5,-5,0
202505,8758000,V3,0,11,-11,0
202505,8770000,2,0,2,-2,0
202505,8832000,2,0,7,-7,0
202505,8832000,3S3,0,1,-1,0
202505,11001000,2,0,3167,-3167,0
202505,11001000,2R2,0,5,-5,0
202505,11001000,2S2,0,784,-784,0
202505,11001000,2S3,0,217,-217,0
202505,11001000,3,0,85,-85,0
202505,11001000,3S2,0,345,-345,0
202505,11001000,3S3,0,1395,-1395,0
202505,11001000,3S4,0,3,-3,0
202505,11001000,4,0,6,-6,0
202505,11001000,CA,0,1501,-1501,0
202505,11001000,V2,0,1,-1,0
202505,11001000,V3,0,2,-2,0
202505,11001001,2,0,6,-6,0
202505,11001001,2S2,0,2,-2,0
202505,11001001,3S3,0,17,-17,0
202505,11001002,2,0,1,-1,0
202505,13001000,2,0,763,-763,0
202505,13001000,2R2,0,3,-3,0
202505,13001000,2S2,0,461,-461,0
202505,13001000,2S3,0,162,-162,0
202505,13001000,3,0,21,-21,0
202505,13001000,3S1,0,1,-1,0
202505,13001000,3S2,0,244,-244,0
202505,13001000,3S3,0,1315,-1315,0
202505,13001000,3S4,0,1,-1,0
202505,13001000,CA,0,150,-150,0
202505,13001001,3S3,0,1,-1,0
202505,13001003,CA,0,2,-2,0
202505,13001004,2,0,3,-3,0
202505,13001004,3S2,0,1,-1,0
202505,13001004,3S3,0,2,-2,0
202505,13001009,3S3,0,3,-3,0
202505,13001009,CA,0,1,-1,0
202505,13001015,2,0,2,-2,0
202505,13001019,2,0,1,-1,0
202505,13001020,2,0,1,-1,0
202505,13001020,CA,0,2,-2,0
202505,13001029,2,0,2,-2,0
202505,13001029,3S2,0,1,-1,0
202505,13006000,2,0,2,-2,0
202505,13006000,2S3,0,1,-1,0
202505,13006000,3S3,0,1,-1,0
202505,13042000,2,0,1,-1,0
202505,13052000,2,0,21,-21,0
202505,13052000,2S3,0,2,-2,0
202505,13052000,3,0,2,-2,0
202505,13052000,3S3,0,14,-14,0
202505,13052000,3S4,0,1,-1,0
202505,13052000,CA,0,8,-8,0
202505,13052002,2,0,3,-3,0
202505,13052002,3S2,0,1,-1,0
202505,13052004,3S3,0,1,-1,0
202505,13062000,2,0,2,-2,0
202505,13062000,CA,0,5,-5,0
202505,13074000,2,0,1,-1,0
202505,13074000,3,0,1,-1,0
202505,13140000,2,0,2,-2,0
202505,13140000,3S3,0,1,-1,0
202505,13140000,CA,0,3,-3,0
202505,13140000,V2,0,1,-1,0
202505,13160000,2,0,6,-6,0
202505,13160000,3S3,0,2,-2,0
202505,13160000,CA,0,1,-1,0
202505,13212000,2,0,2,-2,0
202505,13222000,2,0,1,-1,0
202505,13222000,2S2,0,1,-1,0
202505,13222000,3S3,0,1,-1,0
202505,13244000,2,0,11,-11,0
202505,13244000,3,0,3,-3,0
202505,13268019,2,0,4,-4,0
202505,13430000,2,0,75,-75,0
202505,13430000,2R2,0,1,-1,0
202505,13430000,3,0,5,-5,0
202505,13430000,3S3,0,15,-15,0
202505,13430000,CA,0,9,-9,0
202505,13430017,2,0,1,-1,0
202505,13430023,2,0,1,-1,0
202505,13433000,2,0,1,-1,0
202505,13442000,2,0,8,-8,0
202505,13442000,3S3,0,1,-1,0
202505,13442000,CA,0,2,-2,0
202505,13468000,2,0,12,-12,0
202505,13468000,2S3,0,1,-1,0
202505,13468000,3,0,1,-1,0
202505,13468000,3S3,0,5,-5,0
202505,13468000,CA,0,2,-2,0
202505,13468028,2,0,2,-2,0
202505,13468040,2,0,1,-1,0
202505,13473000,2,0,1,-1,0
202505,13490000,2,0,1,-1,0
202505,13580000,2,0,1,-1,0
202505,13580000,3,0,1,-1,0
202505,13580000,3S3,0,2,-2,0
202505,13600000,2,0,2,-2,0
202505,13600000,3S3,0,1,-1,0
202505,13600001,2,0,1,-1,0
202505,13647000,3S3,0,1,-1,0
202505,13647000,CA,0,1,-1,0
202505,13654000,2,0,2,-2,0
202505,13657000,2,0,2,-2,0
202505,13657000,3S2,0,2,-2,0
202505,13657000,3S3,0,2,-2,0
202505,13667000,2,0,4,-4,0
202505,13670000,2,0,4,-4,0
202505,13670000,3,0,2,-2,0
202505,13670000,3S2,0,1,-1,0
202505,13670000,3S3,0,1,-1,0
202505,13673005,3S2,0,1,-1,0
202505,13683000,2,0,6,-6,0
202505,13683000,3S3,0,1,-1,0
202505,13688000,2,0,24,-24,0
202505,13688000,3,0,2,-2,0
202505,13688000,3S3,0,8,-8,0
202505,13688000,CA,0,2,-2,0
202505,13688007,3,0,1,-1,0
202505,13744000,2,0,5,-5,0
202505,13744000,3S3,0,4,-4,0
202505,13760000,CA,0,1,-1,0
202505,13780000,2,0,1,-1,0
202505,13810000,2,0,1,-1,0
202505,13836000,2,0,60,-60,0
202505,13836000,2S2,0,1,-1,0
202505,13836000,2S3,0,5,-5,0
202505,13836000,3S2,0,5,-5,0
202505,13836000,3S3,0,14,-14,0
202505,13836000,3S4,0,1,-1,0
202505,13836000,CA,0,7,-7,0
202505,13838000,2,0,6,-6,0
202505,13838000,2S2,0,1,-1,0
202505,13838000,2S3,0,1,-1,0
202505,13838000,3S2,0,1,-1,0
202505,13838000,3S3,0,1,-1,0
202505,13873000,2,0,2,-2,0
202505,13873001,2,0,1,-1,0
202505,13894000,2,0,1,-1,0
202505,13894000,CA,0,1,-1,0
202505,15001000,2,0,146,-146,0
202505,15001000,2R2,0,2,-2,0
202505,15001000,2S2,0,12,-12,0
202505,15001000,2S3,0,5,-5,0
202505,15001000,3,0,3,-3,0
202505,15001000,3S2,0,14,-14,0
202505,15001000,3S3,0,64,-64,0
202505,15001000,CA,0,41,-41,0
202505,15001007,2S2,0,3,-3,0
202505,15022000,CA,0,1,-1,0
202505,15047000,2,0,17,-17,0
202505,15047010,2,0,2,-2,0
202505,15051000,CA,0,1,-1,0
202505,15087000,2,0,5,-5,0
202505,15087000,3S3,0,1,-1,0
202505,15087000,CA,0,1,-1,0
202505,15097000,2,0,2,-2,0
202505,15104000,2,0,5,-5,0
202505,15104000,3S3,0,1,-1,0
202505,15109000,CA,0,2,-2,0
202505,15131000,2,0,1,-1,0
202505,15172000,2,0,1,-1,0
202505,15172000,CA,0,1,-1,0
202505,15176000,2,0,35,-35,0
202505,15176000,3,0,2,-2,0
202505,15176000,3S3,0,12,-12,0
202505,15176000,CA,0,18,-18,0
202505,15183000,2,0,1,-1,0
202505,15185000,2,0,2,-2,0
202505,15187000,2,0,1,-1,0
202505,15204000,2,0,1,-1,0
202505,15204000,CA,0,1,-1,0
202505,15218000,2,0,1,-1,0
202505,15223000,2,0,1,-1,0
202505,15224000,CA,0,2,-2,0
202505,15236000,CA,0,1,-1,0
202505,15238000,2,0,107,-107,0
202505,15238000,2R2,0,1,-1,0
202505,15238000,2S2,0,8,-8,0
202505,15238000,2S3,0,2,-2,0
202505,15238000,3,0,6,-6,0
202505,15238000,3S2,0,8,-8,0
202505,15238000,3S3,0,32,-32,0
202505,15238000,CA,0,30,-30,0
202505,15276000,CA,0,1,-1,0
202505,15296000,2,0,1,-1,0
202505,15299000,2,0,3,-3,0
202505,15299000,CA,0,3,-3,0
202505,15322000,2,0,9,-9,0
202505,15322000,3,0,1,-1,0
202505,15322000,CA,0,6,-6,0
202505,15322008,2,0,1,-1,0
202505,15322008,CA,0,1,-1,0
202505,15325000,2,0,1,-1,0
202505,15325000,CA,0,1,-1,0
202505,15362000,CA,0,1,-1,0
202505,15367000,2,0,2,-2,0
202505,15380000,CA,0,13,-13,0
202505,15403000,2,0,2,-2,0
202505,15407000,2,0,27,-27,0
202505,15407000,3S3,0,1,-1,0
202505,15407000,CA,0,2,-2,0
202505,15425000,CA,0,1,-1,0
202505,15455000,2,0,1,-1,0
202505,15455000,CA,0,2,-2,0
202505,15469000,2,0,16,-16,0
202505,15469000,2S3,0,1,-1,0
202505,15469000,CA,0,5,-5,0
202505,15476000,2,0,1,-1,0
202505,15480000,2,0,2,-2,0
202505,15480000,CA,0,2,-2,0
202505,15491000,2,0,10,-10,0
202505,15491000,3S2,0,3,-3,0
202505,15491000,3S3,0,74,-74,0
202505,15491001,2,0,2,-2,0
202505,15491001,3S3,0,33,-33,0
202505,15491001,V4,0,1,-1,0
202505,15494000,2,0,2,-2,0
202505,15500000,3S3,0,7,-7,0
202505,15507000,2,0,1,-1,0
202505,15507000,CA,0,2,-2,0
202505,15511000,CA,0,1,-1,0
202505,15514000,3S2,0,1,-1,0
202505,15516000,2,0,13,-13,0
202505,15516000,3,0,1,-1,0
202505,15516000,CA,0,5,-5,0
202505,15516000,V2,0,1,-1,0
202505,15522000,2,0,1,-1,0
202505,15531000,2,0,1,-1,0
202505,15531000,CA,0,3,-3,0
202505,15537000,2,0,3,-3,0
202505,15537000,V3,0,1,-1,0
202505,15542000,2,0,1,-1,0
202505,15542000,3S2,0,1,-1,0
202505,15542000,3S3,0,2,-2,0
202505,15572000,2,0,25,-25,0
202505,15572000,2R2,0,1,-1,0
202505,15572000,3S2,0,19,-19,0
202505,15572000,3S3,0,20,-20,0
202505,15572000,3S3S2,0,1,-1,0
202505,15572000,CA,0,5,-5,0
202505,15572007,3S3,0,2,-2,0
202505,15572014,3S2,0,2,-2,0
202505,15572014,3S3,0,5,-5,0
202505,15580000,CA,0,1,-1,0
202505,15600000,2,0,3,-3,0
202505,15600000,CA,0,1,-1,0
202505,15632000,CA,0,1,-1,0
202505,15638000,2,0,1,-1,0
202505,15646000,2,0,11,-11,0
202505,15646000,3S2,0,1,-1,0
202505,15646000,3S3,0,14,-14,0
202505,15646000,4,0,1,-1,0
202505,15646000,V2,0,2,-2,0
202505,15646000,V3,0,6,-6,0
202505,15646000,V3R2,0,1,-1,0
202505,15646000,V4,0,3,-3,0
202505,15664000,2,0,3,-3,0
202505,15667000,2,0,1,-1,0
202505,15667000,CA,0,1,-1,0
202505,15676000,2,0,2,-2,0
202505,15681000,CA,0,2,-2,0
202505,15686000,2,0,4,-4,0
202505,15690000,2,0,1,-1,0
202505,15690000,CA,0,2,-2,0
202505,15693000,2,0,2,-2,0
202505,15696000,CA,0,1,-1,0
202505,15740000,2,0,3,-3,0
202505,15753000,2,0,1,-1,0
202505,15753000,3,0,1,-1,0
202505,15753000,CA,0,1,-1,0
202505,15759000,2,0,174,-174,0
202505,15759000,2R2,0,1,-1,0
202505,15759000,2S2,0,5,-5,0
202505,15759000,3,0,6,-6,0
202505,15759000,3S3,0,48,-48,0
202505,15759000,CA,0,37,-37,0
202505,15759000,V3,0,2,-2,0
202505,15759001,2,0,1,-1,0
202505,15761000,CA,0,1,-1,0
202505,15763000,2,0,1,-1,0
202505,15764000,2,0,3,-3,0
202505,15764000,3S2,0,1,-1,0
202505,15764000,3S3,0,1,-1,0
202505,15764000,CA,0,2,-2,0
202505,15776000,2,0,1,-1,0
202505,15776000,3S3,0,1,-1,0
202505,15778000,CA,0,2,-2,0
202505,15804000,2,0,3,-3,0
202505,15804000,3S2,0,1,-1,0
202505,15804000,3S3,0,1,-1,0
202505,15806000,2,0,7,-7,0
202505,15806000,2S2,0,4,-4,0
202505,15806000,2S3,0,2,-2,0
202505,15806000,3S3,0,73,-73,0
202505,15806000,CA,0,3,-3,0
202505,15808000,CA,0,11,-11,0
202505,15814000,2,0,7,-7,0
202505,15816000,2,0,1,-1,0
202505,15835000,2,0,2,-2,0
202505,15837000,2,0,13,-13,0
202505,15837000,3,0,1,-1,0
202505,15837000,3S3,0,69,-69,0
202505,15837000,CA,0,1,-1,0
202505,15842000,CA,0,2,-2,0
202505,15861000,2,0,3,-3,0
202505,15861008,2,0,1,-1,0
202505,15897000,2,0,1,-1,0
202505,17001000,2,0,328,-328,0
202505,17001000,2S2,0,47,-47,0
202505,17001000,2S3,0,8,-8,0
202505,17001000,3,0,7,-7,0
202505,17001000,3S2,0,23,-23,0
202505,17001000,3S3,0,122,-122,0
202505,17001000,CA,0,68,-68,0
202505,17001004,2,0,1,-1,0
202505,17001027,3S3,0,14,-14,0
202505,17013000,2,0,11,-11,0
202505,17013000,CA,0,2,-2,0
202505,17042000,2,0,12,-12,0
202505,17042000,3S3,0,3,-3,0
202505,17042000,CA,0,2,-2,0
202505,17050000,2,0,4,-4,0
202505,17050000,CA,0,2,-2,0
202505,17088000,2,0,6,-6,0
202505,17174000,2,0,41,-41,0
202505,17174000,2S2,0,1,-1,0
202505,17174000,3,0,2,-2,0
202505,17174000,3S2,0,1,-1,0
202505,17174000,3S3,0,19,-19,0
202505,17174000,CA,0,4,-4,0
202505,17272000,2,0,3,-3,0
202505,17272000,3S3,0,2,-2,0
202505,17380000,2,0,37,-37,0
202505,17380000,2R2,0,2,-2,0
202505,17380000,3,0,3,-3,0
202505,17380000,3S3,0,6,-6,0
202505,17380000,CA,0,12,-12,0
202505,17380000,V3,0,1,-1,0
202505,17388000,2,0,1,-1,0
202505,17388002,3S3,0,1,-1,0
202505,17433000,2,0,8,-8,0
202505,17433000,CA,0,2,-2,0
202505,17442000,2,0,3,-3,0
202505,17442000,3,0,1,-1,0
202505,17442000,CA,0,2,-2,0
202505,17444000,2,0,7,-7,0
202505,17486000,2,0,3,-3,0
202505,17486000,3S3,0,3,-3,0
202505,17486000,CA,0,2,-2,0
202505,17495000,2,0,4,-4,0
202505,17495000,3,0,1,-1,0
202505,17513000,2,0,1,-1,0
202505,17513000,3,0,1,-1,0
202505,17524000,2,0,7,-7,0
202505,17524000,3S3,0,1,-1,0
202505,17524000,CA,0,1,-1,0
202505,17524001,2,0,3,-3,0
202505,17524001,3S3,0,21,-21,0
202505,17524001,CA,0,1,-1,0
202505,17524003,2,0,1,-1,0
202505,17541000,2,0,13,-13,0
202505,17541000,3,0,1,-1,0
202505,17614000,2,0,22,-22,0
202505,17614000,3,0,1,-1,0
202505,17614000,3S3,0,3,-3,0
202505,17614000,CA,0,5,-5,0
202505,17614004,2,0,7,-7,0
202505,17616000,2,0,4,-4,0
202505,17616000,3S3,0,2,-2,0
202505,17616000,CA,0,2,-2,0
202505,17653000,2,0,3,-3,0
202505,17662000,2,0,6,-6,0
202505,17662001,2,0,1,-1,0
202505,17662003,V3,0,1,-1,0
202505,17665000,3S3,0,1,-1,0
202505,17777000,2,0,21,-21,0
202505,17777000,3S3,0,1,-1,0
202505,17777000,CA,0,7,-7,0
202505,17867000,2,0,2,-2,0
202505,17867000,3,0,2,-2,0
202505,17873000,2,0,24,-24,0
202505,17873000,2S2,0,3,-3,0
202505,17873000,3S2,0,1,-1,0
202505,17873000,3S3,0,3,-3,0
202505,17873000,CA,0,2,-2,0
202505,17877000,2,0,8,-8,0
202505,17877000,3S3,0,5,-5,0
202505,18001000,2,0,121,-121,0
202505,18001000,2S2,0,6,-6,0
202505,18001000,2S3,0,1,-1,0
202505,18001000,3,0,3,-3,0
202505,18001000,3S3,0,33,-33,0
202505,18001000,CA,0,12,-12,0
202505,18001013,3S3,0,2,-2,0
202505,18029000,2,0,1,-1,0
202505,18094000,2,0,3,-3,0
202505,18094000,3S3,0,2,-2,0
202505,18150000,2,0,7,-7,0
202505,18150000,3,0,1,-1,0
202505,18150000,3S3,0,3,-3,0
202505,18205000,2,0,1,-1,0
202505,18205000,3,0,1,-1,0
202505,18205000,3S3,0,2,-2,0
202505,18205000,CA,0,1,-1,0
202505,18247000,2,0,2,-2,0
202505,18247000,3S3,0,1,-1,0
202505,18256000,2,0,1,-1,0
202505,18479000,3S3,0,1,-1,0
202505,18592000,2,0,7,-7,0
202505,18610000,3S3,0,1,-1,0
202505,18753000,2,0,35,-35,0
202505,18753000,2S2,0,1,-1,0
202505,18753000,3,0,2,-2,0
202505,18753000,3S2,0,1,-1,0
202505,18753000,3S3,0,9,-9,0
202505,18753003,2,0,1,-1,0
202505,18756000,2,0,1,-1,0
202505,19001000,2,0,186,-186,0
202505,19001000,2R2,0,2,-2,0
202505,19001000,2S2,0,7,-7,0
202505,19001000,3,0,5,-5,0
202505,19001000,3S2,0,10,-10,0
202505,19001000,3S3,0,46,-46,0
202505,19001000,CA,0,32,-32,0
202505,19022000,2,0,3,-3,0
202505,19050000,2,0,3,-3,0
202505,19050000,3,0,1,-1,0
202505,19050006,2,0,3,-3,0
202505,19050007,2,0,1,-1,0
202505,19075000,2,0,5,-5,0
202505,19100000,2,0,2,-2,0
202505,19100000,3,0,1,-1,0
202505,19100000,3S3,0,2,-2,0
202505,19110000,2,0,1,-1,0
202505,19110012,3S3,0,2,-2,0
202505,19130000,2,0,1,-1,0
202505,19130000,CA,0,1,-1,0
202505,19137000,CA,0,1,-1,0
202505,19142000,2,0,31,-31,0
202505,19142000,2S2,0,4,-4,0
202505,19142000,2S3,0,1,-1,0
202505,19142000,3,0,1,-1,0
202505,19142000,3S2,0,6,-6,0
202505,19142000,3S3,0,76,-76,0
202505,19142000,4,0,1,-1,0
202505,19142000,CA,0,7,-7,0
202505,19142006,2,0,4,-4,0
202505,19142006,3S2,0,1,-1,0
202505,19142006,3S3,0,20,-20,0
202505,19212000,2,0,3,-3,0
202505,19212000,3,0,1,-1,0
202505,19256000,2,0,2,-2,0
202505,19256000,3,0,1,-1,0
202505,19256000,3S3,0,1,-1,0
202505,19256000,CA,0,1,-1,0
202505,19256018,2,0,3,-3,0
202505,19290000,2,0,4,-4,0
202505,19300000,2,0,5,-5,0
202505,19300000,2S2,0,2,-2,0
202505,19300000,3S3,0,6,-6,0
202505,19355000,2,0,2,-2,0
202505,19355000,3,0,1,-1,0
202505,19355000,3S3,0,1,-1,0
202505,19355012,2,0,2,-2,0
202505,19355012,CA,0,1,-1,0
202505,19392000,3S2,0,1,-1,0
202505,19397000,2,0,4,-4,0
202505,19397000,3S2,0,1,-1,0
202505,19418020,3S3,0,18,-18,0
202505,19450000,2,0,10,-10,0
202505,19450000,3S3,0,1,-1,0
202505,19455000,2,0,3,-3,0
202505,19455000,3S3,0,1,-1,0
202505,19455005,2,0,1,-1,0
202505,19455005,3S3,0,1,-1,0
202505,19473000,3S3,0,1,-1,0
202505,19473000,CA,0,1,-1,0
202505,19513000,2,0,1,-1,0
202505,19517000,2,0,5,-5,0
202505,19517000,CA,0,1,-1,0
202505,19532000,2,0,15,-15,0
202505,19532000,3S3,0,1,-1,0
202505,19532000,CA,0,3,-3,0
202505,19532004,3S2,0,1,-1,0
202505,19532008,2,0,4,-4,0
202505,19532021,CA,0,2,-2,0
202505,19533000,2S2,0,1,-1,0
202505,19548000,2,0,11,-11,0
202505,19548000,CA,0,2,-2,0
202505,19573000,2,0,28,-28,0
202505,19573000,2S2,0,1,-1,0
202505,19573000,3,0,1,-1,0
202505,19573000,3S2,0,3,-3,0
202505,19573000,3S3,0,37,-37,0
202505,19573000,CA,0,8,-8,0
202505,19622000,2,0,1,-1,0
202505,19622000,CA,0,1,-1,0
202505,19693000,2,0,1,-1,0
202505,19698000,2,0,56,-56,0
202505,19698000,2R2,0,1,-1,0
202505,19698000,2S2,0,6,-6,0
202505,19698000,2S3,0,3,-3,0
202505,19698000,3,0,4,-4,0
202505,19698000,3S2,0,3,-3,0
202505,19698000,3S3,0,16,-16,0
202505,19698000,CA,0,18,-18,0
202505,19698007,2,0,2,-2,0
202505,19701000,3S3,0,2,-2,0
202505,19743000,2,0,1,-1,0
202505,19743000,CA,0,1,-1,0
202505,19780000,2,0,5,-5,0
202505,19780000,3S3,0,2,-2,0
202505,19780000,CA,0,3,-3,0
202505,19807000,2,0,12,-12,0
202505,19807000,CA,0,4,-4,0
202505,19807009,2,0,1,-1,0
202505,19824000,2,0,4,-4,0
202505,19824000,CA,0,1,-1,0
202505,19824002,2,0,1,-1,0
202505,19845000,2,0,14,-14,0
202505,19845000,2S2,0,11,-11,0
202505,19845000,2S3,0,2,-2,0
202505,19845000,3S2,0,10,-10,0
202505,19845000,3S3,0,37,-37,0
202505,19845000,CA,0,2,-2,0
202505,20001000,2,0,379,-379,0
202505,20001000,2S2,0,21,-21,0
202505,20001000,2S3,0,8,-8,0
202505,20001000,3,0,11,-11,0
202505,20001000,3S2,0,34,-34,0
202505,20001000,3S3,0,119,-119,0
202505,20001000,CA,0,37,-37,0
202505,20001001,2,0,1,-1,0
202505,20001003,2,0,1,-1,0
202505,20001013,2,0,1,-1,0
202505,20001013,3S3,0,2,-2,0
202505,20001018,3S3,0,1,-1,0
202505,20001031,3S2,0,1,-1,0
202505,20001031,3S3,0,1,-1,0
202505,20011000,2,0,102,-102,0
202505,20011000,2S3,0,2,-2,0
202505,20011000,3,0,4,-4,0
202505,20011000,3S2,0,11,-11,0
202505,20011000,3S3,0,139,-139,0
202505,20011000,CA,0,5,-5,0
202505,20013000,2,0,14,-14,0
202505,20013000,2S3,0,1,-1,0
202505,20013000,3S2,0,1,-1,0
202505,20013000,3S3,0,10,-10,0
202505,20013000,CA,0,1,-1,0
202505,20032000,2,0,4,-4,0
202505,20032000,3S2,0,1,-1,0
202505,20045000,2,0,8,-8,0
202505,20045000,3S3,0,1,-1,0
202505,20045000,CA,0,1,-1,0
202505,20060000,2,0,31,-31,0
202505,20060000,3S2,0,10,-10,0
202505,20060000,3S3,0,9,-9,0
202505,20060000,CA,0,1,-1,0
202505,20175000,2,0,3,-3,0
202505,20175000,3S3,0,1,-1,0
202505,20175000,CA,0,1,-1,0
202505,20175011,CA,0,1,-1,0
202505,20175016,3S3,0,1,-1,0
202505,20178000,2,0,2,-2,0
202505,20178000,3S2,0,1,-1,0
202505,20178000,3S3,0,1,-1,0
202505,20178006,3S3,0,1,-1,0
202505,20228000,2,0,23,-23,0
202505,20228000,3S3,0,7,-7,0
202505,20228000,CA,0,5,-5,0
202505,20228006,2,0,1,-1,0
202505,20238000,2,0,3,-3,0
202505,20238000,2S3,0,1,-1,0
202505,20238000,3S3,0,4,-4,0
202505,20250000,2,0,5,-5,0
202505,20250000,3S3,0,3,-3,0
202505,20250002,2,0,7,-7,0
202505,20250002,3S3,0,2,-2,0
202505,20250002,CA,0,1,-1,0
202505,20250004,2,0,1,-1,0
202505,20295000,2,0,2,-2,0
202505,20295000,3S2,0,1,-1,0
202505,20295005,3S3,0,1,-1,0
202505,20383000,2,0,2,-2,0
202505,20383000,3S2,0,7,-7,0
202505,20383000,3S3,0,73,-73,0
202505,20383000,CA,0,1,-1,0
202505,20383001,3,0,1,-1,0
202505,20383001,3S2,0,2,-2,0
202505,20383001,3S3,0,62,-62,0
202505,20383010,3S3,0,2,-2,0
202505,20400000,2,0,14,-14,0
202505,20400000,3S2,0,4,-4,0
202505,20400000,3S3,0,2,-2,0
202505,20400002,2,0,1,-1,0
202505,20443000,2,0,5,-5,0
202505,20443000,3,0,1,-1,0
202505,20443000,CA,0,1,-1,0
202505,20517000,2,0,10,-10,0
202505,20517000,3S3,0,2,-2,0
202505,20517000,CA,0,1,-1,0
202505,20550000,2,0,9,-9,0
202505,20550000,3,0,1,-1,0
202505,20550000,3S3,0,5,-5,0
202505,20570000,2,0,4,-4,0
202505,20614000,2,0,1,-1,0
202505,20614000,3S4,0,1,-1,0
202505,20621000,2,0,9,-9,0
202505,20621000,3S3,0,7,-7,0
202505,20621000,CA,0,2,-2,0
202505,20710000,2,0,10,-10,0
202505,20710000,2S3,0,1,-1,0
202505,20710000,3S2,0,1,-1,0
202505,20710000,3S3,0,2,-2,0
202505,20710000,CA,0,3,-3,0
202505,20750000,2,0,9,-9,0
202505,20750000,3S3,0,1,-1,0
202505,20770000,2,0,13,-13,0
202505,20770000,2S2,0,2,-2,0
202505,20770000,3,0,1,-1,0
202505,20770000,3S3,0,3,-3,0
202505,20770002,2,0,1,-1,0
202505,20770003,3S3,0,1,-1,0
202505,20787000,2,0,4,-4,0
202505,23001000,2,0,297,-297,0
202505,23001000,2R2,0,1,-1,0
202505,23001000,2S2,0,28,-28,0
202505,23001000,2S3,0,3,-3,0
202505,23001000,3,0,15,-15,0
202505,23001000,3S2,0,81,-81,0
202505,23001000,3S3,0,162,-162,0
202505,23001000,4,0,1,-1,0
202505,23001000,CA,0,26,-26,0
202505,23001000,V2,0,1,-1,0
202505,23068000,2,0,8,-8,0
202505,23068000,CA,0,1,-1,0
202505,23079000,2,0,1,-1,0
202505,23079000,3S3,0,1,-1,0
202505,23079007,2,0,1,-1,0
202505,23090000,2,0,1,-1,0
202505,23090000,CA,0,2,-2,0
202505,23162000,2,0,91,-91,0
202505,23162000,2S2,0,2,-2,0
202505,23162000,2S3,0,3,-3,0
202505,23162000,3,0,3,-3,0
202505,23162000,3S2,0,10,-10,0
202505,23162000,3S3,0,68,-68,0
202505,23162000,CA,0,8,-8,0
202505,23168000,CA,0,1,-1,0
202505,23182000,2,0,9,-9,0
202505,23182000,3S3,0,1,-1,0
202505,23182026,3,0,1,-1,0
202505,23189000,2,0,37,-37,0
202505,23189000,2S2,0,1,-1,0
202505,23189000,3S2,0,1,-1,0
202505,23189000,3S3,0,56,-56,0
202505,23189000,CA,0,3,-3,0
202505,23300000,2,0,3,-3,0
202505,23350000,2,0,1,-1,0
202505,23350000,3S2,0,1,-1,0
202505,23417000,2,0,26,-26,0
202505,23417000,3,0,1,-1,0
202505,23417000,3S2,0,1,-1,0
202505,23417000,3S3,0,5,-5,0
202505,23417000,CA,0,14,-14,0
202505,23417016,2,0,1,-1,0
202505,23464000,2,0,2,-2,0
202505,23466000,2,0,14,-14,0
202505,23466000,3,0,1,-1,0
202505,23466000,3S2,0,1,-1,0
202505,23466000,3S3,0,9,-9,0
202505,23466000,4,0,1,-1,0
202505,23466000,CA,0,4,-4,0
202505,23466001,2,0,1,-1,0
202505,23500000,2,0,3,-3,0
202505,23500000,3S3,0,1,-1,0
202505,23500000,CA,0,2,-2,0
202505,23555000,2,0,22,-22,0
202505,23555000,3S2,0,2,-2,0
202505,23555000,3S3,0,4,-4,0
202505,23555000,CA,0,1,-1,0
202505,23570000,2,0,8,-8,0
202505,23570011,2,0,2,-2,0
202505,23570011,3S3,0,1,-1,0
202505,23570013,3S3,0,1,-1,0
202505,23574000,2,0,1,-1,0
202505,23574000,CA,0,1,-1,0
202505,23580000,2,0,10,-10,0
202505,23580000,3S3,0,2,-2,0
202505,23580000,CA,0,2,-2,0
202505,23660000,2,0,30,-30,0
202505,23660000,3,0,1,-1,0
202505,23660000,3S3,0,3,-3,0
202505,23660000,CA,0,3,-3,0
202505,23660004,2,0,1,-1,0
202505,23670000,3,0,1,-1,0
202505,23670000,CA,0,1,-1,0
202505,23670011,2,0,1,-1,0
202505,23670024,2,0,1,-1,0
202505,23672000,2,0,1,-1,0
202505,23675000,2,0,1,-1,0
202505,23678000,2,0,2,-2,0
202505,23678000,3S3,0,1,-1,0
202505,23682000,3S3,0,1,-1,0
202505,23686000,2,0,2,-2,0
202505,23686000,3S3,0,1,-1,0
202505,23686009,2,0,1,-1,0
202505,23807000,2,0,19,-19,0
202505,23807000,3S3,0,4,-4,0
202505,23807000,CA,0,4,-4,0
202505,23807027,2,0,2,-2,0
202505,23807027,3S3,0,12,-12,0
202505,23855000,2,0,5,-5,0
202505,23855000,3S3,0,2,-2,0
202505,25001000,2,0,2,-2,0
202505,25001000,CA,0,3,-3,0
202505,25019000,2,0,1,-1,0
202505,25019000,3S3,0,1,-1,0
202505,25035000,2,0,17,-17,0
202505,25035000,3S3,0,3,-3,0
202505,25035000,CA,0,15,-15,0
202505,25040000,2,0,2,-2,0
202505,25040000,CA,0,6,-6,0
202505,25053000,2,0,1,-1,0
202505,25053000,CA,0,3,-3,0
202505,25086000,CA,0,1,-1,0
202505,25095000,2,0,2,-2,0
202505,25095000,CA,0,1,-1,0
202505,25099000,2,0,5,-5,0
202505,25099000,3S3,0,4,-4,0
202505,25099000,CA,0,5,-5,0
202505,25120000,2,0,4,-4,0
202505,25120000,CA,0,1,-1,0
202505,25123000,2,0,1,-1,0
202505,25123000,3,0,1,-1,0
202505,25123000,CA,0,6,-6,0
202505,25126000,2,0,63,-63,0
202505,25126000,2S2,0,7,-7,0
202505,25126000,2S3,0,3,-3,0
202505,25126000,3,0,2,-2,0
202505,25126000,3S2,0,10,-10,0
202505,25126000,3S3,0,29,-29,0
202505,25126000,CA,0,58,-58,0
202505,25126009,2,0,1,-1,0
202505,25148000,2,0,2,-2,0
202505,25148000,CA,0,1,-1,0
202505,25151000,2,0,2,-2,0
202505,25151000,2S3,0,1,-1,0
202505,25151000,3S3,0,24,-24,0
202505,25151000,CA,0,3,-3,0
202505,25154000,2,0,1,-1,0
202505,25154000,CA,0,1,-1,0
202505,25168000,CA,0,1,-1,0
202505,25175000,2,0,133,-133,0
202505,25175000,2S2,0,32,-32,0
202505,25175000,2S3,0,3,-3,0
202505,25175000,3,0,2,-2,0
202505,25175000,3S2,0,4,-4,0
202505,25175000,3S3,0,43,-43,0
202505,25175000,4,0,1,-1,0
202505,25175000,CA,0,82,-82,0
202505,25175002,2,0,1,-1,0
202505,25178000,2,0,1,-1,0
202505,25181000,2,0,6,-6,0
202505,25181000,CA,0,1,-1,0
202505,25183000,2,0,10,-10,0
202505,25183000,2S2,0,1,-1,0
202505,25183000,3,0,1,-1,0
202505,25183000,CA,0,2,-2,0
202505,25183001,2,0,6,-6,0
202505,25200000,2,0,14,-14,0
202505,25200000,2S3,0,2,-2,0
202505,25200000,3S3,0,36,-36,0
202505,25200000,CA,0,4,-4,0
202505,25200000,V2,0,1,-1,0
202505,25214000,2,0,430,-430,0
202505,25214000,2S2,0,148,-148,0
202505,25214000,2S3,0,26,-26,0
202505,25214000,3,0,6,-6,0
202505,25214000,3S2,0,50,-50,0
202505,25214000,3S3,0,216,-216,0
202505,25214000,CA,0,58,-58,0
202505,25214008,2,0,16,-16,0
202505,25214008,2S2,0,4,-4,0
202505,25214008,2S3,0,3,-3,0
202505,25214008,3S2,0,7,-7,0
202505,25214008,3S3,0,4,-4,0
202505,25214008,CA,0,5,-5,0
202505,25224000,2,0,1,-1,0
202505,25224000,V3,0,1,-1,0
202505,25245000,2,0,10,-10,0
202505,25245000,2S2,0,3,-3,0
202505,25245000,3,0,2,-2,0
202505,25245000,3S3,0,1,-1,0
202505,25245000,CA,0,9,-9,0
202505,25260000,2,0,90,-90,0
202505,25260000,2S2,0,2,-2,0
202505,25260000,3S2,0,23,-23,0
202505,25260000,3S3,0,29,-29,0
202505,25260000,CA,0,16,-16,0
202505,25269000,2,0,126,-126,0
202505,25269000,2S3,0,2,-2,0
202505,25269000,3,0,3,-3,0
202505,25269000,3S2,0,27,-27,0
202505,25269000,3S3,0,178,-178,0
202505,25269000,CA,0,65,-65,0
202505,25279000,2,0,2,-2,0
202505,25279000,3S3,0,6,-6,0
202505,25279000,CA,0,3,-3,0
202505,25281000,CA,0,1,-1,0
202505,25286000,2,0,560,-560,0
202505,25286000,2R2,0,1,-1,0
202505,25286000,2S1,0,1,-1,0
202505,25286000,2S2,0,243,-243,0
202505,25286000,2S3,0,36,-36,0
202505,25286000,3,0,11,-11,0
202505,25286000,3S2,0,107,-107,0
202505,25286000,3S3,0,417,-417,0
202505,25286000,4,0,1,-1,0
202505,25286000,CA,0,177,-177,0
202505,25288000,2,0,1,-1,0
202505,25288000,3S2,0,2,-2,0
202505,25288000,3S3,0,1,-1,0
202505,25288000,CA,0,1,-1,0
202505,25290000,2,0,63,-63,0
202505,25290000,3,0,6,-6,0
202505,25290000,3S3,0,27,-27,0
202505,25290000,4,0,1,-1,0
202505,25290000,CA,0,24,-24,0
202505,25290011,2,0,1,-1,0
202505,25290012,3S3,0,4,-4,0
202505,25293000,CA,0,3,-3,0
202505,25295000,2,0,47,-47,0
202505,25295000,2S2,0,11,-11,0
202505,25295000,2S3,0,5,-5,0
202505,25295000,3,0,5,-5,0
202505,25295000,3S2,0,4,-4,0
202505,25295000,3S3,0,38,-38,0
202505,25295000,CA,0,7,-7,0
202505,25297000,2,0,3,-3,0
202505,25297000,CA,0,6,-6,0
202505,25299000,CA,0,1,-1,0
202505,25307000,2,0,55,-55,0
202505,25307000,2R2,0,1,-1,0
202505,25307000,2S2,0,1,-1,0
202505,25307000,3,0,4,-4,0
202505,25307000,3S2,0,2,-2,0
202505,25307000,3S3,0,29,-29,0
202505,25307000,CA,0,22,-22,0
202505,25312000,2,0,2,-2,0
202505,25312000,CA,0,2,-2,0
202505,25317000,2,0,1,-1,0
202505,25317000,3S3,0,4,-4,0
202505,25317000,CA,0,3,-3,0
202505,25317000,V3,0,2,-2,0
202505,25320000,2,0,12,-12,0
202505,25320000,3,0,2,-2,0
202505,25320000,3S2,0,33,-33,0
202505,25320000,3S3,0,54,-54,0
202505,25320000,CA,0,4,-4,0
202505,25320003,2,0,1,-1,0
202505,25322000,2,0,6,-6,0
202505,25322000,CA,0,13,-13,0
202505,25324000,CA,0,1,-1,0
202505,25326000,2,0,3,-3,0
202505,25326000,CA,0,1,-1,0
202505,25335000,2,0,1,-1,0
202505,25335000,CA,0,2,-2,0
202505,25368000,2,0,2,-2,0
202505,25368000,CA,0,1,-1,0
202505,25372000,CA,0,1,-1,0
202505,25377000,2,0,30,-30,0
202505,25377000,2S2,0,1,-1,0
202505,25377000,3,0,3,-3,0
202505,25377000,3S2,0,1,-1,0
202505,25377000,3S3,0,5,-5,0
202505,25377000,CA,0,20,-20,0
202505,25386000,2,0,33,-33,0
202505,25386000,2S3,0,1,-1,0
202505,25386000,3S3,0,4,-4,0
202505,25386000,CA,0,7,-7,0
202505,25394000,2,0,2,-2,0
202505,25398000,2,0,2,-2,0
202505,25398000,CA,0,1,-1,0
202505,25402000,2,0,8,-8,0
202505,25402000,3,0,1,-1,0
202505,25402000,CA,0,3,-3,0
202505,25407000,2,0,3,-3,0
202505,25407000,V2,0,2,-2,0
202505,25407000,V3,0,3,-3,0
202505,25407000,V4,0,1,-1,0
202505,25426000,2,0,3,-3,0
202505,25426000,CA,0,1,-1,0
202505,25430000,2,0,134,-134,0
202505,25430000,2B1,0,2,-2,0
202505,25430000,2R2,0,1,-1,0
202505,25430000,2S2,0,61,-61,0
202505,25430000,2S3,0,11,-11,0
202505,25430000,3,0,6,-6,0
202505,25430000,3S2,0,26,-26,0
202505,25430000,3S3,0,129,-129,0
202505,25430000,4,0,2,-2,0
202505,25430000,CA,0,51,-51,0
202505,25430000,V3,0,25,-25,0
202505,25430000,V4,0,10,-10,0
202505,25436000,CA,0,2,-2,0
202505,25438000,3S3,0,1,-1,0
202505,25438000,CA,0,1,-1,0
202505,25473000,2,0,169,-169,0
202505,25473000,2S2,0,62,-62,0
202505,25473000,2S3,0,14,-14,0
202505,25473000,3,0,15,-15,0
202505,25473000,3S2,0,22,-22,0
202505,25473000,3S3,0,252,-252,0
202505,25473000,3S4,0,1,-1,0
202505,25473000,CA,0,45,-45,0
202505,25473000,V2,0,5,-5,0
202505,25473000,V3,0,13,-13,0
202505,25473000,V4,0,1,-1,0
202505,25483000,2,0,1,-1,0
202505,25483000,3S2,0,1,-1,0
202505,25483000,CA,0,1,-1,0
202505,25486000,2,0,2,-2,0
202505,25486000,CA,0,6,-6,0
202505,25486000,V2,0,1,-1,0
202505,25488000,2,0,3,-3,0
202505,25488000,3S3,0,1,-1,0
202505,25491000,CA,0,3,-3,0
202505,25506000,2,0,2,-2,0
202505,25513000,2,0,6,-6,0
202505,25513000,3,0,1,-1,0
202505,25513000,3S3,0,1,-1,0
202505,25513000,CA,0,8,-8,0
202505,25524000,2,0,1,-1,0
202505,25530000,2,0,4,-4,0
202505,25530000,3S2,0,2,-2,0
202505,25530000,3S3,0,2,-2,0
202505,25535000,2,0,6,-6,0
202505,25535000,CA,0,1,-1,0
202505,25572000,2,0,9,-9,0
202505,25572000,2R2,0,1,-1,0
202505,25572000,3S3,0,4,-4,0
202505,25572000,CA,0,3,-3,0
202505,25580000,CA,0,1,-1,0
202505,25592000,2,0,1,-1,0
202505,25592000,CA,0,1,-1,0
202505,25594000,3S3,0,2,-2,0
202505,25594000,CA,0,2,-2,0
202505,25594002,2,0,1,-1,0
202505,25594002,3S3,0,2,-2,0
202505,25596000,2,0,1,-1,0
202505,25596000,CA,0,1,-1,0
202505,25599000,2,0,9,-9,0
202505,25599000,CA,0,3,-3,0
202505,25612000,2,0,5,-5,0
202505,25612000,3,0,1,-1,0
202505,25612000,3S3,0,5,-5,0
202505,25612000,CA,0,5,-5,0
202505,25645000,2,0,1,-1,0
202505,25645000,CA,0,6,-6,0
202505,25649000,2,0,6,-6,0
202505,25658000,2,0,2,-2,0
202505,25658000,3S2,0,2,-2,0
202505,25658000,CA,0,1,-1,0
202505,25662000,2,0,2,-2,0
202505,25662000,3,0,1,-1,0
202505,25662000,CA,0,2,-2,0
202505,25662001,2,0,1,-1,0
202505,25662001,3,0,1,-1,0
202505,25662001,3S3,0,1,-1,0
202505,25662001,CA,0,1,-1,0
202505,25718000,2,0,3,-3,0
202505,25718000,CA,0,1,-1,0
202505,25736000,2,0,22,-22,0
202505,25736000,2S3,0,1,-1,0
202505,25736000,3S2,0,5,-5,0
202505,25736000,3S3,0,20,-20,0
202505,25736000,CA,0,5,-5,0
202505,25740000,2,0,77,-77,0
202505,25740000,2S2,0,1,-1,0
202505,25740000,2S3,0,2,-2,0
202505,25740000,3,0,5,-5,0
202505,25740000,3S2,0,8,-8,0
202505,25740000,3S3,0,78,-78,0
202505,25740000,CA,0,16,-16,0
202505,25743000,2,0,2,-2,0
202505,25743000,CA,0,2,-2,0
202505,25745000,2,0,7,-7,0
202505,25745000,3S3,0,2,-2,0
202505,25745000,CA,0,5,-5,0
202505,25754000,2,0,144,-144,0
202505,25754000,2S2,0,5,-5,0
202505,25754000,2S3,0,2,-2,0
202505,25754000,3,0,4,-4,0
202505,25754000,3S2,0,12,-12,0
202505,25754000,3S3,0,65,-65,0
202505,25754000,CA,0,48,-48,0
202505,25754001,3S3,0,1,-1,0
202505,25758000,2,0,53,-53,0
202505,25758000,2S2,0,3,-3,0
202505,25758000,2S3,0,1,-1,0
202505,25758000,3,0,8,-8,0
202505,25758000,3S2,0,1,-1,0
202505,25758000,3S3,0,11,-11,0
202505,25758000,4,0,1,-1,0
202505,25758000,CA,0,11,-11,0
202505,25758000,V2,0,1,-1,0
202505,25758000,V3,0,47,-47,0
202505,25758000,V4,0,12,-12,0
202505,25758006,2,0,1,-1,0
202505,25769000,2,0,16,-16,0
202505,25769000,3S3,0,1,-1,0
202505,25769000,CA,0,7,-7,0
202505,25769000,V2,0,1,-1,0
202505,25772000,2,0,3,-3,0
202505,25772000,3,0,1,-1,0
202505,25772000,3S3,0,26,-26,0
202505,25772000,CA,0,4,-4,0
202505,25777000,3S3,0,1,-1,0
202505,25779000,2,0,2,-2,0
202505,25781000,3S3,0,1,-1,0
202505,25781000,CA,0,1,-1,0
202505,25785000,2,0,4,-4,0
202505,25785000,3S3,0,3,-3,0
202505,25785000,CA,0,8,-8,0
202505,25793000,CA,0,1,-1,0
202505,25793003,3S3,0,2,-2,0
202505,25797000,2,0,3,-3,0
202505,25797000,3S3,0,1,-1,0
202505,25797000,CA,0,1,-1,0
202505,25799000,2,0,116,-116,0
202505,25799000,2S2,0,161,-161,0
202505,25799000,2S3,0,16,-16,0
202505,25799000,3,0,5,-5,0
202505,25799000,3S2,0,53,-53,0
202505,25799000,3S3,0,25,-25,0
202505,25799000,CA,0,39,-39,0
202505,25799000,V3,0,1,-1,0
202505,25799001,2,0,2,-2,0
202505,25807000,2,0,1,-1,0
202505,25807000,CA,0,2,-2,0
202505,25815000,2,0,11,-11,0
202505,25815000,3S3,0,1,-1,0
202505,25815000,CA,0,5,-5,0
202505,25817000,2,0,285,-285,0
202505,25817000,2S2,0,67,-67,0
202505,25817000,2S3,0,50,-50,0
202505,25817000,3,0,3,-3,0
202505,25817000,3S1,0,1,-1,0
202505,25817000,3S2,0,62,-62,0
202505,25817000,3S3,0,357,-357,0
202505,25817000,CA,0,62,-62,0
202505,25817000,V3,0,1,-1,0
202505,25817000,V4,0,1,-1,0
202505,25817001,3S2,0,3,-3,0
202505,25817002,2,0,1,-1,0
202505,25817014,3S3,0,3,-3,0
202505,25839000,CA,0,2,-2,0
202505,25841000,3S3,0,5,-5,0
202505,25841000,CA,0,3,-3,0
202505,25843000,2,0,28,-28,0
202505,25843000,3,0,2,-2,0
202505,25843000,3S3,0,14,-14,0
202505,25843000,CA,0,4,-4,0
202505,25843000,V2,0,7,-7,0
202505,25843000,V3,0,16,-16,0
202505,25843000,V4,0,4,-4,0
202505,25845000,CA,0,1,-1,0
202505,25851000,2,0,2,-2,0
202505,25851000,3S3,0,1,-1,0
202505,25851000,CA,0,3,-3,0
202505,25873000,2,0,5,-5,0
202505,25873000,3S3,0,2,-2,0
202505,25873000,CA,0,9,-9,0
202505,25875000,2,0,31,-31,0
202505,25875000,3S2,0,1,-1,0
202505,25875000,3S3,0,2,-2,0
202505,25875000,CA,0,3,-3,0
202505,25878000,2,0,1,-1,0
202505,25878000,CA,0,4,-4,0
202505,25885000,2,0,2,-2,0
202505,25898000,2,0,7,-7,0
202505,25899000,2,0,149,-149,0
202505,25899000,2S2,0,5,-5,0
202505,25899000,2S3,0,2,-2,0
202505,25899000,3,0,1,-1,0
202505,25899000,3S2,0,2,-2,0
202505,25899000,3S3,0,18,-18,0
202505,25899000,3S4,0,1,-1,0
202505,25899000,CA,0,74,-74,0
202505,25899000,V2,0,1,-1,0
202505,25899000,V3,0,1,-1,0
202505,27001000,2,0,177,-177,0
202505,27001000,2S2,0,1,-1,0
202505,27001000,3,0,17,-17,0
202505,27001000,3S2,0,2,-2,0
202505,27001000,3S3,0,15,-15,0
202505,27001000,4,0,4,-4,0
202505,27001000,CA,0,7,-7,0
202505,27006000,2,0,3,-3,0
202505,27006000,CA,0,1,-1,0
202505,27050000,2,0,2,-2,0
202505,27073000,2,0,2,-2,0
202505,27073000,CA,0,1,-1,0
202505,27086000,2,0,8,-8,0
202505,27086000,3,0,2,-2,0
202505,27099000,2,0,1,-1,0
202505,27135000,2,0,1,-1,0
202505,27150000,2,0,2,-2,0
202505,27160000,2,0,1,-1,0
202505,27160000,3S2,0,1,-1,0
202505,27205000,2,0,14,-14,0
202505,27205000,3,0,2,-2,0
202505,27205000,3S3,0,1,-1,0
202505,27205000,CA,0,1,-1,0
202505,27245000,2,0,5,-5,0
202505,27245000,3,0,1,-1,0
202505,27245000,3S2,0,2,-2,0
202505,27245000,3S3,0,1,-1,0
202505,27245000,CA,0,1,-1,0
202505,27250012,2,0,1,-1,0
202505,27361000,2,0,75,-75,0
202505,27361000,3,0,17,-17,0
202505,27361000,3S2,0,1,-1,0
202505,27361000,3S3,0,5,-5,0
202505,27361000,CA,0,7,-7,0
202505,27413000,2,0,2,-2,0
202505,27430011,2,0,1,-1,0
202505,27450000,2,0,2,-2,0
202505,27491000,2,0,1,-1,0
202505,27491000,3,0,1,-1,0
202505,27491000,3S2,0,3,-3,0
202505,27580000,2,0,1,-1,0
202505,27615000,2,0,6,-6,0
202505,27615000,3,0,1,-1,0
202505,27615000,3S3,0,2,-2,0
202505,27615000,CA,0,1,-1,0
202505,27660000,2,0,1,-1,0
202505,27660000,3S3,0,2,-2,0
202505,27787000,2,0,13,-13,0
202505,27787000,3,0,1,-1,0
202505,27787000,CA,0,2,-2,0
202505,27800000,2,0,2,-2,0
202505,27810000,3S2,0,1,-1,0
202505,27810002,2,0,9,-9,0
202505,41001000,2,0,210,-210,0
202505,41001000,2R2,0,1,-1,0
202505,41001000,2S2,0,38,-38,0
202505,41001000,2S3,0,1,-1,0
202505,41001000,3,0,16,-16,0
202505,41001000,3S2,0,17,-17,0
202505,41001000,3S3,0,110,-110,0
202505,41001000,4,0,1,-1,0
202505,41001000,CA,0,59,-59,0
202505,41001001,CA,0,1,-1,0
202505,41001003,3S3,0,1,-1,0
202505,41006000,2,0,15,-15,0
202505,41006000,3,0,1,-1,0
202505,41006000,3S3,0,2,-2,0
202505,41013000,2,0,3,-3,0
202505,41013000,3,0,1,-1,0
202505,41016000,2,0,3,-3,0
202505,41016000,2S2,0,1,-1,0
202505,41016000,3,0,13,-13,0
202505,41016000,3S3,0,10,-10,0
202505,41016000,4,0,1,-1,0
202505,41016000,CA,0,2,-2,0
202505,41020000,3S3,0,1,-1,0
202505,41020000,CA,0,2,-2,0
202505,41026000,2,0,19,-19,0
202505,41026000,CA,0,1,-1,0
202505,41078000,CA,0,1,-1,0
202505,41132000,2,0,7,-7,0
202505,41132000,3S3,0,5,-5,0
202505,41132000,CA,0,1,-1,0
202505,41298000,2,0,29,-29,0
202505,41298000,2S3,0,1,-1,0
202505,41298000,3,0,1,-1,0
202505,41298000,3S3,0,8,-8,0
202505,41298000,CA,0,7,-7,0
202505,41306000,2,0,3,-3,0
202505,41306000,3S3,0,2,-2,0
202505,41306000,CA,0,1,-1,0
202505,41319000,2,0,3,-3,0
202505,41319000,3,0,1,-1,0
202505,41319000,3S3,0,1,-1,0
202505,41349000,2,0,2,-2,0
202505,41349000,3S2,0,1,-1,0
202505,41357000,2,0,2,-2,0
202505,41359000,2,0,9,-9,0
202505,41359000,3,0,1,-1,0
202505,41359000,3S3,0,1,-1,0
202505,41359000,CA,0,1,-1,0
202505,41359002,3S3,0,1,-1,0
202505,41378000,2,0,2,-2,0
202505,41378000,3,0,1,-1,0
202505,41396000,2,0,25,-25,0
202505,41396000,3,0,1,-1,0
202505,41396000,3S3,0,3,-3,0
202505,41396000,4,0,2,-2,0
202505,41396000,CA,0,6,-6,0
202505,41503000,CA,0,1,-1,0
202505,41518000,3,0,1,-1,0
202505,41524000,2,0,12,-12,0
202505,41524000,2S2,0,1,-1,0
202505,41524000,3,0,1,-1,0
202505,41524000,3S3,0,47,-47,0
202505,41524000,CA,0,4,-4,0
202505,41524001,3S3,0,2,-2,0
202505,41524006,2,0,2,-2,0
202505,41530000,2,0,1,-1,0
202505,41530000,CA,0,2,-2,0
202505,41548000,2,0,1,-1,0
202505,41548000,3S3,0,1,-1,0
202505,41551000,2,0,119,-119,0
202505,41551000,2R2,0,1,-1,0
202505,41551000,2S2,0,3,-3,0
202505,41551000,3,0,2,-2,0
202505,41551000,3S2,0,1,-1,0
202505,41551000,3S3,0,35,-35,0
202505,41551000,CA,0,12,-12,0
202505,41551001,2,0,3,-3,0
202505,41551001,CA,0,1,-1,0
202505,41615000,2,0,4,-4,0
202505,41615000,3,0,1,-1,0
202505,41615000,3S3,0,28,-28,0
202505,41615000,CA,0,4,-4,0
202505,41660000,2,0,2,-2,0
202505,41660000,3,0,2,-2,0
202505,41668000,2,0,8,-8,0
202505,41668000,3,0,1,-1,0
202505,41668000,3S3,0,1,-1,0
202505,41668000,CA,0,1,-1,0
202505,41770000,2,0,9,-9,0
202505,41770000,3S3,0,3,-3,0
202505,41791000,2,0,1,-1,0
202505,41791000,3S3,0,2,-2,0
202505,41797000,2,0,7,-7,0
202505,41797000,3,0,9,-9,0
202505,41797000,3S3,0,2,-2,0
202505,41799000,3S2,0,1,-1,0
202505,41799000,CA,0,1,-1,0
202505,41801000,2,0,1,-1,0
202505,41807000,2,0,9,-9,0
202505,41807000,3S2,0,1,-1,0
202505,41807000,3S3,0,12,-12,0
202505,41872000,3S2,0,1,-1,0
202505,41872000,3S3,0,2,-2,0
202505,41885000,2,0,1,-1,0
202505,41885000,CA,0,1,-1,0
202505,44001000,2,0,92,-92,0
202505,44001000,2S2,0,1,-1,0
202505,44001000,2S3,0,2,-2,0
202505,44001000,3,0,5,-5,0
202505,44001000,3S2,0,4,-4,0
202505,44001000,3S3,0,29,-29,0
202505,44001000,CA,0,11,-11,0
202505,44001003,3S3,0,1,-1,0
202505,44035000,2,0,9,-9,0
202505,44035000,2S2,0,2,-2,0
202505,44035000,2S3,0,2,-2,0
202505,44035000,3S3,0,14,-14,0
202505,44035000,3S4,0,3,-3,0
202505,44035000,CA,0,1,-1,0
202505,44035001,2,0,1,-1,0
202505,44078000,2,0,4,-4,0
202505,44078000,3S3,0,6,-6,0
202505,44090000,2,0,7,-7,0
202505,44090000,3S3,0,268,-268,0
202505,44090000,CA,0,2,-2,0
202505,44090003,2,0,1,-1,0
202505,44090003,3S3,0,2,-2,0
202505,44090004,2,0,4,-4,0
202505,44098000,2,0,1,-1,0
202505,44098000,3S3,0,1,-1,0
202505,44110000,2,0,1,-1,0
202505,44110000,3S3,0,1,-1,0
202505,44279000,2,0,18,-18,0
202505,44279000,3,0,1,-1,0
202505,44378000,2,0,1,-1,0
202505,44378000,CA,0,1,-1,0
202505,44420000,2,0,1,-1,0
202505,44430000,2,0,165,-165,0
202505,44430000,2S2,0,6,-6,0
202505,44430000,2S3,0,1,-1,0
202505,44430000,3,0,9,-9,0
202505,44430000,3S2,0,2,-2,0
202505,44430000,3S3,0,62,-62,0
202505,44430000,CA,0,19,-19,0
202505,44430000,V2,0,1,-1,0
202505,44430007,2,0,25,-25,0
202505,44430007,2S2,0,3,-3,0
202505,44430007,2S3,0,3,-3,0
202505,44430007,3S2,0,4,-4,0
202505,44430007,3S3,0,27,-27,0
202505,44430007,CA,0,3,-3,0
202505,44560000,2,0,16,-16,0
202505,44560000,3S3,0,3,-3,0
202505,44650000,2,0,5,-5,0
202505,44650000,3S3,0,2,-2,0
202505,44650000,CA,0,2,-2,0
202505,44847000,2,0,23,-23,0
202505,44847000,3,0,1,-1,0
202505,44847000,3S3,0,25,-25,0
202505,44847000,CA,0,3,-3,0
202505,44855000,2,0,1,-1,0
202505,44874000,2,0,3,-3,0
202505,44874000,3S3,0,1,-1,0
202505,44874000,CA,0,2,-2,0
202505,47001000,2,0,240,-240,0
202505,47001000,2R2,0,7,-7,0
202505,47001000,2S2,0,345,-345,0
202505,47001000,2S3,0,45,-45,0
202505,47001000,3,0,7,-7,0
202505,47001000,3S2,0,62,-62,0
202505,47001000,3S3,0,431,-431,0
202505,47001000,3S4,0,5,-5,0
202505,47001000,CA,0,64,-64,0
202505,47001000,V3R3,0,1,-1,0
202505,47001003,CA,0,1,-1,0
202505,47001005,3S3,0,4,-4,0
202505,47001006,2,0,2,-2,0
202505,47001010,2,0,1,-1,0
202505,47001011,CA,0,3,-3,0
202505,47001019,3S3,0,1,-1,0
202505,47030000,2,0,4,-4,0
202505,47030000,2S2,0,1,-1,0
202505,47053000,2,0,6,-6,0
202505,47053000,2S2,0,5,-5,0
202505,47053000,2S3,0,2,-2,0
202505,47053000,3S2,0,1,-1,0
202505,47053000,3S3,0,8,-8,0
202505,47053000,CA,0,2,-2,0
202505,47053000,V3R3,0,2,-2,0
202505,47058000,2,0,8,-8,0
202505,47058003,2,0,1,-1,0
202505,47058003,3S2,0,3,-3,0
202505,47161000,2,0,1,-1,0
202505,47170000,3S3,0,1,-1,0
202505,47170000,CA,0,1,-1,0
202505,47189000,2,0,40,-40,0
202505,47189000,2S2,0,2,-2,0
202505,47189000,2S3,0,1,-1,0
202505,47189000,3S2,0,6,-6,0
202505,47189000,3S3,0,16,-16,0
202505,47189000,CA,0,1,-1,0
202505,47189004,2,0,2,-2,0
202505,47205000,2,0,2,-2,0
202505,47245000,2,0,32,-32,0
202505,47245000,2S2,0,1,-1,0
202505,47245000,3,0,1,-1,0
202505,47245000,3S3,0,2,-2,0
202505,47245000,CA,0,5,-5,0
202505,47245001,2,0,1,-1,0
202505,47258000,2,0,2,-2,0
202505,47268000,2,0,11,-11,0
202505,47268000,3S3,0,1,-1,0
202505,47268000,CA,0,1,-1,0
202505,47288000,2,0,31,-31,0
202505,47288000,2S2,0,2,-2,0
202505,47288000,3S3,0,7,-7,0
202505,47288000,CA,0,3,-3,0
202505,47288011,3S3,0,1,-1,0
202505,47318000,2,0,11,-11,0
202505,47318000,3,0,1,-1,0
202505,47318000,CA,0,3,-3,0
202505,47460000,3S3,0,1,-1,0
202505,47460005,2,0,1,-1,0
202505,47541000,2,0,1,-1,0
202505,47545000,3,0,1,-1,0
202505,47551000,2,0,14,-14,0
202505,47551000,3S3,0,1,-1,0
202505,47551000,CA,0,4,-4,0
202505,47555000,2,0,19,-19,0
202505,47555000,3,0,1,-1,0
202505,47555000,3S2,0,1,-1,0
202505,47555000,3S3,0,2,-2,0
202505,47605000,2,0,6,-6,0
202505,47660000,3S2,0,1,-1,0
202505,47675000,2,0,2,-2,0
202505,47692000,2,0,3,-3,0
202505,47707000,2,0,4,-4,0
202505,47707000,CA,0,1,-1,0
202505,47745000,2,0,6,-6,0
202505,47745000,3S2,0,2,-2,0
202505,47745000,3S3,0,65,-65,0
202505,47745003,3S2,0,9,-9,0
202505,47745003,3S3,0,110,-110,0
202505,47798000,3S2,0,1,-1,0
202505,47960000,2,0,1,-1,0
202505,47980000,2,0,4,-4,0
202505,47980000,3S3,0,1,-1,0
202505,47980003,3S3,0,2,-2,0
202505,47980004,2,0,4,-4,0
202505,47980004,3S3,0,2,-2,0
202505,47980004,CA,0,1,-1,0
202505,47980006,3S3,0,2,-2,0
202505,47980008,2,0,3,-3,0
202505,47980011,3S2,0,1,-1,0
202505,50001000,2,0,342,-342,0
202505,50001000,2R2,0,1,-1,0
202505,50001000,2S2,0,73,-73,0
202505,50001000,2S3,0,17,-17,0
202505,50001000,3,0,8,-8,0
202505,50001000,3S2,0,49,-49,0
202505,50001000,3S3,0,221,-221,0
202505,50001000,3S4,0,1,-1,0
202505,50001000,4,0,1,-1,0
202505,50001000,CA,0,108,-108,0
202505,50001000,V2,0,1,-1,0
202505,50001001,3S3,0,1,-1,0
202505,50001001,CA,0,1,-1,0
202505,50001002,2,0,1,-1,0
202505,50001004,2,0,1,-1,0
202505,50001019,3S2,0,3,-3,0
202505,50001019,3S3,0,16,-16,0
202505,50001019,CA,0,1,-1,0
202505,50006000,2,0,50,-50,0
202505,50006000,2R2,0,1,-1,0
202505,50006000,2S2,0,3,-3,0
202505,50006000,3,0,3,-3,0
202505,50006000,3S2,0,11,-11,0
202505,50006000,3S3,0,38,-38,0
202505,50006000,4,0,1,-1,0
202505,50006000,CA,0,14,-14,0
202505,50006003,2,0,3,-3,0
202505,50006003,3S3,0,1,-1,0
202505,50110000,2,0,4,-4,0
202505,50110000,2S2,0,2,-2,0
202505,50110000,3S2,0,2,-2,0
202505,50110000,3S3,0,4,-4,0
202505,50110000,CA,0,2,-2,0
202505,50124000,2,0,2,-2,0
202505,50124000,2S3,0,1,-1,0
202505,50124000,3,0,1,-1,0
202505,50124000,3S3,0,6,-6,0
202505,50150000,2,0,12,-12,0
202505,50150000,2S2,0,1,-1,0
202505,50150000,3S3,0,4,-4,0
202505,50150000,3S4,0,1,-1,0
202505,50150000,CA,0,1,-1,0
202505,50223000,2,0,2,-2,0
202505,50223000,CA,0,1,-1,0
202505,50226000,2,0,11,-11,0
202505,50226000,2S3,0,1,-1,0
202505,50226000,3,0,1,-1,0
202505,50226000,3S3,0,4,-4,0
202505,50226000,CA,0,4,-4,0
202505,50251000,2,0,4,-4,0
202505,50251001,3S3,0,1,-1,0
202505,50270000,2S3,0,1,-1,0
202505,50270000,CA,0,1,-1,0
202505,50287000,3S3,0,1,-1,0
202505,50313000,2,0,62,-62,0
202505,50313000,3,0,3,-3,0
202505,50313000,3S2,0,2,-2,0
202505,50313000,3S3,0,39,-39,0
202505,50313000,CA,0,13,-13,0
202505,50313002,2,0,3,-3,0
202505,50318000,2,0,4,-4,0
202505,50318000,3S2,0,5,-5,0
202505,50318000,3S3,0,18,-18,0
202505,50318000,CA,0,1,-1,0
202505,50318004,3S2,0,21,-21,0
202505,50325000,3S3,0,4,-4,0
202505,50330000,2,0,2,-2,0
202505,50350000,2,0,1,-1,0
202505,50350003,2,0,1,-1,0
202505,50370000,2,0,1,-1,0
202505,50370000,CA,0,1,-1,0
202505,50400000,2,0,9,-9,0
202505,50400000,CA,0,1,-1,0
202505,50400001,3S3,0,4,-4,0
202505,50450000,2,0,1,-1,0
202505,50450000,3S3,0,1,-1,0
202505,50450001,3S3,0,3,-3,0
202505,50568000,2,0,69,-69,0
202505,50568000,2S2,0,3,-3,0
202505,50568000,2S3,0,9,-9,0
202505,50568000,3,0,3,-3,0
202505,50568000,3S2,0,34,-34,0
202505,50568000,3S3,0,157,-157,0
202505,50568000,3S4,0,1,-1,0
202505,50568000,CA,0,7,-7,0
202505,50568000,V3R2,0,1,-1,0
202505,50568000,V3R3,0,2,-2,0
202505,50568001,3S3,0,1,-1,0
202505,50568007,V2,0,1,-1,0
202505,50568007,V3,0,2,-2,0
202505,50568010,2,0,1,-1,0
202505,50568010,2S3,0,1,-1,0
202505,50568010,3S2,0,2,-2,0
202505,50568010,3S3,0,2,-2,0
202505,50568010,CA,0,1,-1,0
202505,50568011,2,0,26,-26,0
202505,50568011,2S1,0,1,-1,0
202505,50568011,2S2,0,4,-4,0
202505,50568011,2S3,0,2,-2,0
202505,50568011,3,0,3,-3,0
202505,50568011,3S2,0,16,-16,0
202505,50568011,3S3,0,79,-79,0
202505,50568011,CA,0,7,-7,0
202505,50568011,V3R3,0,14,-14,0
202505,50573000,2,0,16,-16,0
202505,50573000,2S2,0,1,-1,0
202505,50573000,2S3,0,1,-1,0
202505,50573000,3,0,2,-2,0
202505,50573000,3S2,0,2,-2,0
202505,50573000,3S3,0,17,-17,0
202505,50573000,4,0,1,-1,0
202505,50573000,CA,0,5,-5,0
202505,50577000,2,0,1,-1,0
202505,50590000,2,0,2,-2,0
202505,50590000,3S3,0,4,-4,0
202505,50606000,2,0,34,-34,0
202505,50606000,3,0,1,-1,0
202505,50606000,3S3,0,3,-3,0
202505,50606000,CA,0,5,-5,0
202505,50680000,2,0,3,-3,0
202505,50680000,2S3,0,1,-1,0
202505,50680000,3S2,0,5,-5,0
202505,50680000,3S3,0,38,-38,0
202505,50683000,2,0,2,-2,0
202505,50689000,2,0,9,-9,0
202505,50689000,3S3,0,2,-2,0
202505,50689000,CA,0,5,-5,0
202505,50711000,2,0,9,-9,0
202505,50711000,3S3,0,1,-1,0
202505,50711000,CA,0,2,-2,0
202505,52001000,2,0,383,-383,0
202505,52001000,2S2,0,45,-45,0
202505,52001000,2S3,0,10,-10,0
202505,52001000,3,0,2,-2,0
202505,52001000,3S2,0,13,-13,0
202505,52001000,3S3,0,122,-122,0
202505,52001000,CA,0,31,-31,0
202505,52001001,2,0,7,-7,0
202505,52001001,CA,0,1,-1,0
202505,52001003,2,0,1,-1,0
202505,52001003,CA,0,3,-3,0
202505,52019000,2,0,1,-1,0
202505,52019003,2,0,1,-1,0
202505,52019003,CA,0,1,-1,0
202505,52022000,CA,0,1,-1,0
202505,52036000,CA,0,1,-1,0
202505,52079000,2,0,6,-6,0
202505,52079000,CA,0,1,-1,0
202505,52079012,2,0,2,-2,0
202505,52083000,3,0,1,-1,0
202505,52083000,CA,0,1,-1,0
202505,52110000,2,0,1,-1,0
202505,52110000,3S3,0,2,-2,0
202505,52110000,CA,0,2,-2,0
202505,52203000,2,0,3,-3,0
202505,52203000,CA,0,2,-2,0
202505,52203007,2,0,1,-1,0
202505,52203007,CA,0,1,-1,0
202505,52207000,2,0,1,-1,0
202505,52215000,2,0,3,-3,0
202505,52215000,CA,0,1,-1,0
202505,52224000,2,0,3,-3,0
202505,52227000,2,0,8,-8,0
202505,52227000,3S3,0,2,-2,0
202505,52227000,CA,0,1,-1,0
202505,52240000,2,0,4,-4,0
202505,52240000,CA,0,2,-2,0
202505,52254000,CA,0,1,-1,0
202505,52256000,2,0,1,-1,0
202505,52256000,CA,0,1,-1,0
202505,52258003,CA,0,1,-1,0
202505,52258012,3,0,1,-1,0
202505,52260000,2,0,1,-1,0
202505,52260000,CA,0,1,-1,0
202505,52287000,2,0,1,-1,0
202505,52317000,2,0,10,-10,0
202505,52317000,3S3,0,3,-3,0
202505,52317000,CA,0,1,-1,0
202505,52320000,CA,0,1,-1,0
202505,52323000,2,0,1,-1,0
202505,52323000,3S3,0,1,-1,0
202505,52352000,2,0,2,-2,0
202505,52354002,2,0,1,-1,0
202505,52354004,2,0,1,-1,0
202505,52356000,2,0,261,-261,0
202505,52356000,2S2,0,3,-3,0
202505,52356000,2S3,0,4,-4,0
202505,52356000,3,0,1,-1,0
202505,52356000,3S2,0,13,-13,0
202505,52356000,3S3,0,89,-89,0
202505,52356000,CA,0,30,-30,0
202505,52356003,2,0,5,-5,0
202505,52356003,3S3,0,11,-11,0
202505,52378000,2,0,3,-3,0
202505,52378000,3,0,1,-1,0
202505,52378000,CA,0,1,-1,0
202505,52381000,CA,0,1,-1,0
202505,52385000,2,0,1,-1,0
202505,52399000,2,0,18,-18,0
202505,52399000,3S2,0,1,-1,0
202505,52399000,3S3,0,3,-3,0
202505,52399000,CA,0,4,-4,0
202505,52405000,2,0,2,-2,0
202505,52405008,CA,0,2,-2,0
202505,52411000,2,0,6,-6,0
202505,52411000,CA,0,1,-1,0
202505,52418000,2,0,1,-1,0
202505,52480000,2,0,1,-1,0
202505,52560000,2,0,1,-1,0
202505,52560000,CA,0,1,-1,0
202505,52565000,CA,0,1,-1,0
202505,52573000,2,0,2,-2,0
202505,52573000,CA,0,1,-1,0
202505,52573004,2,0,2,-2,0
202505,52585000,2,0,3,-3,0
202505,52585000,3S3,0,1,-1,0
202505,52585000,CA,0,1,-1,0
202505,52612000,2,0,4,-4,0
202505,52678000,2,0,4,-4,0
202505,52678000,CA,0,3,-3,0
202505,52683000,2,0,7,-7,0
202505,52683000,3S3,0,1,-1,0
202505,52683000,CA,0,3,-3,0
202505,52685000,2,0,2,-2,0
202505,52687000,2,0,1,-1,0
202505,52687000,CA,0,1,-1,0
202505,52693000,2,0,4,-4,0
202505,52693000,3,0,1,-1,0
202505,52693000,3S3,0,2,-2,0
202505,52693000,CA,0,1,-1,0
202505,52720000,2,0,1,-1,0
202505,52786000,CA,0,2,-2,0
202505,52786019,3S3,0,1,-1,0
202505,52788000,CA,0,2,-2,0
202505,52835000,2,0,73,-73,0
202505,52835000,2S2,0,1,-1,0
202505,52835000,3,0,2,-2,0
202505,52835000,3S2,0,4,-4,0
202505,52835000,3S3,0,15,-15,0
202505,52835000,CA,0,6,-6,0
202505,52835031,2,0,9,-9,0
202505,52835031,3S3,0,1,-1,0
202505,52838000,2,0,19,-19,0
202505,52838000,3,0,1,-1,0
202505,52838000,3S3,0,6,-6,0
202505,52838000,CA,0,8,-8,0
202505,52885000,2,0,2,-2,0
202505,54001000,2,0,778,-778,0
202505,54001000,2B1,0,1,-1,0
202505,54001000,2S2,0,33,-33,0
202505,54001000,2S3,0,27,-27,0
202505,54001000,3,0,31,-31,0
202505,54001000,3S2,0,45,-45,0
202505,54001000,3S3,0,375,-375,0
202505,54001000,4,0,1,-1,0
202505,54001000,CA,0,114,-114,0
202505,54001001,2,0,1,-1,0
202505,54001001,3S3,0,2,-2,0
202505,54001026,3S3,0,3,-3,0
202505,54001042,3S3,0,1,-1,0
202505,54001047,3,0,1,-1,0
202505,54003000,2,0,25,-25,0
202505,54003000,3S3,0,1,-1,0
202505,54051000,2,0,4,-4,0
202505,54051000,CA,0,4,-4,0
202505,54099000,2,0,2,-2,0
202505,54099000,3S3,0,1,-1,0
202505,54099002,2S2,0,1,-1,0
202505,54128000,2,0,1,-1,0
202505,54172000,2,0,10,-10,0
202505,54172000,2S2,0,1,-1,0
202505,54172000,3,0,2,-2,0
202505,54172000,3S2,0,2,-2,0
202505,54174000,2,0,1,-1,0
202505,54174000,3S3,0,2,-2,0
202505,54174000,CA,0,2,-2,0
202505,54206000,2,0,1,-1,0
202505,54206013,2,0,2,-2,0
202505,54206013,CA,0,1,-1,0
202505,54223000,2,0,3,-3,0
202505,54239000,2,0,3,-3,0
202505,54245000,2,0,1,-1,0
202505,54250000,2,0,2,-2,0
202505,54261000,2,0,15,-15,0
202505,54261000,3S3,0,3,-3,0
202505,54261005,3S2,0,1,-1,0
202505,54261007,3S3,0,1,-1,0
202505,54313000,2,0,1,-1,0
202505,54377000,2,0,1,-1,0
202505,54377000,CA,0,1,-1,0
202505,54385000,2,0,2,-2,0
202505,54385000,3S3,0,1,-1,0
202505,54398000,2,0,4,-4,0
202505,54405000,2,0,52,-52,0
202505,54405000,2S2,0,2,-2,0
202505,54405000,3,0,2,-2,0
202505,54405000,3S2,0,1,-1,0
202505,54405000,3S3,0,84,-84,0
202505,54405000,CA,0,1,-1,0
202505,54405000,V3,0,1,-1,0
202505,54405001,2,0,1,-1,0
202505,54480000,2,0,2,-2,0
202505,54498000,2,0,168,-168,0
202505,54498000,2S2,0,1,-1,0
202505,54498000,3,0,10,-10,0
202505,54498000,3S2,0,1,-1,0
202505,54498000,3S3,0,30,-30,0
202505,54498000,4,0,1,-1,0
202505,54498000,CA,0,5,-5,0
202505,54498001,2,0,1,-1,0
202505,54498011,2,0,4,-4,0
202505,54518000,2,0,29,-29,0
202505,54518000,3S3,0,3,-3,0
202505,54518000,CA,0,5,-5,0
202505,54520000,2,0,2,-2,0
202505,54553000,2,0,4,-4,0
202505,54553000,3S3,0,2,-2,0
202505,54553000,CA,0,1,-1,0
202505,54599000,2,0,1,-1,0
202505,54660000,2,0,3,-3,0
202505,54673000,2,0,9,-9,0
202505,54673000,3S2,0,1,-1,0
202505,54673000,3S3,0,2,-2,0
202505,54720000,2,0,5,-5,0
202505,54720024,2,0,1,-1,0
202505,54743000,2,0,1,-1,0
202505,54800000,2,0,1,-1,0
202505,54810000,2,0,20,-20,0
202505,54810000,3S3,0,15,-15,0
202505,54810000,CA,0,1,-1,0
202505,54810017,3S3,0,1,-1,0
202505,54820000,2,0,13,-13,0
202505,54874000,2,0,17,-17,0
202505,54874000,2S3,0,1,-1,0
202505,54874000,3S2,0,3,-3,0
202505,54874000,3S3,0,120,-120,0
202505,54874000,CA,0,8,-8,0
202505,63001000,2,0,218,-218,0
202505,63001000,2S2,0,33,-33,0
202505,63001000,3,0,10,-10,0
202505,63001000,3S2,0,5,-5,0
202505,63001000,3S3,0,57,-57,0
202505,63001000,CA,0,37,-37,0
202505,63130000,2,0,33,-33,0
202505,63130000,2R2,0,1,-1,0
202505,63130000,2S2,0,1,-1,0
202505,63130000,3S2,0,4,-4,0
202505,63130000,3S3,0,14,-14,0
202505,63130000,CA,0,2,-2,0
202505,63130001,2,0,1,-1,0
202505,63130004,2,0,1,-1,0
202505,63190000,2,0,15,-15,0
202505,63190000,CA,0,4,-4,0
202505,63190000,V3,0,1,-1,0
202505,63212000,2,0,2,-2,0
202505,63272000,2,0,5,-5,0
202505,63272000,CA,0,2,-2,0
202505,63302000,2,0,2,-2,0
202505,63302000,CA,0,2,-2,0
202505,63401000,2,0,41,-41,0
202505,63401000,2S3,0,1,-1,0
202505,63401000,3S2,0,2,-2,0
202505,63401000,3S3,0,3,-3,0
202505,63401000,CA,0,5,-5,0
202505,63401001,3S3,0,1,-1,0
202505,63470000,2,0,13,-13,0
202505,63470000,3S2,0,1,-1,0
202505,63470000,CA,0,3,-3,0
202505,63470003,2,0,4,-4,0
202505,63470003,3S3,0,1,-1,0
202505,63548000,2,0,1,-1,0
202505,63594000,2,0,28,-28,0
202505,63594000,3S3,0,1,-1,0
202505,63594000,CA,0,7,-7,0
202505,63690000,2,0,3,-3,0
202505,66001000,2,0,520,-520,0
202505,66001000,2R2,0,1,-1,0
202505,66001000,2S2,0,102,-102,0
202505,66001000,2S3,0,19,-19,0
202505,66001000,3,0,13,-13,0
202505,66001000,3S1,0,1,-1,0
202505,66001000,3S2,0,41,-41,0
202505,66001000,3S3,0,193,-193,0
202505,66001000,CA,0,104,-104,0
202505,66001001,2,0,6,-6,0
202505,66001015,2S2,0,1,-1,0
202505,66001015,3S2,0,1,-1,0
202505,66001018,2,0,6,-6,0
202505,66001018,3S3,0,1,-1,0
202505,66001031,2,0,1,-1,0
202505,66045000,2,0,6,-6,0
202505,66045000,CA,0,2,-2,0
202505,66075000,2,0,1,-1,0
202505,66075000,3S3,0,5,-5,0
202505,66088000,2,0,10,-10,0
202505,66088000,3,0,2,-2,0
202505,66170000,2,0,239,-239,0
202505,66170000,2S2,0,8,-8,0
202505,66170000,2S3,0,2,-2,0
202505,66170000,3,0,9,-9,0
202505,66170000,3S2,0,25,-25,0
202505,66170000,3S3,0,62,-62,0
202505,66170000,CA,0,31,-31,0
202505,66318000,2,0,7,-7,0
202505,66383000,2,0,2,-2,0
202505,66400000,2,0,31,-31,0
202505,66400000,3S2,0,2,-2,0
202505,66400000,3S3,0,8,-8,0
202505,66400000,3S4,0,1,-1,0
202505,66400000,CA,0,2,-2,0
202505,66440000,2,0,3,-3,0
202505,66440000,CA,0,2,-2,0
202505,66456000,2,0,1,-1,0
202505,66572000,2,0,4,-4,0
202505,66572000,CA,0,2,-2,0
202505,66594000,2,0,13,-13,0
202505,66594000,CA,0,2,-2,0
202505,66594002,2,0,2,-2,0
202505,66682000,2,0,68,-68,0
202505,66682000,3,0,2,-2,0
202505,66682000,3S3,0,6,-6,0
202505,66682000,CA,0,7,-7,0
202505,66687000,2,0,6,-6,0
202505,66687000,CA,0,2,-2,0
202505,68001000,2,0,751,-751,0
202505,68001000,2R2,0,2,-2,0
202505,68001000,2S2,0,97,-97,0
202505,68001000,2S3,0,12,-12,0
202505,68001000,3,0,26,-26,0
202505,68001000,3S2,0,48,-48,0
202505,68001000,3S3,0,846,-846,0
202505,68001000,CA,0,138,-138,0
202505,68001000,V2,0,6,-6,0
202505,68001010,3S3,0,1,-1,0
202505,68051000,2,0,10,-10,0
202505,68077000,2,0,45,-45,0
202505,68077000,2S3,0,1,-1,0
202505,68077000,3,0,5,-5,0
202505,68077000,3S3,0,10,-10,0
202505,68077000,CA,0,10,-10,0
202505,68079000,2,0,1,-1,0
202505,68079000,CA,0,1,-1,0
202505,68081000,2,0,167,-167,0
202505,68081000,2R2,0,1,-1,0
202505,68081000,2S2,0,20,-20,0
202505,68081000,2S3,0,3,-3,0
202505,68081000,3,0,3,-3,0
202505,68081000,3S2,0,10,-10,0
202505,68081000,3S3,0,191,-191,0
202505,68081000,3S4,0,2,-2,0
202505,68081000,CA,0,30,-30,0
202505,68081000,V3,0,2,-2,0
202505,68081001,3S3,0,1,-1,0
202505,68081002,3S3,0,1,-1,0
202505,68081002,3S3S2,0,1,-1,0
202505,68081003,2,0,2,-2,0
202505,68081003,3,0,1,-1,0
202505,68081003,3S3,0,12,-12,0
202505,68081010,3S3,0,4,-4,0
202505,68092000,3S2,0,1,-1,0
202505,68092000,3S3,0,34,-34,0
202505,68092003,3S3,0,5,-5,0
202505,68101000,2,0,2,-2,0
202505,68132000,2,0,1,-1,0
202505,68147000,2,0,3,-3,0
202505,68152000,2,0,1,-1,0
202505,68162000,2,0,1,-1,0
202505,68162000,3S3,0,1,-1,0
202505,68167000,2,0,13,-13,0
202505,68167000,3S3,0,1,-1,0
202505,68167000,CA,0,1,-1,0
202505,68169000,2,0,1,-1,0
202505,68176000,2,0,1,-1,0
202505,68190000,2,0,31,-31,0
202505,68190000,3,0,1,-1,0
202505,68190000,3S3,0,4,-4,0
202505,68190000,CA,0,1,-1,0
202505,68190000,V3,0,1,-1,0
202505,68190002,2,0,5,-5,0
202505,68190002,3S2,0,1,-1,0
202505,68190002,3S3,0,2,-2,0
202505,68190004,3,0,1,-1,0
202505,68207000,2,0,1,-1,0
202505,68209000,2,0,2,-2,0
202505,68211000,2,0,1,-1,0
202505,68217000,2,0,2,-2,0
202505,68229000,2,0,5,-5,0
202505,68235000,2,0,2,-2,0
202505,68235000,V2,0,1,-1,0
202505,68250000,2,0,1,-1,0
202505,68255000,2,0,3,-3,0
202505,68255000,3S3,0,1,-1,0
202505,68264000,2,0,1,-1,0
202505,68266000,2,0,1,-1,0
202505,68271000,2,0,1,-1,0
202505,68276000,2,0,179,-179,0
202505,68276000,2R2,0,1,-1,0
202505,68276000,2S2,0,2,-2,0
202505,68276000,3,0,6,-6,0
202505,68276000,3S2,0,14,-14,0
202505,68276000,3S3,0,9,-9,0
202505,68276000,CA,0,21,-21,0
202505,68298000,2,0,1,-1,0
202505,68307000,2,0,186,-186,0
202505,68307000,2S2,0,6,-6,0
202505,68307000,2S3,0,3,-3,0
202505,68307000,3,0,14,-14,0
202505,68307000,3S2,0,42,-42,0
202505,68307000,3S3,0,284,-284,0
202505,68307000,CA,0,29,-29,0
202505,68307000,V2,0,1,-1,0
202505,68307007,2,0,7,-7,0
202505,68307007,3S3,0,1,-1,0
202505,68318000,2,0,1,-1,0
202505,68318000,CA,0,1,-1,0
202505,68320000,2,0,2,-2,0
202505,68324000,3S3,0,2,-2,0
202505,68327000,2,0,5,-5,0
202505,68377000,2,0,1,-1,0
202505,68385000,2,0,7,-7,0
202505,68385000,3,0,1,-1,0
202505,68397000,2,0,1,-1,0
202505,68406000,2,0,83,-83,0
202505,68406000,2S2,0,3,-3,0
202505,68406000,3,0,3,-3,0
202505,68406000,3S2,0,2,-2,0
202505,68406000,3S3,0,43,-43,0
202505,68406000,CA,0,5,-5,0
202505,68418000,2,0,26,-26,0
202505,68418000,3,0,2,-2,0
202505,68418000,3S3,0,1,-1,0
202505,68418000,CA,0,1,-1,0
202505,68425000,2,0,1,-1,0
202505,68432000,2,0,16,-16,0
202505,68432000,3,0,1,-1,0
202505,68432000,3S3,0,1,-1,0
202505,68444000,2,0,1,-1,0
202505,68464000,2,0,8,-8,0
202505,68498000,2,0,3,-3,0
202505,68500000,2,0,10,-10,0
202505,68500000,3,0,1,-1,0
202505,68500000,3S3,0,3,-3,0
202505,68500000,CA,0,2,-2,0
202505,68500000,V2,0,1,-1,0
202505,68524000,2,0,6,-6,0
202505,68533000,2,0,6,-6,0
202505,68547000,2,0,54,-54,0
202505,68547000,2R2,0,1,-1,0
202505,68547000,2S2,0,3,-3,0
202505,68547000,2S3,0,1,-1,0
202505,68547000,3,0,4,-4,0
202505,68547000,3S2,0,2,-2,0
202505,68547000,3S3,0,24,-24,0
202505,68547000,CA,0,15,-15,0
202505,68547011,2,0,1,-1,0
202505,68549000,2,0,5,-5,0
202505,68572000,2,0,10,-10,0
202505,68572000,3S3,0,3,-3,0
202505,68572000,CA,0,2,-2,0
202505,68573000,2,0,4,-4,0
202505,68573000,3S3,0,3,-3,0
202505,68573000,3S4,0,1,-1,0
202505,68575000,2,0,4,-4,0
202505,68575000,3S3,0,6,-6,0
202505,68575000,CA,0,1,-1,0
202505,68575000,V3,0,3,-3,0
202505,68615000,2,0,12,-12,0
202505,68615000,3,0,1,-1,0
202505,68615000,3S3,0,2,-2,0
202505,68615000,CA,0,1,-1,0
202505,68655000,2,0,14,-14,0
202505,68655000,3,0,9,-9,0
202505,68655000,3S2,0,2,-2,0
202505,68655000,3S3,0,7,-7,0
202505,68655000,CA,0,1,-1,0
202505,68669000,2,0,5,-5,0
202505,68669000,CA,0,1,-1,0
202505,68679000,2,0,63,-63,0
202505,68679000,2S3,0,1,-1,0
202505,68679000,3,0,1,-1,0
202505,68679000,3S2,0,2,-2,0
202505,68679000,3S3,0,32,-32,0
202505,68679000,CA,0,10,-10,0
202505,68684000,2,0,1,-1,0
202505,68686000,2,0,6,-6,0
202505,68689000,2,0,13,-13,0
202505,68689000,3S2,0,2,-2,0
202505,68689000,V3,0,1,-1,0
202505,68689012,CA,0,1,-1,0
202505,68745000,2,0,1,-1,0
202505,68755000,2,0,26,-26,0
202505,68755000,3,0,1,-1,0
202505,68755000,3S3,0,6,-6,0
202505,68755000,CA,0,3,-3,0
202505,68770000,2,0,2,-2,0
202505,68770000,CA,0,3,-3,0
202505,68780000,2,0,1,-1,0
202505,68820000,2,0,1,-1,0
202505,68820001,3S2,0,1,-1,0
202505,68855000,2,0,3,-3,0
202505,68855000,V2,0,1,-1,0
202505,68861000,2,0,19,-19,0
202505,68861000,3,0,1,-1,0
202505,68861000,3S3,0,14,-14,0
202505,68861000,CA,0,2,-2,0
202505,68872000,2,0,9,-9,0
202505,68895000,2,0,6,-6,0
202505,70001000,2,0,209,-209,0
202505,70001000,2B1,0,1,-1,0
202505,70001000,2R2,0,1,-1,0
202505,70001000,2S2,0,13,-13,0
202505,70001000,2S3,0,2,-2,0
202505,70001000,3,0,7,-7,0
202505,70001000,3S2,0,27,-27,0
202505,70001000,3S3,0,36,-36,0
202505,70001000,4,0,1,-1,0
202505,70001000,CA,0,22,-22,0
202505,70001002,2,0,1,-1,0
202505,70001005,2,0,1,-1,0
202505,70110000,2,0,4,-4,0
202505,70110000,3,0,1,-1,0
202505,70124000,CA,0,1,-1,0
202505,70204000,2,0,1,-1,0
202505,70215000,2,0,27,-27,0
202505,70215000,3,0,2,-2,0
202505,70215000,3S3,0,11,-11,0
202505,70215000,CA,0,1,-1,0
202505,70221000,2,0,9,-9,0
202505,70221000,CA,0,1,-1,0
202505,70221005,CA,0,1,-1,0
202505,70233000,2,0,1,-1,0
202505,70235000,2,0,2,-2,0
202505,70235008,3S3,0,3,-3,0
202505,70265000,2,0,7,-7,0
202505,70265000,CA,0,2,-2,0
202505,70400000,2,0,3,-3,0
202505,70418000,2,0,2,-2,0
202505,70418000,3S3,0,1,-1,0
202505,70429000,2,0,7,-7,0
202505,70429000,3,0,2,-2,0
202505,70429000,CA,0,1,-1,0
202505,70508000,2,0,3,-3,0
202505,70508000,CA,0,1,-1,0
202505,70523000,2,0,1,-1,0
202505,70523000,CA,0,1,-1,0
202505,70670000,2,0,3,-3,0
202505,70670000,3,0,1,-1,0
202505,70678000,2,0,5,-5,0
202505,70708000,2,0,11,-11,0
202505,70708000,3S2,0,1,-1,0
202505,70708000,3S3,0,5,-5,0
202505,70713000,2,0,3,-3,0
202505,70713000,3S3,0,2,-2,0
202505,70713000,CA,0,2,-2,0
202505,70717000,2,0,1,-1,0
202505,70717000,3S3,0,2,-2,0
202505,70717000,CA,0,1,-1,0
202505,70717002,2,0,1,-1,0
202505,70742000,2,0,8,-8,0
202505,70771000,2,0,1,-1,0
202505,70771000,3S2,0,1,-1,0
202505,70771013,2,0,2,-2,0
202505,70771026,3S3,0,4,-4,0
202505,70820000,2,0,8,-8,0
202505,70820000,3S3,0,12,-12,0
202505,70820000,CA,0,4,-4,0
202505,70820001,2,0,1,-1,0
202505,70820008,3S2,0,4,-4,0
202505,70820008,3S3,0,15,-15,0
202505,70823000,2,0,6,-6,0
202505,70823000,2S2,0,1,-1,0
202505,70823000,3S3,0,39,-39,0
202505,70823000,CA,0,1,-1,0
202505,73001000,2,0,353,-353,0
202505,73001000,2R2,0,3,-3,0
202505,73001000,2S2,0,44,-44,0
202505,73001000,2S3,0,3,-3,0
202505,73001000,3,0,15,-15,0
202505,73001000,3S2,0,26,-26,0
202505,73001000,3S3,0,125,-125,0
202505,73001000,CA,0,76,-76,0
202505,73001000,V2,0,2,-2,0
202505,73001000,V4,0,1,-1,0
202505,73001031,2,0,1,-1,0
202505,73024000,CA,0,1,-1,0
202505,73026000,2,0,8,-8,0
202505,73026000,3,0,2,-2,0
202505,73030000,2,0,3,-3,0
202505,73043000,2,0,4,-4,0
202505,73055000,2,0,2,-2,0
202505,73067000,2,0,2,-2,0
202505,73124000,2,0,4,-4,0
202505,73148000,2,0,2,-2,0
202505,73148000,3S2,0,1,-1,0
202505,73148000,3S3,0,1,-1,0
202505,73148000,CA,0,3,-3,0
202505,73168000,2,0,21,-21,0
202505,73168000,2S2,0,3,-3,0
202505,73168000,2S3,0,1,-1,0
202505,73168000,3S3,0,8,-8,0
202505,73168000,CA,0,4,-4,0
202505,73200000,3S3,0,2,-2,0
202505,73200001,2,0,3,-3,0
202505,73200001,3,0,1,-1,0
202505,73200001,3S2,0,1,-1,0
202505,73200001,3S3,0,2,-2,0
202505,73217000,2,0,2,-2,0
202505,73217001,2,0,1,-1,0
202505,73226000,2,0,4,-4,0
202505,73236000,2,0,1,-1,0
202505,73268000,2,0,44,-44,0
202505,73268000,2R2,0,1,-1,0
202505,73268000,2S2,0,3,-3,0
202505,73268000,3,0,3,-3,0
202505,73268000,3S3,0,35,-35,0
202505,73268000,4,0,2,-2,0
202505,73268000,CA,0,11,-11,0
202505,73268001,3S3,0,1,-1,0
202505,73268001,CA,0,2,-2,0
202505,73275000,2,0,14,-14,0
202505,73275000,3S2,0,1,-1,0
202505,73275000,3S3,0,1,-1,0
202505,73275000,CA,0,3,-3,0
202505,73283000,2,0,15,-15,0
202505,73283000,3S3,0,2,-2,0
202505,73283000,CA,0,4,-4,0
202505,73319000,2,0,9,-9,0
202505,73319000,2S2,0,1,-1,0
202505,73319000,3,0,1,-1,0
202505,73319000,CA,0,1,-1,0
202505,73349000,2,0,6,-6,0
202505,73349000,3S3,0,9,-9,0
202505,73349000,CA,0,3,-3,0
202505,73352000,CA,0,1,-1,0
202505,73408000,2,0,7,-7,0
202505,73408000,3S3,0,1,-1,0
202505,73408000,CA,0,1,-1,0
202505,73411000,2,0,8,-8,0
202505,73411000,3,0,3,-3,0
202505,73411000,3S3,0,2,-2,0
202505,73411000,CA,0,4,-4,0
202505,73443000,2,0,20,-20,0
202505,73443000,2S2,0,2,-2,0
202505,73443000,2S3,0,1,-1,0
202505,73443000,3S2,0,2,-2,0
202505,73443000,3S3,0,24,-24,0
202505,73443000,CA,0,2,-2,0
202505,73449000,2,0,13,-13,0
202505,73449000,3S3,0,2,-2,0
202505,73449000,CA,0,9,-9,0
202505,73461000,2,0,1,-1,0
202505,73461000,CA,0,2,-2,0
202505,73483000,2,0,5,-5,0
202505,73504000,2,0,2,-2,0
202505,73504000,2R2,0,1,-1,0
202505,73504000,3S3,0,1,-1,0
202505,73520000,2,0,5,-5,0
202505,73547000,2,0,1,-1,0
202505,73547000,CA,0,1,-1,0
202505,73555000,2,0,7,-7,0
202505,73563000,2,0,1,-1,0
202505,73585000,2,0,10,-10,0
202505,73585000,3,0,2,-2,0
202505,73585000,CA,0,1,-1,0
202505,73616000,2,0,5,-5,0
202505,73624000,2,0,2,-2,0
202505,73671000,2,0,5,-5,0
202505,73671000,2R2,0,1,-1,0
202505,73671000,3S3,0,4,-4,0
202505,73671000,CA,0,1,-1,0
202505,73675000,2,0,2,-2,0
202505,73678000,2,0,3,-3,0
202505,73678004,CA,0,1,-1,0
202505,73686000,2,0,1,-1,0
202505,73686000,CA,0,1,-1,0
202505,73770000,CA,0,1,-1,0
202505,73861000,2,0,3,-3,0
202505,73861000,3S3,0,4,-4,0
202505,73861000,CA,0,1,-1,0
202505,73873000,2,0,1,-1,0
202505,76001000,2,0,1232,-1232,0
202505,76001000,2R2,0,3,-3,0
202505,76001000,2S2,0,189,-189,0
202505,76001000,2S3,0,21,-21,0
202505,76001000,3,0,29,-29,0
202505,76001000,3S2,0,143,-143,0
202505,76001000,3S3,0,325,-325,0
202505,76001000,CA,0,279,-279,0
202505,76001007,2,0,1,-1,0
202505,76001013,2,0,8,-8,0
202505,76001013,CA,0,17,-17,0
202505,76020000,2,0,11,-11,0
202505,76020000,CA,0,1,-1,0
202505,76036000,2,0,6,-6,0
202505,76041000,2,0,6,-6,0
202505,76041000,3S3,0,2,-2,0
202505,76041000,CA,0,2,-2,0
202505,76054000,2,0,3,-3,0
202505,76100000,2,0,2,-2,0
202505,76100007,2,0,1,-1,0
202505,76109000,2,0,192,-192,0
202505,76109000,2S2,0,533,-533,0
202505,76109000,2S3,0,190,-190,0
202505,76109000,3,0,3,-3,0
202505,76109000,3S2,0,177,-177,0
202505,76109000,3S3,0,670,-670,0
202505,76109000,4,0,5,-5,0
202505,76109000,CA,0,46,-46,0
202505,76109006,2,0,1,-1,0
202505,76109006,3S3,0,2,-2,0
202505,76109006,CA,0,2,-2,0
202505,76109008,2S2,0,1,-1,0
202505,76109009,CA,0,1,-1,0
202505,76109016,2,0,2,-2,0
202505,76111000,2,0,137,-137,0
202505,76111000,2S2,0,6,-6,0
202505,76111000,2S3,0,1,-1,0
202505,76111000,3,0,4,-4,0
202505,76111000,3S2,0,10,-10,0
202505,76111000,3S3,0,367,-367,0
202505,76111000,CA,0,13,-13,0
202505,76111024,3S3,0,1,-1,0
202505,76113000,2,0,30,-30,0
202505,76113000,3S2,0,3,-3,0
202505,76113000,3S3,0,17,-17,0
202505,76113000,CA,0,10,-10,0
202505,76113013,2,0,1,-1,0
202505,76122000,2,0,16,-16,0
202505,76122000,CA,0,2,-2,0
202505,76126000,2,0,8,-8,0
202505,76126000,3,0,1,-1,0
202505,76126000,CA,0,3,-3,0
202505,76130000,2,0,63,-63,0
202505,76130000,2S2,0,6,-6,0
202505,76130000,2S3,0,1,-1,0
202505,76130000,3,0,2,-2,0
202505,76130000,3S2,0,7,-7,0
202505,76130000,3S3,0,67,-67,0
202505,76130000,4,0,1,-1,0
202505,76130000,CA,0,13,-13,0
202505,76130002,3S3,0,1,-1,0
202505,76130004,2,0,1,-1,0
202505,76130008,2,0,2,-2,0
202505,76147000,2,0,92,-92,0
202505,76147000,2S2,0,4,-4,0
202505,76147000,3,0,4,-4,0
202505,76147000,3S2,0,6,-6,0
202505,76147000,3S3,0,116,-116,0
202505,76147000,CA,0,16,-16,0
202505,76147010,2,0,3,-3,0
202505,76147010,3S3,0,2,-2,0
202505,76233000,2,0,3,-3,0
202505,76233000,CA,0,4,-4,0
202505,76233009,2,0,1,-1,0
202505,76233017,2,0,2,-2,0
202505,76233017,3S3,0,1,-1,0
202505,76243000,2,0,1,-1,0
202505,76246000,2,0,1,-1,0
202505,76248000,2,0,25,-25,0
202505,76248000,3S3,0,2,-2,0
202505,76248000,3S4,0,3,-3,0
202505,76248000,CA,0,8,-8,0
202505,76248005,3S3,0,1,-1,0
202505,76250000,2,0,4,-4,0
202505,76275000,2,0,10,-10,0
202505,76275000,CA,0,8,-8,0
202505,76275008,2,0,2,-2,0
202505,76306000,2,0,16,-16,0
202505,76306000,3S2,0,1,-1,0
202505,76306000,3S3,0,2,-2,0
202505,76306000,CA,0,4,-4,0
202505,76318000,2,0,14,-14,0
202505,76318000,3,0,2,-2,0
202505,76318000,3S2,0,1,-1,0
202505,76318000,3S3,0,3,-3,0
202505,76318000,CA,0,3,-3,0
202505,76318008,2,0,1,-1,0
202505,76364000,2,0,111,-111,0
202505,76364000,2S2,0,15,-15,0
202505,76364000,3,0,2,-2,0
202505,76364000,3S2,0,4,-4,0
202505,76364000,3S3,0,14,-14,0
202505,76364000,CA,0,22,-22,0
202505,76364000,V4,0,1,-1,0
202505,76364006,2,0,1,-1,0
202505,76377000,2,0,2,-2,0
202505,76377000,CA,0,1,-1,0
202505,76400000,2,0,20,-20,0
202505,76400000,2S2,0,1,-1,0
202505,76400000,3S3,0,5,-5,0
202505,76400000,CA,0,3,-3,0
202505,76400007,2,0,3,-3,0
202505,76400007,3S3,0,1,-1,0
202505,76403000,2,0,2,-2,0
202505,76497000,2,0,2,-2,0
202505,76497000,2S3,0,1,-1,0
202505,76497000,3S3,0,1,-1,0
202505,76497000,CA,0,1,-1,0
202505,76520000,2,0,329,-329,0
202505,76520000,2S2,0,79,-79,0
202505,76520000,2S3,0,23,-23,0
202505,76520000,3,0,5,-5,0
202505,76520000,3S2,0,64,-64,0
202505,76520000,3S3,0,201,-201,0
202505,76520000,3S4,0,2,-2,0
202505,76520000,CA,0,54,-54,0
202505,76520000,V2,0,1,-1,0
202505,76520002,2,0,1,-1,0
202505,76520002,3,0,1,-1,0
202505,76520010,2,0,1,-1,0
202505,76520015,3S3,0,1,-1,0
202505,76520024,2S2,0,13,-13,0
202505,76520024,3S2,0,1,-1,0
202505,76520026,2,0,2,-2,0
202505,76520026,3S3,0,2,-2,0
202505,76520026,CA,0,1,-1,0
202505,76520029,CA,0,2,-2,0
202505,76520038,2,0,2,-2,0
202505,76520038,3S3,0,2,-2,0
202505,76563000,2,0,5,-5,0
202505,76563000,3,0,2,-2,0
202505,76563000,3S3,0,2,-2,0
202505,76563000,CA,0,6,-6,0
202505,76606000,2,0,4,-4,0
202505,76606000,3,0,4,-4,0
202505,76606000,3S3,0,1,-1,0
202505,76606000,CA,0,1,-1,0
202505,76616000,2,0,3,-3,0
202505,76616000,3,0,1,-1,0
202505,76616000,CA,0,3,-3,0
202505,76616002,2,0,1,-1,0
202505,76616009,2,0,1,-1,0
202505,76622000,2,0,21,-21,0
202505,76622000,3,0,1,-1,0
202505,76622000,3S3,0,4,-4,0
202505,76622000,CA,0,5,-5,0
202505,76622005,2,0,1,-1,0
202505,76622005,3S2,0,1,-1,0
202505,76622005,3S3,0,6,-6,0
202505,76622005,CA,0,5,-5,0
202505,76670000,2,0,6,-6,0
202505,76670000,2S3,0,1,-1,0
202505,76670000,3S3,0,6,-6,0
202505,76670004,2,0,1,-1,0
202505,76736000,2,0,15,-15,0
202505,76736000,3S3,0,1,-1,0
202505,76736000,CA,0,6,-6,0
202505,76823000,2,0,6,-6,0
202505,76828000,2,0,2,-2,0
202505,76828000,CA,0,2,-2,0
202505,76834000,2,0,145,-145,0
202505,76834000,2R2,0,1,-1,0
202505,76834000,2S2,0,8,-8,0
202505,76834000,2S3,0,2,-2,0
202505,76834000,3,0,1,-1,0
202505,76834000,3S2,0,2,-2,0
202505,76834000,3S3,0,44,-44,0
202505,76834000,CA,0,15,-15,0
202505,76863000,2,0,16,-16,0
202505,76869000,2,0,6,-6,0
202505,76869000,3S2,0,3,-3,0
202505,76869000,3S3,0,110,-110,0
202505,76869000,CA,0,3,-3,0
202505,76890000,2,0,12,-12,0
202505,76890000,2S2,0,274,-274,0
202505,76890000,2S3,0,12,-12,0
202505,76890000,3,0,2,-2,0
202505,76890000,3S2,0,13,-13,0
202505,76890000,3S3,0,41,-41,0
202505,76890000,CA,0,2,-2,0
202505,76890000,V4,0,1,-1,0
202505,76892000,2,0,363,-363,0
202505,76892000,2B1,0,3,-3,0
202505,76892000,2R2,0,1,-1,0
202505,76892000,2S2,0,165,-165,0
202505,76892000,2S3,0,40,-40,0
202505,76892000,3,0,3,-3,0
202505,76892000,3S2,0,187,-187,0
202505,76892000,3S3,0,524,-524,0
202505,76892000,CA,0,48,-48,0
202505,76892002,2,0,1,-1,0
202505,76892004,2,0,5,-5,0
202505,76892005,3S3,0,3,-3,0
202505,76892010,3S3,0,1,-1,0
202505,76892012,2,0,2,-2,0
202505,76892017,2,0,9,-9,0
202505,76892017,3S2,0,1,-1,0
202505,76892017,3S3,0,1,-1,0
202505,76895000,2,0,10,-10,0
202505,76895000,3S3,0,7,-7,0
202505,76895000,CA,0,4,-4,0
202505,76895002,2,0,6,-6,0
202505,76895002,2S2,0,2,-2,0
202505,76895002,2S3,0,1,-1,0
202505,76895002,3S2,0,3,-3,0
202505,76895002,3S3,0,14,-14,0
202505,76895002,CA,0,3,-3,0
202505,81001000,2,0,214,-214,0
202505,81001000,3,0,13,-13,0
202505,81001000,3S3,0,24,-24,0
202505,81001000,CA,0,5,-5,0
202505,81065000,2,0,24,-24,0
202505,81065000,3S3,0,2,-2,0
202505,81065008,2,0,2,-2,0
202505,81065017,2,0,4,-4,0
202505,81220000,2,0,2,-2,0
202505,81300000,2,0,6,-6,0
202505,81300000,CA,0,2,-2,0
202505,81591000,3S3,0,1,-1,0
202505,81736000,2,0,77,-77,0
202505,81736000,3,0,4,-4,0
202505,81736000,3S3,0,9,-9,0
202505,81736000,CA,0,2,-2,0
202505,81736008,2,0,1,-1,0
202505,81794000,2,0,54,-54,0
202505,81794000,3,0,2,-2,0
202505,81794000,3S3,0,4,-4,0
202505,81794000,CA,0,3,-3,0
202505,81794004,2,0,1,-1,0
202505,81794010,CA,0,1,-1,0
202505,85001000,2,0,220,-220,0
202505,85001000,2S2,0,16,-16,0
202505,85001000,2S3,0,2,-2,0
202505,85001000,3,0,7,-7,0
202505,85001000,3S2,0,40,-40,0
202505,85001000,3S3,0,176,-176,0
202505,85001000,CA,0,72,-72,0
202505,85001001,3S3,0,1,-1,0
202505,85001002,2,0,1,-1,0
202505,85001002,3S2,0,2,-2,0
202505,85001002,3S3,0,5,-5,0
202505,85001002,V3,0,1,-1,0
202505,85010000,2,0,19,-19,0
202505,85010000,3,0,5,-5,0
202505,85010000,3S2,0,52,-52,0
202505,85010000,3S3,0,42,-42,0
202505,85010000,CA,0,5,-5,0
202505,85010000,V3,0,49,-49,0
202505,85010000,V4,0,5,-5,0
202505,85015000,2,0,1,-1,0
202505,85125000,2,0,8,-8,0
202505,85125000,3S3,0,10,-10,0
202505,85125000,CA,0,1,-1,0
202505,85125000,V3,0,1,-1,0
202505,85139000,2,0,7,-7,0
202505,85139000,3,0,1,-1,0
202505,85139000,3S2,0,4,-4,0
202505,85139000,3S3,0,38,-38,0
202505,85139000,CA,0,1,-1,0
202505,85139005,3S2,0,4,-4,0
202505,85162000,2,0,7,-7,0
202505,85162000,3S2,0,33,-33,0
202505,85162000,3S3,0,67,-67,0
202505,85162000,CA,0,6,-6,0
202505,85162004,3S3,0,2,-2,0
202505,85225000,2S2,0,3,-3,0
202505,85225000,2S3,0,4,-4,0
202505,85225000,3S3,0,18,-18,0
202505,85225000,3S4,0,1,-1,0
202505,85225009,2,0,1,-1,0
202505,85230000,2,0,3,-3,0
202505,85230000,2S1,0,1,-1,0
202505,85230000,2S3,0,1,-1,0
202505,85230000,3,0,1,-1,0
202505,85230000,3S3,0,19,-19,0
202505,85230000,V3,0,2,-2,0
202505,85250000,2,0,31,-31,0
202505,85250000,3S2,0,2,-2,0
202505,85250000,3S3,0,18,-18,0
202505,85250000,CA,0,5,-5,0
202505,85263000,2,0,9,-9,0
202505,85263000,3,0,1,-1,0
202505,85263000,3S2,0,1,-1,0
202505,85263000,3S3,0,7,-7,0
202505,85263000,CA,0,1,-1,0
202505,85300001,3S3,0,1,-1,0
202505,85325000,2,0,4,-4,0
202505,85325000,3S2,0,1,-1,0
202505,85325000,3S3,0,14,-14,0
202505,85325000,CA,0,1,-1,0
202505,85410000,2,0,14,-14,0
202505,85410000,3,0,1,-1,0
202505,85410000,3S2,0,80,-80,0
202505,85410000,3S3,0,210,-210,0
202505,85410000,CA,0,4,-4,0
202505,85410001,3S3,0,2,-2,0
202505,85430000,2,0,4,-4,0
202505,85430000,3S3,0,18,-18,0
202505,85440000,2,0,27,-27,0
202505,85440000,2S2,0,3,-3,0
202505,85440000,3,0,1,-1,0
202505,85440000,3S2,0,1,-1,0
202505,85440000,3S3,0,31,-31,0
202505,85440000,CA,0,7,-7,0
202505,85440001,3,0,1,-1,0
202505,86001000,2,0,25,-25,0
202505,86001000,2S2,0,6,-6,0
202505,86001000,3,0,1,-1,0
202505,86001000,3S3,0,13,-13,0
202505,86001000,CA,0,11,-11,0
202505,86320000,2,0,9,-9,0
202505,86320000,3S2,0,9,-9,0
202505,86320000,3S3,0,19,-19,0
202505,86320000,CA,0,1,-1,0
202505,86568000,2,0,52,-52,0
202505,86568000,2S3,0,1,-1,0
202505,86568000,3,0,10,-10,0
202505,86568000,3S3,0,56,-56,0
202505,86568000,CA,0,6,-6,0
202505,86568013,2,0,4,-4,0
202505,86568013,CA,0,2,-2,0
202505,86568016,2,0,1,-1,0
202505,86568017,2,0,1,-1,0
202505,86568026,2,0,1,-1,0
202505,86569000,3,0,1,-1,0
202505,86571000,2,0,5,-5,0
202505,86571000,3S3,0,1,-1,0
202505,86749000,2,0,2,-2,0
202505,86749000,3S3,0,1,-1,0
202505,86749000,CA,0,2,-2,0
202505,86755000,2,0,4,-4,0
202505,86755000,CA,0,2,-2,0
202505,86757000,2,0,3,-3,0
202505,86757000,3,0,3,-3,0
202505,86757000,3S2,0,3,-3,0
202505,86757000,3S3,0,62,-62,0
202505,86757000,CA,0,3,-3,0
202505,86760000,CA,0,1,-1,0
202505,86865000,2,0,41,-41,0
202505,86865000,3S3,0,8,-8,0
202505,86865000,CA,0,2,-2,0
202505,86885000,2,0,9,-9,0
202505,86885000,3,0,6,-6,0
202505,86885000,3S3,0,4,-4,0
202505,86885000,3S4,0,1,-1,0
202505,86885000,CA,0,1,-1,0
202505,86885001,2,0,1,-1,0
202505,86885010,2,0,1,-1,0
202505,88001000,2,0,2,-2,0
202505,91001000,2,0,3,-3,0
202505,91001000,3S3,0,2,-2,0
202505,91001000,CA,0,1,-1,0
202505,94001000,2,0,3,-3,0
202505,94001000,CA,0,1,-1,0
202505,95001000,2,0,136,-136,0
202505,95001000,2S2,0,1,-1,0
202505,95001000,3,0,6,-6,0
202505,95001000,3S2,0,3,-3,0
202505,95001000,3S3,0,21,-21,0
202505,95001000,CA,0,19,-19,0
202505,95015000,2,0,1,-1,0
202505,95015000,3,0,2,-2,0
202505,95025000,2,0,1,-1,0
202505,95025000,3,0,1,-1,0
202505,95025001,2,0,1,-1,0
202505,97001000,2,0,6,-6,0
202505,97001000,3,0,1,-1,0
202505,97001000,3S3,0,1,-1,0
202505,99001000,2,0,14,-14,0
202505,99001000,3,0,3,-3,0
202505,99001000,3S2,0,12,-12,0
202505,99001000,3S3,0,9,-9,0
202505,99001000,CA,0,2,-2,0
202505,99524000,2,0,6,-6,0
202505,99524000,3,0,1,-1,0
202505,99524000,CA,0,2,-2,0
202505,99524007,3S3,0,2,-2,0
202505,99624000,2,0,9,-9,0
202505,99624000,3S3,0,4,-4,0
202505,99624000,V2,0,3,-3,0
202505,99773000,2,0,6,-6,0
202505,99773000,3,0,1,-1,0
202505,99773000,3S3,0,2,-2,0
202505,99773002,2,0,1,-1,0
202505,99773002,3S3,0,1,-1,0
202506,52356000,2,0,1,-1,0
